Lexeme	WC	Flexion
M	N	(no generation)
m	N	(no generation)
maagaa¦rpoq	V	–nngilaq
maagali¦orpoq	V	–unngilaq
maagarnaqaaq	V	(no generation)
maaga¦rpoq	V	–nngilaq
maaji	N	–p, –t
maaj¦ooq	N	–uup, –uut
maajorlu¦erpaa	V	–inngilaa
maajug¦aa	V	–inngilaa
maajuginninne¦q	N	–rup, –rit
maajugisa¦q	N	–p, –t
maajujuilli¦voq	V	–nngilaq
maajujuinaa¦rpaa	V	–nngilaa
maajujui¦ppoq	V	–nngilaq
maajunna¦rpoq	V	–nngilaq
maajunnart¦oq	N	–up, –ut
maajunnartoqassu¦seq	N	–tsip, –tsit
maajunnassu¦seq	N	–tsip, –tsit
maajunne¦q	N	–rup, –rit
maaju¦ppoq	V	–nngilaq
maajussaa¦rpaa	V	–nngilaa
maajut¦ooq	N	–uup, –uut
maajutoorsu¦aq	N	–up, –it
maajutoqaaq	V	(no generation)
maajutu¦voq	V	–nngilaq
maaki¦ppoq	V	–nngilaq
maakkaatit	N, pl.	-
maakkaliorna¦rpoq	V	–nngilaq
maakkali¦orpoq	V	–unngilaq
maakkaliuut	N	–ip, –it
maakkarnaqaaq	V	(no generation)
maakkarna¦rpoq	V	–nngilaq
maakkarnarsi¦voq	V	–nngilaq
maakkarnaveeqqutit	N, pl.	-
maakka¦rpaa	V	–nngilaa
maakka¦rpoq	V	–nngilaq
maakki¦ppoq	V	–nngilaq
maakulu¦k	N	–up, –it
maalaarne¦q	N	–rup, –rit
maa¦laarneq	N	{–laarnerup, –tilaarnerup}, {–laarnerit, –tilaarnerit}
maalaa¦rpoq	V	–nngilaq
maa¦laarpoq	V	{–laanngilaq, –tilaanngilaq}
maalaart¦oq	N	–up, –ut
maa¦laartoq	N	{–laartup, –tilaartup}, {–laartut, –tilaartut}
maalaarut	N	–ip, –it
maalaaruteqarfissa¦q	N	–p, –t
maalaaruteqa¦rpoq	V	–nngilaq
maalaaruteqartarfi¦k	N	–up, –it
maalaarutig¦aa	V	–inngilaa
maalaarutiginninne¦q	N	–rup, –rit
maalaarutiginnitt¦oq	N	–up, –ut
maalaja¦voq	V	–nngilaq
maalajua¦rpoq	V	–nngilaq
maalasa¦rpoq	V	–nngilaq
maalavig¦aa	V	–inngilaa
maala¦voq	V	–nngilaq
maallat	N	–ip, –it
maallataaru¦ppoq	V	–tinngilaq
maallatig¦aa	V	–inngilaa
maallavig¦aa	V	–inngilaa
maamaa¦q	N	–p, –t
maanaanna¦rpoq	V	–nngilaq
maana¦k	N	–ap, –at
maanaqqukkiart¦orpoq	V	–unngilaq
maanaqqu¦ppaa	V	–tinngilaa
maanaqqu¦ppoq	V	–tinngilaq
maanaralaanngu¦aq	N	–up, –it
maane¦q	N	–rup, –rit
maanerpoq	V	(no generation)
maangaanna¦q	N	–ap, –at
maangaanna¦q	N	–p, –t
maa¦ngaannaq	N	{–ngaannap, –tingaannap}, {–ngaannat, –tingaannat}
maangaannarne¦q	N	–rup, –rit
maangaanna¦rpoq	V	–nngilaq
maangaannarti¦ppaa	V	–nngilaa
maangaannart¦oq	N	–up, –ut
maaniikkunnaa¦rpoq	V	–nngilaq
maaniinnarmii¦ppoq	V	–nngilaq
maan¦iinnarmiippoq	V	{–erinnarmiinngilaq, –iinnarmiinngilaq}
maaniinngilaq	V	(no generation)
maanii¦ppoq	V	–nngilaq
maaniitt¦oq	N	–up, –ut
maannaa¦ppaa	V	–tinngilaa
maannaassi¦voq	V	–nngilaq
maannakanne¦q	N	–rup, –rit
maannakkorni¦saq	N	–tsap, –tsat
maannakkuugallart¦oq	N	–up, –ut
maannamuugallart¦oq	N	–up, –ut
maanna¦rpoq	V	–nngilaq
maanne¦q	N	–rup, –rit
maannga¦rpoq	V	–nngilaq
maannine¦q	N	–rup, –rit
maann¦ineq	N	{–ernup, –inerup}, {–ernit, –inerit}
maanni¦voq	V	–nngilaq
maa¦ppoq	V	{–nngilaq, –tinngilaq}
maaqanngilaq	V	(no generation)
maaqanngissu¦seq	N	–tsip, –tsit
maaqanngits¦oq	N	–up, –ut
maar¦aa	V	–inngilaa
maarmori	N	(no generation)
Maarmorilik	N	(no generation)
maa¦rpoq	V	–nngilaq
maasara¦rpoq	V	–nngilaq
maas¦oorpoq	V	–uunngilaq
maassa¦k	N	–ap, –at
maassaki¦ppoq	V	–nngilaq
maassatt¦ooq	N	–uup, –uut
maassattoqaaq	V	(no generation)
maasunna¦rpoq	V	–nngilaq
maats¦oq	N	–up, –ut
maat¦soq	N	{–sup, –tup}, {–sut, –tut}
maatt¦ooq	N	–uup, –uut
maattoorsu¦aq	N	–up, –it
maatt¦oq	N	–up, –ut
maattoqaaq	V	(no generation)
maattunersaa¦voq	V	–nngilaq
maattusaa¦rpoq	V	–nngilaq
maattusa¦rpoq	V	–nngilaq
maattus¦oq	N	–up, –ut
maattu¦voq	V	–nngilaq
maavaa¦rpoq	V	–nngilaq
maava¦rpoq	V	–nngilaq
maa¦voq	V	–nngilaq
Mac	Prop	–ip
madrassi	N	(no generation)
maggorlu¦k	N	–up, –it
maggukkiart¦orpoq	V	–unngilaq
maggu¦ppaa	V	–tinngilaa
maggu¦ppoq	V	–tinngilaq
maggusimas¦oq	N	–up, –ut
maggussa¦q	N	–p, –t
maggutt¦oorpaa	V	–uunngilaa
maggutt¦oorpoq	V	–uunngilaq
maj	N	–ip, –it
majoqqal¦ik	N	{–iup, –lip, –lup}, –lit
majoqqa¦q	N	–ap, –at
majorajaanngu¦aq	N	–up, –it
majorajaa¦q	N	–p, –t
majorajaarsu¦aq	N	–up, –it
majoralaa¦rpoq	V	–nngilaq
majoralaartittua¦rpaa	V	–nngilaa
majorallaa¦ppoq	V	–tinngilaq
majoralla¦ppoq	V	–nngilaq
majorallatsi¦ppaa	V	–nngilaa
majora¦ppoq	V	–nngilaq
majorari¦aq	N	–ssap, –ssat
majorarnart¦oq	N	–up, –ut
majorarsisa¦q	N	–p, –t
majorarsi¦vaa	V	–nngilaa
majorassaa¦rpoq	V	–nngilaq
majoriakk¦oorpoq	V	–uunngilaq
majori¦aq	N	–ssap, –ssat
maj¦orpaa	V	–unngilaa
maj¦orpoq	V	–unngilaq
majorranne¦q	N	–rup, –rit
majorsima¦voq	V	–nngilaq
majorteqilaa¦rpoq	V	–nngilaq
majorteqi¦voq	V	–nngilaq
majorti¦ppaa	V	–nngilaa
majuarfigisarta¦gaq	N	–kkap, –kkat
majuari¦aq	N	–ssap, –ssat
majuarne¦q	N	–rup, –rit
majua¦rpoq	V	–nngilaq
majuartaat	N	–ip, –it
majuartarfiit	N, pl.	-
majuartarfi¦k	N	–up, –it
majuartoorne¦q	N	–rup, –rit
majuffa¦seq	N	–tsip, –tsit
majuffas¦erpoq	V	–inngilaq
majuffasil¦ik	N	{–iup, –lip, –lup}, –lit
majuffasillit	N, pl.	-
majukuj¦oorpoq	V	–uunngilaq
majukujoortaanna¦rpoq	V	–nngilaq
majuunneqarne¦q	N	–rup, –rit
majuu¦ppaa	V	–tinngilaa
majuu¦ppoq	V	–tinngilaq
majuussa¦q	N	–p, –t
majuussine¦q	N	–rup, –rit
majuussi¦voq	V	–nngilaq
Makedoniam¦eersoq	N	{–eersup, –eertup, –inngaanneersup, –inngaanneertup, –inngaanninngaanneersup, –inngaanninngaanneertup}, {–eersut, –eertut, –inngaanneersut, –inngaanneertut, –inngaanninngaanneersut, –inngaanninngaanneertut}
Makedoniam¦eersoq	N	{–eersup, –eertup, –inngaanneersup, –inngaanneertup}, {–eersut, –eertut, –inngaanneersut, –inngaanneertut}
Makedoniamioq	N	(no generation)
Makedoniamiu	N	–p, –t
Makedonia¦miu	N	{–miup, –rmiup}, {–miut, –rmiut}
makeqqaat	N, pl.	-
makeqqi¦ppoq	V	–nngilaq
makeqqi¦tsitaaneq	N	{–ssitaanerup, –tsitaanerup}, {–ssitaanerit, –tsitaanerit}
maker¦eerpoq	V	–iinngilaq
makeria¦rpoq	V	–nngilaq
makiaallus¦ooq	N	–uup, –uut
makiaallu¦sooq	N	{–suup, –tuup}, {–suut, –tuut}
makiaallu¦voq	V	–nngilaq
makiaanngilaq	V	(no generation)
makiaa¦rpoq	V	–nngilaq
makiaarut	N	–ip, –it
makialaneqanngits¦oq	N	–up, –ut
makiala¦voq	V	–nngilaq
makiali¦ppoq	V	–nngilaq
makialit¦erpaa	V	–inngilaa
makialitsi¦ppaa	V	–nngilaa
makiali¦tsippaa	V	{–ssinngilaa, –tsinngilaa}
makialitsisimas¦oq	N	–up, –ut
makiali¦tsisimasoq	N	{–ssisimasup, –tsisimasup}, {–ssisimasut, –tsisimasut}
makiarne¦q	N	–rup, –rit
makiarniku	N	–p, –t
makia¦rpaa	V	–nngilaa
makia¦rpoq	V	–nngilaq
makiart¦erpaa	V	–inngilaa
makiart¦erpoq	V	–inngilaq
makiffi¦k	N	–up, –it
makiffissa¦q	N	–p, –t
makiffissaqa¦rpoq	V	–nngilaq
makikkallanngilaq	V	(no generation)
makikkasua¦rpoq	V	–nngilaq
makikkumaarnertu¦voq	V	–nngilaq
makil¦erpoq	V	–inngilaq
makillaqqi¦ppoq	V	–nngilaq
makinnial¦erpoq	V	–inngilaq
makinniarti¦ppaa	V	–nngilaa
maki¦ppaa	V	–nngilaa
maki¦ppoq	V	–nngilaq
makisaarsi¦voq	V	–nngilaq
makisart¦oq	N	–up, –ut
makis¦eq	N	–ip, –it
makisequt	N	–ip, –it
makisequtaa¦rpoq	V	–nngilaq
makisequts¦erpoq	V	–inngilaq
makisermi¦ppaa	V	–nngilaa
maki¦sik	N	–tsip, –tsit
makisilunne¦q	N	–rup, –rit
makisilu¦ppoq	V	–nngilaq
makisimia¦rpoq	V	–nngilaq
makisimmi¦ppoq	V	–nngilaq
makisi¦ppaa	V	–nngilaa
makis¦oorpoq	V	–uunngilaq
makissimaarpoq	V	(no generation)
makis¦simasoq	N	{–imasup, –simasup}, {–imasut, –simasut}
makissima¦voq	V	–nngilaq
makissinnaa¦voq	V	–nngilaq
makissut	N	–ip, –it
maki¦ssut	N, pl.	{–ssut, –ttut}
makissutaa¦voq	V	–nngilaq
maki¦t	N	–sip, –sit
makitaa¦voq	V	–nngilaq
makitajui¦ppoq	V	–nngilaq
makitasaarne¦q	N	–rup, –rit
makitasaa¦rpoq	V	–nngilaq
makitas¦ooq	N	–uup, –uut
makita¦sooq	N	{–suup, –tuup}, {–suut, –tuut}
makitas¦oq	N	–up, –ut
makitassu¦seq	N	–tsip, –tsit
makitavallaaqaaq	V	(no generation)
makita¦voq	V	–nngilaq
makit¦erpoq	V	–inngilaq
makiterusaa¦rpoq	V	–nngilaq
makiti¦ppaa	V	–nngilaa
makit¦ippaa	V	–sinngilaa
makititsi¦voq	V	–nngilaq
makit¦itsivoq	V	{–itsinngilaq, –sitsinngilaq}
makitserine¦q	N	–rup, –rit
makitseri¦voq	V	–nngilaq
makitsine¦q	N	–rup, –rit
makitsi¦voq	V	–nngilaq
makittaat	N	–ip, –it
maki¦ttaat	N	{–ssaatip, –ttaatip}, {–ssaatit, –ttaatit}
makittakkaluttuinna¦rpoq	V	–nngilaq
makittakkunnanngilaa	V	(no generation)
makittaler¦soq	N	{–sup, –tup}, {–sut, –tut}
makittal¦ik	N	{–iup, –lip, –lup}, –lit
makitta¦ppaa	V	–nngilaa
makitta¦ppoq	V	–nngilaq
makitta¦q	N	–p, –t
makittaqanngilaq	V	(no generation)
makittaqanngits¦oq	N	–up, –ut
makittaqa¦rpoq	V	–nngilaq
makittariaqal¦erpoq	V	–inngilaq
makittariaqa¦rpoq	V	–nngilaq
makittari¦k	N	–up, –it
makittarinne¦q	N	–rup, –rit
makittari¦ppoq	V	–nngilaq
makittarissaat	N	–ip, –it
makittari¦ssaat	N	{–ssaatip, –ttaatip}, {–ssaatit, –ttaatit}
makittariss¦oq	N	–up, –ut
makittari¦ssoq	N	{–ssup, –ttup}, {–ssut, –ttut}
makittarissu¦seq	N	–tsip, –tsit
maki¦ttarissuseq	N	{–ssarissutsip, –ttarissutsip}, {–ssarissutsit, –ttarissutsit}
makittarissuu¦voq	V	–nngilaq
makittarissu¦uvoq	V	{–aanngilaq, –unngilaq}
makittari¦ssuuvoq	V	{–ssuunngilaq, –ttuunngilaq}
maki¦ttarneq	N	{–ssarnerup, –ttarnerup}, {–ssarnerit, –ttarnerit}
makitta¦rpoq	V	–nngilaq
makittassimaarpoq	V	(no generation)
makittataa¦voq	V	–nngilaq
makittatig¦aa	V	–inngilaa
makittussa¦q	N	–p, –t
maki¦ttussaq	N	{–ssussap, –ttussap}, {–ssussat, –ttussat}
makittuu¦voq	V	–nngilaq
maki¦ttuuvoq	V	{–ssuunngilaq, –ttuunngilaq}
maki¦voq	V	–nngilaq
makkaa¦voq	V	–nngilaq
makkariina	N	–p, –t
makkari¦ppoq	V	–nngilaq
makka¦rpaa	V	–nngilaa
makkornat	N, pl.	-
makkorpalla¦ppoq	V	–nngilaq
makk¦orpallappoq	V	{–orpallanngilaq, –upallanngilaq}
makkorpalu¦ppoq	V	–nngilaq
makk¦orpoq	V	–unngilaq
makku	Pron, pl.	–a
makku¦a	Pron, pl.	–a
makkualla¦k	N	–ap, –at
makkuallappoq	V	(no generation)
makkuinna¦rpoq	V	–nngilaq
makkukkiart¦orpaa	V	–unngilaa
makkullua¦rpaa	V	–nngilaa
makkulu¦ppoq	V	–nngilaq
makkulutsitsine¦q	N	–rup, –rit
makkulutsitsi¦voq	V	–nngilaq
makkuluttua¦rpoq	V	–nngilaq
makkuluttuinnaa¦voq	V	–nngilaq
makku¦ppaa	V	–tinngilaa
makku¦ppoq	V	–nngilaq
makkusiine¦q	N	–rup, –rit
makunneqa¦rpoq	V	–nngilaq
maku¦ppaa	V	–nngilaa
makussisinnaannginne¦q	N	–rup, –rit
makussi¦voq	V	–nngilaq
makuta¦q	N	–p, –t
malaa¦ppaa	V	–tinngilaa
malaassaa¦rpoq	V	–nngilaq
malakaa¦ppoq	V	–tinngilaq
malakaassaa¦rpoq	V	–nngilaq
malakarti¦ppaa	V	–nngilaa
malam¦ooq	N	–uup, –uut
malamu¦k	N	–up, –it
malangaa¦rpoq	V	–nngilaq
malangaartitsi¦voq	V	–nngilaq
malangalaa¦rpoq	V	–nngilaq
malangavallaa¦rpoq	V	–nngilaq
malanga¦voq	V	–nngilaq
mala¦q	N	–ap, –at
malariarne¦q	N	–rup, –rit
malarninngu¦aq	N	–up, –it
mala¦rpoq	V	–nngilaq
malarsima¦voq	V	–nngilaq
malarsiut	N	–ip, –it
malartaa¦ppoq	V	–nngilaq
malartaas¦erpoq	V	–inngilaq
malartaa¦serpoq	V	{–sinngilaq, –tilinngilaq}
malartaaser¦toq	N	{–sup, –tup}, {–sut, –tut}
malartaa¦sertoq	N	{–sersup, –sertup, –tilersup, –tilertup}, {–sersut, –sertut, –tilersut, –tilertut}
malarti¦ppaa	V	–nngilaa
malartitassaanngilaq	V	(no generation)
malartitassaanngissu¦seq	N	–tsip, –tsit
malartitassaanngits¦oq	N	–up, –ut
malasiut	N	–ip, –it
maleqanngits¦oq	N	–up, –ut
maleqqeri¦voq	V	–nngilaq
maleqqiarnaq	Interj	(no generation)
maleqqiarne¦q	N	–rup, –rit
maleqqia¦rpoq	V	–nngilaq
maleqqiu¦ppaa	V	–tinngilaa
maleqqusaa¦rpaa	V	–nngilaa
male¦raq	N	–qqap, –qqat
malerar¦aa	V	–inngilaa
malerariunnaa¦rpaa	V	–nngilaa
male¦req	N	–qqip, –qqit
maler¦erpoq	V	–inngilaq
maleri¦ppaa	V	–nngilaa
malerita¦q	N	–p, –t
maleritar¦aa	V	–inngilaa
malerneeqaaq	V	(no generation)
malern¦erpoq	V	–inngilaq
malerniilli¦voq	V	–nngilaq
malernii¦ppoq	V	–nngilaq
malersoriilissavaa	V	(no generation)
malersorneqarsimas¦oq	N	–up, –ut
malersorneqarsorine¦q	N	–rup, –rit
malersorneqart¦oq	N	–up, –ut
malers¦orpaa	V	–unngilaa
malersorpoq	V	(no generation)
Malersortinneq	Prop	–-ip
Malersortinne¦q	N	–rup, –rit
malersorti¦ppoq	V	–nngilaq
malersoruminaa¦ppoq	V	–nngilaq
malersugaanasorine¦q	N	–rup, –rit
malersugaane¦q	N	–rup, –rit
malersu¦gaq	N	–kkap, –kkat
malersuine¦q	N	–rup, –rit
malersuis¦oq	N	–up, –ut
malersui¦voq	V	–nngilaq
malersukk¦erpoq	V	–inngilaq
maleruaane¦q	N	–rup, –rit
maleruaanngitsoorne¦q	N	–rup, –rit
maleruaa¦voq	V	–nngilaq
maleruagaane¦q	N	–rup, –rit
maleruagassaalluart¦oq	N	–up, –ut
maleruagassa¦q	N	–p, –t
maleruagassaqqiss¦oq	N	–up, –ut
maleruagassaqqi¦ssoq	N	{–ssup, –ttup}, {–ssut, –ttut}
maleruagassareqqusa¦q	N	–p, –t
maleruagassia¦q	N	–p, –t
maleruagassiat	N, pl.	-
maleruaqqusa¦q	N	–p, –t
malerua¦rpaa	V	–nngilaa
maleruarti	N	–p, –t
maleruuffiginninne¦q	N	–rup, –rit
maleruukkumanngits¦oq	N	–up, –ut
maleruunne¦q	N	–rup, –rit
maleruu¦ppoq	V	–tinngilaq
maleruutiinnarpallaart¦oq	N	–up, –ut
maleruut¦iinnarpallaartoq	N	{–iinnarpallaartup, –siinnarpallaartup}, {–iinnarpallaartut, –siinnarpallaartut}
maleruutiinna¦rpoq	V	–nngilaq
maleruut¦iinnarpoq	V	{–iinnanngilaq, –siinnanngilaq}
maleruutiinnart¦oq	N	–up, –ut
maleruut¦iinnartoq	N	{–iinnartup, –siinnartup}, {–iinnartut, –siinnartut}
maleruut¦issuseq	N	{–issutsip, –sissutsip}, {–issutsit, –sissutsit}
maleruuttaanna¦rpoq	V	–nngilaq
maleruutt¦oq	N	–up, –ut
maleruuttuarpoq	V	(no generation)
malialaarne¦q	N	–rup, –rit
malialaa¦rpoq	V	–nngilaq
malialaartunnguu¦voq	V	–nngilaq
maliallerajuppoq	V	(no generation)
maliall¦erpoq	V	–inngilaq
maliallersorsuu¦voq	V	–nngilaq
maliallersorsu¦uvoq	V	{–aanngilaq, –unngilaq}
malialler¦sorsuuvoq	V	{–sorsuaanngilaq, –sorsuunngilaq, –torsuaanngilaq, –torsuunngilaq}
malialu¦k	N	–up, –it
malialuppalu¦ppoq	V	–nngilaq
malialu¦ppoq	V	–nngilaq
malialuttorsuu¦voq	V	–nngilaq
malialuttorsu¦uvoq	V	{–aanngilaq, –unngilaq}
maliaqilaa¦rpoq	V	–nngilaq
maliaqisorsuu¦voq	V	–nngilaq
maliaqisorsu¦uvoq	V	{–aanngilaq, –unngilaq}
maliaqi¦voq	V	–nngilaq
maliarpalu¦k	N	–up, –it
maliarsu¦k	N	–up, –it
maligaa¦q	N	–p, –t
maligaarsi¦orpoq	V	–unngilaq
maligaasaliortarne¦q	N	–rup, –rit
mali¦gaasaliortarneq	N	{–gaasaliortarnerup, –taasaliortarnerup}, {–gaasaliortarnerit, –taasaliortarnerit}
maligaasa¦q	N	–p, –t
mali¦gaasaq	N	{–gaasap, –taasap}, {–gaasat, –taasat}
mali¦gaasarneq	N	{–gaasarnerup, –taasarnerup}, {–gaasarnerit, –taasarnerit}
mali¦gaasartoq	N	{–gaasartup, –taasartup}, {–gaasartut, –taasartut}
maligaasiorne¦q	N	–rup, –rit
mali¦gaasiorneq	N	{–gaasiornerup, –gaatiliornerup, –taasiornerup, –taatiliornerup}, {–gaasiornerit, –gaatiliornerit, –taasiornerit, –taatiliornerit}
maligaasi¦orpoq	V	–unngilaq
mali¦gaasiorpoq	V	{–gaasiunngilaq, –gaatiliunngilaq, –taasiunngilaq, –taatiliunngilaq}
maligaasiort¦oq	N	–up, –ut
mali¦gaasiortoq	N	{–gaasiortup, –gaatiliortup, –taasiortup, –taatiliortup}, {–gaasiortut, –gaatiliortut, –taasiortut, –taatiliortut}
mali¦gaq	N	{–kkap, –tap}, {–kkat, –tat}
mali¦gassaalluartoq	N	{–gassaalluartup, –tassaalluartup}, {–gassaalluartut, –tassaalluartut}
mali¦gassaasariaqartoq	N	{–gassaasariaqartup, –tassaasariaqartup}, {–gassaasariaqartut, –tassaasariaqartut}
maligassaas¦oq	N	–up, –ut
mali¦gassaasoq	N	{–gassaasup, –tassaasup}, {–gassaasut, –tassaasut}
mali¦gassaavoq	V	{–gassaanngilaq, –tassaanngilaq}
mali¦gassaq	N	{–gassap, –tassap}, {–gassat, –tassat}
mali¦gassiaq	N	{–gassiap, –tassiap}, {–gassiat, –tassiat}
maligassi¦orpaa	V	–unngilaa
maligassiuillua¦rpoq	V	–nngilaq
maligassiuilluart¦oq	N	–up, –ut
maligassiuinerlunne¦q	N	–rup, –rit
maligassiuinerlu¦ppoq	V	–nngilaq
maligassiuis¦oq	N	–up, –ut
maligassiui¦voq	V	–nngilaq
maligi¦aq	N	–ssap, –ssat
Maliina	Prop	(no generation)
maliinna¦rpoq	V	–nngilaq
mal¦ik	N	{–iup, –lip, –lup}, –lit
malikkumanngisaannassavaa	V	(no generation)
malimaa¦gaq	N	–kkap, –kkat
malimaa¦rpaa	V	–nngilaa
malingaa¦rpoq	V	–nngilaq
malinnaaffig¦aa	V	–inngilaa
malinnaa¦ppaa	V	–tinngilaa
malinnaa¦q	N	–p, –t
malinnaasinnaajunnaarpoq	V	(no generation)
malinnaasinnaatitaane¦q	N	–rup, –rit
malinnaas¦oq	N	–up, –ut
malinnaati¦ppaa	V	–nngilaa
malinnaat¦ippaa	V	{–itinngilaa, –sinngilaa}
malinnaatitsine¦q	N	–rup, –rit
malinnaa¦voq	V	–nngilaq
malinneqarsinnaas¦oq	N	–up, –ut
malinneqarti¦ppaa	V	–nngilaa
malinnguaa¦q	N	–p, –t
malinnguaa¦rpoq	V	–nngilaq
malinngu¦aq	N	–up, –it
malinnguart¦oq	N	–up, –ut
malinnigu¦ppaa	V	–tinngilaa
malinnigussa¦q	N	–p, –t
malinninne¦q	N	–rup, –rit
malinni¦ppoq	V	–nngilaq
malinnitsi	N	–p, –t
malinnitt¦oq	N	–up, –ut
mali¦ppaa	V	–nngilaa
malissari¦aq	N	–ssap, –ssat
malissa¦rpaa	V	–nngilaa
malissiorne¦q	N	–rup, –rit
maliss¦iorneq	N	{–iornerup, –aliornerup}, {–iornerit, –aliornerit}
malissi¦orpoq	V	–unngilaq
maliss¦iorpoq	V	{–iunngilaq, –aliunngilaq}
mal¦issuaq	N	{–ersuup, –issuup}, {–ersuit, –issuit}
malisungaanna¦rpaa	V	–nngilaa
malisunga¦rpaa	V	–nngilaa
malit¦aq	N	{–ap, –tap}, {–at, –tat}
mali¦taq	N	{–kkap, –tap}, {–kkat, –tat}
mali¦tassaq	N	{–gassap, –tassap}, {–gassat, –tassat}
mali¦tassiaq	N	{–gassiap, –tassiap}, {–gassiat, –tassiat}
malitseqa¦rpoq	V	–nngilaq
malitsi	N	–p, –t
malitsig¦aa	V	–inngilaa
malitsigisa¦q	N	–p, –t
malitsigiuma¦vaa	V	–nngilaa
malitsit	N	–ip, –it
malitsit	N, pl.	-
malittaasa¦ppoq	V	–nngilaq
malittaa¦voq	V	–nngilaq
malit¦taavoq	V	{–aanngilaq, –taanngilaq}
malit¦taq	N	{–ap, –tap}, {–at, –tat}
malittaqqutiinna¦rpoq	V	–nngilaq
malittar¦aa	V	–inngilaa
malit¦taraa	V	{–arinngilaa, –tarinngilaa}
malittareqqusa¦q	N	–p, –t
malit¦tareqqusaq	N	{–areqqusap, –tareqqusap}, {–areqqusat, –tareqqusat}
malittariissari¦aq	N	–ssap, –ssat
malittarinni¦ppoq	V	–nngilaq
malit¦tarinnippoq	V	{–arinninngilaq, –tarinninngilaq}
malittarisa¦q	N	–p, –t
malit¦tarisaq	N	{–arisap, –tarisap}, {–arisat, –tarisat}
mal¦ittarisaq	N	{–erarisap, –ittarisap}, {–erarisat, –ittarisat}
malittarisassa¦q	N	–p, –t
malit¦tarisassaq	N	{–arisassap, –tarisassap}, {–arisassat, –tarisassat}
mal¦ittarisassaq	N	{–erarisassap, –ittarisassap}, {–erarisassat, –ittarisassat}
malittarisassaqarne¦q	N	–rup, –rit
malit¦tarisassaqarneq	N	{–arisassaqarnerup, –tarisassaqarnerup}, {–arisassaqarnerit, –tarisassaqarnerit}
mal¦ittarisassaqarneq	N	{–erarisassaqarnerup, –ittarisassaqarnerup}, {–erarisassaqarnerit, –ittarisassaqarnerit}
malittarisassat	N, pl.	-
malit¦tarisassat	N, pl.	{–arisassat, –tarisassat}
mal¦ittarisassat	N, pl.	{–erarisassat, –ittarisassat}
malittarisassia¦q	N	–p, –t
malit¦tarisassiaq	N	{–arisassiap, –tarisassiap}, {–arisassiat, –tarisassiat}
mal¦ittarisassiaq	N	{–erarisassiap, –ittarisassiap}, {–erarisassiat, –ittarisassiat}
malittarisassiat	N, pl.	-
malit¦tarisassiat	N, pl.	{–arisassiat, –tarisassiat}
mal¦ittarisassiat	N, pl.	{–erarisassiat, –ittarisassiat}
mali¦voq	V	–nngilaq
mallaassu¦seq	N	–tsip, –tsit
mallaa¦voq	V	–nngilaq
malla¦k	N	–ap, –at
malla¦ppoq	V	–nngilaq
mallassu¦aq	N	–up, –it
mallattorne¦q	N	–rup, –rit
mallatt¦orpaa	V	–unngilaa
mallatt¦orpoq	V	–unngilaq
malleqaaq	V	(no generation)
malleqis¦oq	N	–up, –ut
mallerne¦q	N	–rup, –rit
mallerpalu¦k	N	–up, –it
mall¦erpoq	V	–inngilaq
mallersitsine¦q	N	–rup, –rit
mallers¦oq	N	–up, –ut
maller¦soq	N	{–sup, –tup}, {–sut, –tut}
mallersorsuu¦voq	V	–nngilaq
mallersorsu¦uvoq	V	{–aanngilaq, –unngilaq}
maller¦sorsuuvoq	V	{–sorsuaanngilaq, –sorsuunngilaq, –torsuaanngilaq, –torsuunngilaq}
mallilaa¦rpoq	V	–nngilaq
malli¦orpoq	V	–unngilaq
malliukkaa¦q	N	–p, –t
malliukkaarne¦q	N	–rup, –rit
malliukkaa¦rpoq	V	–nngilaq
Mallorca	Prop	–p
mall¦orpaa	V	–unngilaa
mall¦orpoq	V	–unngilaq
mallui¦voq	V	–nngilaq
mallu¦ppaa	V	–tinngilaa
mallus¦erpaa	V	–inngilaa
mallu¦serpaa	V	–tilinngilaa
mallussi¦voq	V	–nngilaq
malug¦aa	V	–inngilaa
malugine¦q	N	–rup, –rit
malugineqanngissu¦seq	N	–tsip, –tsit
malugineqanngits¦oq	N	–up, –ut
malugineqa¦rpoq	V	–nngilaq
malugineqarsinnaas¦oq	N	–up, –ut
maluginiut	N	–ip, –it
maluginninniut	N	–ip, –it
maluginninniu¦t	N	{–t, –p}, –t
malugisaarunne¦q	N	–rup, –rit
malugisaarut¦ivinneq	N	{–ivinnerup, –sivinnerup}, {–ivinnerit, –sivinnerit}
malugisaa¦voq	V	–nngilaq
malugisaqaraluanngilaq	V	(no generation)
malugisassaa¦voq	V	–nngilaq
malugisimaa¦rpoq	V	–nngilaq
malugisimaart¦oq	N	–up, –ut
malugisinnaassu¦seq	N	–tsip, –tsit
malugis¦oorpaa	V	–uunngilaa
malugisoortippoq	V	(no generation)
malugissut	N	–ip, –it
malugissut	N, pl.	-
malugiti¦ppaa	V	–nngilaa
malugiti¦ppoq	V	–nngilaq
malugivikkunarpaa	V	(no generation)
malugusunna¦rpoq	V	–nngilaq
malugusu¦ppoq	V	–nngilaq
malukk¦oorpoq	V	–uunngilaq
malunnaa¦ppoq	V	–nngilaq
malunnaaqqus¦erpaa	V	–inngilaa
malunnaaqqu¦serpaa	V	{–sinngilaa, –tilinngilaa}
malunnaaqqut	N	–ip, –it
malunnaarsaa¦rpoq	V	–nngilaq
malunnaarsaart¦oq	N	–up, –ut
malunnaas¦erpaa	V	–inngilaa
malunnaa¦serpaa	V	{–sinngilaa, –tilinngilaa}
malunnaat	N	–ip, –it
malunnaateqanngissu¦seq	N	–tsip, –tsit
malunnaateqanngits¦oq	N	–up, –ut
malunnaateqarneruniarne¦q	N	–rup, –rit
malunnaateqa¦rpoq	V	–nngilaq
malunnanngilaq	V	(no generation)
malunnanngits¦oq	N	–up, –ut
malunnaqaaq	V	(no generation)
malunnarluart¦oq	N	–up, –ut
malunnarnerus¦oq	N	–up, –ut
malunna¦rpoq	V	–nngilaq
malunnarti¦ppaa	V	–nngilaa
malunnartitsine¦q	N	–rup, –rit
malunnart¦oq	N	–up, –ut
malunnera¦rpoq	V	–nngilaq
malunnersimaa¦rpoq	V	–nngilaq
malunniukkiart¦orpoq	V	–unngilaq
malunniullua¦rpoq	V	–nngilaq
malunniunne¦q	N	–rup, –rit
malunniu¦ppoq	V	–tinngilaq
malussajas¦oq	N	–up, –ut
malussarikkunnaa¦rpoq	V	–nngilaq
malussarilluart¦oq	N	–up, –ut
malussarippallaart¦oq	N	–up, –ut
malussari¦ppoq	V	–nngilaq
malussarissisinneqart¦oq	N	–up, –ut
malussarissi¦voq	V	–nngilaq
malussariss¦oq	N	–up, –ut
malussari¦ssoq	N	{–ssup, –ttup}, {–ssut, –ttut}
malussarissu¦seq	N	–tsip, –tsit
malussarne¦q	N	–rup, –rit
malussa¦rpoq	V	–nngilaq
malussarsinnaajunnaarne¦q	N	–rup, –rit
malussataaleriivippoq	V	(no generation)
malussitsaa¦rpoq	V	–nngilaq
maluttaa¦ppoq	V	–nngilaq
maluttajas¦oq	N	–up, –ut
maluttajassu¦seq	N	–tsip, –tsit
malutta¦rpoq	V	–nngilaq
mamaag¦aa	V	–inngilaa
mamaaginngilaa	V	(no generation)
mamaaginni¦ppoq	V	–nngilaq
mamaagivi¦ppaa	V	–nngilaa
mamaalasuinnaa¦voq	V	–nngilaq
mamaala¦voq	V	–nngilaq
mamaalli¦voq	V	–nngilaq
mamaannera¦rpaa	V	–nngilaa
mamaappallaaqaaq	V	(no generation)
mamaa¦ppoq	V	–nngilaq
mamaaqqamm¦erpoq	V	–inngilaq
mamaarfi¦k	N	–up, –it
mamaarne¦q	N	–rup, –rit
mamaa¦rpoq	V	–nngilaq
mamaart¦oq	N	–up, –ut
mamaasi¦voq	V	–nngilaq
mamaat	N	–ip, –it
mamaat	N, pl.	-
mamaatil¦ik	N	{–iup, –lip, –lup}, –lit
mamaatsoorna¦rpoq	V	–nngilaq
mamaats¦oorpoq	V	–uunngilaq
mamaats¦oq	N	–up, –ut
mamag¦oq	N	–up, –ut
mamakujuit	N, pl.	-
mamakuju¦k	N	–up, –it
mamakujuttut	N, pl.	-
mamalaa¦q	N	–p, –t
mamallatsiinna¦rpoq	V	–nngilaq
mamangaa¦q	N	–p, –t
mamanngerpallaa¦rpoq	V	–nngilaq
mamanng¦erpoq	V	–inngilaq
mamanngers¦oq	N	–up, –ut
mamannger¦soq	N	{–sup, –tup}, {–sut, –tut}
mamanngersorsuu¦voq	V	–nngilaq
mamanngersorsu¦uvoq	V	{–aanngilaq, –unngilaq}
mamannger¦sorsuuvoq	V	{–sorsuaanngilaq, –sorsuunngilaq, –torsuaanngilaq, –torsuunngilaq}
mamanngersuunngilaq	V	(no generation)
mamanngersuu¦voq	V	–nngilaq
mamannger¦suuvoq	V	{–suunngilaq, –tuunngilaq}
mamanngilaq	V	(no generation)
mamanngits¦oq	N	–up, –ut
mamanngivi¦ssoq	N	{–ssup, –ttup}, {–ssut, –ttut}
mamanngi¦vissoq	N	{–ivissup, –ivittup, –vissup, –vittup}, {–ivissut, –ivittut, –vissut, –vittut}
mama¦q	N	–p, –t
mamaqis¦oq	N	–up, –ut
mamar¦aa	V	–inngilaa
mamaraluarti¦ppaa	V	–nngilaa
mamaraluartitsiinna¦rpoq	V	–nngilaq
mamaraluartitsi¦voq	V	–nngilaq
mamarillua¦gaq	N	–kkap, –kkat
mamarinngilaa	V	(no generation)
mamarisaaru¦ppoq	V	–tinngilaq
mamarisa¦q	N	–p, –t
mamarisariunnaa¦rpaa	V	–nngilaa
mamarl¦erpaa	V	–inngilaa
mamarliigajussu¦seq	N	–tsip, –tsit
mamarliigajutt¦oq	N	–up, –ut
mamarliine¦q	N	–rup, –rit
mamarliis¦oq	N	–up, –ut
mamarliisorsu¦aq	N	–up, –it
mamarliissutaas¦oq	N	–up, –ut
mamarlii¦voq	V	–nngilaq
mamarliut	N	–ip, –it
mamarluart¦oq	N	–up, –ut
mama¦rpoq	V	–nngilaq
mamarsaa¦serpaa	V	{–sinngilaa, –tilinngilaa}
mamarsaatig¦aa	V	–inngilaa
mamarsaatigingaa¦rpaa	V	–nngilaa
mamarsaatissa¦q	N	–p, –t
mamarsa¦rpoq	V	–nngilaq
mamarseqqut	N, pl.	-
mamarsisi¦ppaa	V	–nngilaa
mamarsisitsi¦voq	V	–nngilaq
mamarsisoorti¦ppaa	V	–nngilaa
mamarsi¦voq	V	–nngilaq
mamart¦oq	N	–up, –ut
mamar¦torpoq	V	{–sunngilaq, –tunngilaq}
mamartorsu¦aq	N	–up, –it
mamartukuju¦k	N	–up, –it
mamartuliaarniarfi¦k	N	–up, –it
mamartulia¦q	N	–p, –t
mamartuliat	N, pl.	-
mamarunart¦oq	N	–up, –ut
mamassu¦seq	N	–tsip, –tsit
mamassusersiut	N	–ip, –it
mamat¦orpoq	V	–unngilaq
mam¦eq	N	–ip, –it
mame¦raq	N	–qqap, –qqat
mamerartaa¦rpoq	V	–nngilaq
mami	N	–p, –t
mamiaa¦ppoq	V	–nngilaq
mamiag¦aa	V	–inngilaa
mamiagisa¦q	N	–p, –t
mamianaqaaq	V	(no generation)
mamiana¦rpoq	V	–nngilaq
mamianart¦oq	N	–up, –ut
mamianartulia¦q	N	–p, –t
mamianartuliorne¦q	N	–rup, –rit
mamiasaari¦voq	V	–nngilaq
mamiasaa¦rpaa	V	–nngilaa
mamiasaarutig¦aa	V	–inngilaa
mamiasa¦rpaa	V	–nngilaa
mamiasu¦ppoq	V	–nngilaq
mamiasuutig¦aa	V	–inngilaa
mamiatsaat	N	–ip, –it
mamiatsaatig¦aa	V	–inngilaa
mamiatsaatiginni¦ppoq	V	–nngilaq
mamiatsanne¦q	N	–rup, –rit
mamiatsa¦ppoq	V	–nngilaq
mamiatsatsinneqart¦oq	N	–up, –ut
mamiatsatsi¦ppaa	V	–nngilaa
mamiatsatsitsine¦q	N	–rup, –rit
mamiatsatsitsis¦oq	N	–up, –ut
mamiatsatsitsi¦voq	V	–nngilaq
mamia¦voq	V	–nngilaq
mamigi¦ppoq	V	–nngilaq
mamiinaa¦rpaa	V	–nngilaa
mamiinaavi¦ppaa	V	–nngilaa
mami¦k	N	–up, –it
mamikkiartorne¦q	N	–rup, –rit
mamikkiart¦orpoq	V	–unngilaq
mamikkumaarnert¦ooq	N	–uup, –uut
mamikkumaarnertu¦voq	V	–nngilaq
mamil¦erpoq	V	–inngilaq
mamil¦ik	N	{–iup, –lip, –lup}, –lit
mamilikkaluttuinna¦rpoq	V	–nngilaq
mamili¦orpoq	V	–unngilaq
mamili¦ppoq	V	–nngilaq
mamilitsi¦ppaa	V	–nngilaa
mamili¦tsippaa	V	{–ssinngilaa, –tsinngilaa}
mamilu¦ppoq	V	–nngilaq
maminne¦q	N	–rup, –rit
maminneqanngits¦oq	N	–up, –ut
maminngaa¦rpoq	V	–nngilaq
maminnga¦voq	V	–nngilaq
mami¦ppoq	V	–nngilaq
mamisa¦rpaa	V	–nngilaa
mamisa¦rpoq	V	–nngilaq
mamissinnaanngits¦oq	N	–up, –ut
mamit	N, pl.	-
mamitaqqaja¦rpoq	V	–nngilaq
mamitarne¦q	N	–rup, –rit
mamita¦rpoq	V	–nngilaq
mamitarti¦ppaa	V	–nngilaa
mamiti¦ppaa	V	–nngilaa
mamit¦orpoq	V	–unngilaq
mami¦torpoq	V	{–sunngilaq, –tunngilaq}
mamits¦erpaa	V	–inngilaa
mamitsui¦ppoq	V	–nngilaq
mamiui¦ppoq	V	–nngilaq
mamma	Interj	(no generation)
mammaa¦rpoq	V	–nngilaq
mamma¦rpoq	V	–nngilaq
mammata¦ppoq	V	–nngilaq
mammine¦q	N	–rup, –rit
mammi¦voq	V	–nngilaq
mamm¦oorpoq	V	–uunngilaq
mamoqqaa¦q	N	–rup, –rit
mandoliina	N	–p, –t
mane¦q	N	–rup, –rit
maneqitsi¦vaa	V	–nngilaa
maneraanna¦q	N	–ap, –at
maneraa¦voq	V	–nngilaq
mane¦rak	N	–qqap, –qqat
manerassi¦orpoq	V	–unngilaq
manerass¦iorpoq	V	{–iunngilaq, –aliunngilaq}
Manerassu¦aq	N	–up, –it
Manerassu¦aq	Prop	–up, –it
manerassu¦aq	N	–up, –it
manerillua¦rpoq	V	–nngilaq
maneri¦ppoq	V	–nngilaq
manerisaa¦voq	V	–nngilaq
manerisimaa¦rpoq	V	–nngilaq
manerisima¦voq	V	–nngilaq
maneris¦imavoq	V	{–imanngilaq, –simanngilaq}
maneris¦imavoq	V	–simanngilaq
manerissi¦voq	V	–nngilaq
maneri¦ssoq	N	{–ssup, –ttup}, {–ssut, –ttut}
manerna¦q	N	–p, –t
manerna¦rpoq	V	–nngilaq
mangaannart¦oq	N	–up, –ut
manga¦ppaa	V	–nngilaa
mangiaane¦q	N	–rup, –rit
mangiaa¦voq	V	–nngilaq
mangia¦rpaa	V	–nngilaa
mangia¦rpoq	V	–nngilaq
mangi¦ppaa	V	–nngilaa
mangi¦ppoq	V	–nngilaq
mangullua¦rpaa	V	–nngilaa
mangu¦ppaa	V	–nngilaa
mangussaa¦ppaa	V	–tinngilaa
mangussa¦k	N	–ap, –at
mangussa¦ppoq	V	–nngilaq
mangussa¦q	N	–p, –t
manguss¦eq	N	–ip, –it
mangutseri¦voq	V	–nngilaq
manguts¦erpoq	V	–inngilaq
mangutseru¦ppaa	V	–tinngilaa
mangutsi¦voq	V	–nngilaq
manguttaaja¦rpoq	V	–nngilaq
manguttaajarsima¦voq	V	–nngilaq
manguttaajartaanna¦rpoq	V	–nngilaq
mangutta¦gaq	N	–kkap, –kkat
mangutta¦q	N	–p, –t
maniginnaa¦ppoq	V	–nngilaq
manig¦orpaa	V	–unngilaa
manig¦orpoq	V	–unngilaq
manigors¦erpoq	V	–inngilaq
manigui¦voq	V	–nngilaq
maniguuffig¦aa	V	–inngilaa
maniguukkajuppoq	V	(no generation)
maniguunna¦rpoq	V	–nngilaq
maniguunne¦q	N	–rup, –rit
maniguunnerpaa¦q	N	–p, –t
maniguunnerul¦erpoq	V	–inngilaq
maniguu¦ppoq	V	–tinngilaq
maniguutivi¦ppoq	V	–nngilaq
maniguutt¦oq	N	–up, –ut
maniikkunnaa¦rpoq	V	–nngilaq
maniilaaraqa¦rpoq	V	–nngilaq
maniilaats¦oq	N	–up, –ut
maniilaa¦voq	V	–nngilaq
maniilakuluppoq	V	(no generation)
maniilakulutsi¦ppoq	V	–nngilaq
maniilakulutt¦oq	N	–up, –ut
maniilakuluttuinnaa¦voq	V	–nngilaq
maniila¦ppoq	V	–nngilaq
maniil¦aq	N	–lap, –lat
maniilart¦ooq	N	–uup, –uut
maniileraa¦rpoq	V	–nngilaq
maniillaaraqa¦rpoq	V	–nngilaq
maniillat	N, pl.	-
maniilleraa¦rpoq	V	–nngilaq
maniill¦erpoq	V	–inngilaq
maniillersui¦voq	V	–nngilaq
maniilli¦voq	V	–nngilaq
maniinnal¦erpoq	V	–inngilaq
man¦iinnalerpoq	V	{–erinnalinngilaq, –iinnalinngilaq}
maniinne¦q	N	–rup, –rit
manii¦ppoq	V	–nngilaq
Maniits¦oq	N	–up, –ut
Maniits¦oq	Prop	–up
maniits¦oq	N	–up, –ut
Maniitsormiu	N	–p, –t
maniitsorsu¦aq	N	–up, –it
maniitsorsuu¦voq	V	–nngilaq
maniitsorsu¦uvoq	V	{–aanngilaq, –unngilaq}
Maniitsulia¦rpoq	V	–nngilaq
Maniitsumiillatsiarpoq	V	(no generation)
manikujutsi¦ppoq	V	–nngilaq
manikujutsisima¦voq	V	–nngilaq
manilerfig¦aa	V	–inngilaa
manilerisuu¦voq	V	–nngilaq
manileri¦voq	V	–nngilaq
manil¦erpaa	V	–inngilaa
manilluinna¦rpoq	V	–nngilaq
manillu¦innarpoq	V	{–aannanngilaq, –innanngilaq}
manioqqaa¦voq	V	–nngilaq
manioqqat	N	–ip, –it
manioraa¦voq	V	–nngilaq
mani¦ppoq	V	–nngilaq
manisa¦q	N	–p, –t
manisima¦vaa	V	–nngilaa
manisivi¦k	N	–up, –it
manisi¦voq	V	–nngilaq
manissaane¦q	N	–rup, –rit
manissaasarfi¦k	N	–up, –it
manissaassu¦aq	N	–up, –it
mani¦ssaassuaq	N	{–ssaassuup, –ttaassuup}, {–ssaassuit, –ttaassuit}
manissaat	N	–ip, –it
mani¦ssaat	N	{–ssaatip, –ttaatip}, {–ssaatit, –ttaatit}
manissaavi¦k	N	–up, –it
manissaa¦vik	N	{–ffiup, –viup}, {–ffiit, –viit}
manissaa¦voq	V	–nngilaq
manissa¦rpaa	V	–nngilaa
manissarsimas¦oq	N	–up, –ut
manissisi¦ppaa	V	–nngilaa
manissisitsine¦q	N	–rup, –rit
manissi¦voq	V	–nngilaq
maniss¦oq	N	–up, –ut
mani¦ssoq	N	{–ssup, –ttup}, {–ssut, –ttut}
manissorta¦q	N	–p, –t
mani¦ssortaq	N	{–ssortap, –ttortap}, {–ssortat, –ttortat}
manissuajaa¦q	N	–jup, –vit
manissu¦seq	N	–tsip, –tsit
manitsivi¦k	N	–up, –it
manitsiviu¦voq	V	–nngilaq
manittorne¦q	N	–rup, –rit
manitt¦orpoq	V	–unngilaq
manittuinnanng¦orpoq	V	–unngilaq
mani¦ttuinnanngorpoq	V	{–ssuinnanngunngilaq, –ttuinnanngunngilaq}
mani¦vaa	V	–nngilaa
mani¦voq	V	–nngilaq
ma¦nna	Pron	{–ssuma, –tuma}, {–kku, –kkua}
mannari¦k	N	–up, –it
mannari¦ppoq	V	–nngilaq
mannarivi¦ppoq	V	–nngilaq
manneeqqia¦rpoq	V	–nngilaq
mannee¦raq	N	–qqap, –qqat
mann¦eeraq	N	{–eeqqap, –iaqqap}, {–eeqqat, –iaqqat}
manneerartaat	N	–ip, –it
manneerartaat	N, pl.	-
mann¦eerartaat	N, pl.	{–eerartaat, –iarartaat}
manneerarta¦rpoq	V	–nngilaq
mannequsaa¦q	N	–p, –t
mannerna¦q	N	–ap, –at
manngaallaanna¦rpoq	V	–nngilaq
manngaallag¦aa	V	–inngilaa
manngaalla¦ppoq	V	–nngilaq
manngari¦ppoq	V	–nngilaq
manngarissu¦aq	N	–up, –it
manngeqqa¦k	N	–ap, –at
manngerluinnart¦oq	N	–up, –ut
manngerne¦q	N	–rup, –rit
manng¦erpoq	V	–inngilaq
manngerta¦q	N	–p, –t
manngertigu¦ppoq	V	–nngilaq
manngertinne¦q	N	–rup, –rit
manngerti¦ppaa	V	–nngilaa
manngerti¦ppoq	V	–nngilaq
manngertisimas¦oq	N	–up, –ut
manngertisimassu¦seq	N	–tsip, –tsit
manngerti¦sinneqarsinnaasoq	N	{–sinneqarsinnaasup, –tinneqarsinnaasup, –tsinneqarsinnaasup}, {–sinneqarsinnaasut, –tinneqarsinnaasut, –tsinneqarsinnaasut}
manngertissimas¦oq	N	–up, –ut
manngertissinnaas¦oq	N	–up, –ut
manngertitaane¦q	N	–rup, –rit
manngertiti¦ppaa	V	–nngilaa
manngertit¦ippaa	V	–sinngilaa
manngerti¦tippaa	V	{–sinngilaa, –tinngilaa, –tsinngilaa}
manngertitsine¦q	N	–rup, –rit
manngertitsi¦voq	V	–nngilaq
manngert¦oq	N	–up, –ut
manngertorneeru¦ppoq	V	–tinngilaq
manngertorne¦q	N	–rup, –rit
manngertorneqa¦rpoq	V	–nngilaq
manngertornerne¦q	N	–rup, –rit
manngertorn¦erpoq	V	–inngilaq
manngertorniiaasart¦oq	N	–up, –ut
manngertorniiaat	N	–ip, –it
manngertorniia¦rpaa	V	–nngilaa
manngertorningas¦oq	N	–up, –ut
manngertornis¦oq	N	–up, –ut
manngertorsu¦aq	N	–up, –it
manngertum¦ineq	N	–ernup, –ernit
manngikaajaa¦q	N	–p, –t
manngingaart¦oq	N	–up, –ut
manng¦oq	N	–up, –ut
manngori¦ppoq	V	–nngilaq
manngororlua¦rpaa	V	–nngilaa
manngor¦orpaa	V	–unngilaa
manng¦orpaa	V	–unngilaa
manng¦orpoq	V	–unngilaq
manngort¦ooq	N	–uup, –uut
mannguisa¦rpoq	V	–nngilaq
manngui¦voq	V	–nngilaq
manngu¦k	N	–up, –it
manngukinaa¦rpaa	V	–nngilaa
mannguki¦ppoq	V	–nngilaq
manngunikkiart¦orpoq	V	–unngilaq
mannguni¦ppoq	V	–nngilaq
manngunneqa¦rpoq	V	–nngilaq
manngu¦ppaa	V	–tinngilaa
manngu¦ppoq	V	–tinngilaq
mannguss¦erpaa	V	–inngilaa
manngussimas¦oq	N	–up, –ut
manngussuu¦ppaa	V	–tinngilaa
manngussuussi¦voq	V	–nngilaq
manngut¦sippaa	V	{–inngilaa, –sinngilaa, –itinngilaa}
manngut¦sippoq	V	{–itinngilaq, –sinngilaq}
mannguusarne¦q	N	–rup, –rit
manni¦k	N	–up, –it
mannilia¦q	N	–p, –t
manniliarne¦q	N	–rup, –rit
mannilia¦rpoq	V	–nngilaq
manniliorne¦q	N	–rup, –rit
mannili¦orpoq	V	–unngilaq
manniliortart¦oq	N	–up, –ut
manniliort¦oq	N	–up, –ut
mannissaa¦q	N	–p, –t
manniss¦aliorfik	N	{–aliorfiup, –iorfiup}, {–aliorfiit, –iorfiit}
mannissa¦q	N	–p, –t
mannissaqarfiit	N, pl.	-
mannissaqarfi¦k	N	–up, –it
mannissariarne¦q	N	–rup, –rit
mannissaria¦rpoq	V	–nngilaq
mannissa¦rpoq	V	–nngilaq
mannissi¦orpoq	V	–unngilaq
manniss¦iorpoq	V	{–iunngilaq, –aliunngilaq}
mannissorfi¦k	N	–up, –it
manniss¦orpoq	V	–unngilaq
manniusaa¦q	N	–p, –t
manniusa¦q	N	–p, –t
mannivig¦aa	V	–inngilaa
mannivigiinna¦rpaa	V	–nngilaa
manoqus¦erpaa	V	–inngilaa
manoqu¦t	N	{–t, –p}, –t
manorlu¦ppoq	V	–nngilaq
manormi¦ppaa	V	–nngilaa
manorsiu¦t	N	{–t, –p}, –t
manu	N	–up, –it
manull¦orpoq	V	–unngilaq
manusine¦q	N	–rup, –rit
mappaa¦rpoq	V	–nngilaq
mapperlua¦rpaa	V	–nngilaa
mapp¦erpaa	V	–inngilaa
mapp¦erpoq	V	–inngilaq
mappersa¦gaq	N	–kkap, –kkat
mappersakkat	N, pl.	-
mappersi¦gaq	N	–kkap, –kkat
mappersimas¦oq	N	–up, –ut
mappersima¦voq	V	–nngilaq
mappers¦oorpaa	V	–uunngilaa
mappers¦oorpoq	V	–uunngilaq
mappert¦oq	N	–up, –ut
mapper¦toq	N	{–sup, –tup}, {–sut, –tut}
mapperukkiart¦orpaa	V	–unngilaa
mapperu¦ppoq	V	–tinngilaq
mappiiniut	N	–ip, –it
mappikaa¦rpoq	V	–nngilaq
mappikaart¦oq	N	–up, –ut
mappika¦rpoq	V	–nngilaq
mappila¦ppoq	V	–nngilaq
mappila¦voq	V	–nngilaq
mappiukkiart¦orpaa	V	–unngilaa
mappiunnia¦rpaa	V	–nngilaa
mappiu¦ppaa	V	–tinngilaa
mappiussa¦q	N	–p, –t
mappiussi¦voq	V	–nngilaq
maqaajallaanna¦rpoq	V	–nngilaq
maqaajalla¦ppoq	V	–nngilaq
maqaa¦ppoq	V	{–nngilaq, –tinngilaq}
maqaasig¦aa	V	–inngilaa
maqaasigaju¦ppoq	V	–nngilaq
maqaasinaqaaq	V	(no generation)
maqaasina¦rpoq	V	–nngilaq
maqaasine¦q	N	–rup, –rit
maqaasineqart¦oq	N	–up, –ut
maqaasisa¦q	N	–p, –t
maqaasisa¦rpoq	V	–nngilaq
maqaasiua¦rpaa	V	–nngilaa
maqaasiua¦rpoq	V	–nngilaq
maqaasi¦vaa	V	–nngilaa
maqaasivallaassaqaaq	V	(no generation)
maqaasi¦voq	V	–nngilaq
maqiffi¦k	N	–up, –it
maqigaaru¦ppoq	V	–tinngilaq
maqi¦gaq	N	–kkap, –kkat
maqigi¦aq	N	–ssap, –ssat
maqine¦q	N	–rup, –rit
maqing¦erpoq	V	–inngilaq
maqi¦ppaa	V	–nngilaa
maqi¦ppoq	V	–nngilaq
maqisaat	N	–ip, –it
maqisa¦rpaa	V	–nngilaa
maqisoorne¦q	N	–rup, –rit
maqis¦oorpoq	V	–uunngilaq
maqisorsuu¦voq	V	–nngilaq
maqisorsu¦uvoq	V	{–aanngilaq, –unngilaq}
maqisuinnanng¦orpoq	V	–unngilaq
maqita¦q	N	–p, –t
maqitassa¦q	N	–p, –t
maqiterine¦q	N	–rup, –rit
maqiteri¦voq	V	–nngilaq
maqit¦erpaa	V	–inngilaa
maqiti¦ppaa	V	–nngilaa
maqit¦ippaa	V	–sinngilaa
maqitsine¦q	N	–rup, –rit
maqitsi¦voq	V	–nngilaq
maqittaanna¦rpoq	V	–nngilaq
maqittarfi¦k	N	–up, –it
maqi¦ttarfik	N	{–ssarfiup, –ttarfiup}, {–ssarfiit, –ttarfiit}
maqi¦voq	V	–nngilaq
maqqalla¦ppoq	V	–nngilaq
maqqallassaat	N	–ip, –it
maqqallassaatissa¦q	N	–p, –t
maqqallu¦k	N	–up, –it
maqqallu¦ppoq	V	–nngilaq
maqqa¦q	N	–ap, –at
maqqarfi¦k	N	–up, –it
maqqata¦ppoq	V	–nngilaq
maqqerlu¦ppoq	V	–nngilaq
maqq¦erpoq	V	–inngilaq
maqqiu¦ppaa	V	–tinngilaa
maqulluinnaa¦voq	V	–nngilaq
maqullu¦k	N	–up, –it
maqulluni¦ppoq	V	–nngilaq
maqullussunni¦ppoq	V	–nngilaq
maqunna¦q	N	–p, –t
maqunna¦rpoq	V	–nngilaq
maqunnart¦oq	N	–up, –ut
marajuinnaa¦voq	V	–nngilaq
marallu¦k	N	–up, –it
maralluni¦ppoq	V	–nngilaq
marallunng¦orpoq	V	–unngilaq
marallussu¦aq	N	–up, –it
marane¦q	N	–rup, –rit
maranersunni	N	–p, –t
maranersunni	N	–up, –it
maranga¦voq	V	–nngilaq
maraniinnaa¦voq	V	–nngilaq
maran¦iinnaavoq	V	{–erinnaanngilaq, –iinnaanngilaq}
maraniusa¦q	N	–p, –t
maraniu¦voq	V	–nngilaq
mararna	N	–p, –t
marasis¦oq	N	–up, –ut
marloqiusaassu¦seq	N	–tsip, –tsit
marloqiusaa¦voq	V	–nngilaq
marloqiusanngorne¦q	N	–rup, –rit
marloqiusanngortitsine¦q	N	–rup, –rit
marloqiusa¦q	N	–p, –t
marloqqat	N, pl.	-
marloraaginna¦rpoq	V	–nngilaq
marloraa¦rpoq	V	–nngilaq
marloraarsima¦voq	V	–nngilaq
marloral¦ik	N	{–iup, –lip, –lup}, –lit
marlo¦raq	N	–qqap, –qqat
marloriaa¦seqqippaa	V	{–seqqinngilaa, –tileqqinngilaa}
marloriaatinngorti¦ppaa	V	–nngilaa
marloriaatinngortitsine¦q	N	–rup, –rit
marloriaatit	N, pl.	-
marloriaganngorti¦ppaa	V	–nngilaa
marloriaganngortitsine¦q	N	–rup, –rit
marloria¦gaq	N	–kkap, –kkat
marloriarne¦q	N	–rup, –rit
marloriarpaa	V	(no generation)
marloria¦rpoq	V	–nngilaq
marlorsiut	N	–ip, –it
marlorsiutaas¦oq	N	–up, –ut
marluit	N, pl.	-
marluk	Num, pl.	-
marlu¦k	N	–up, –it
marlukkaat	N, pl.	-
marlukkuutaarne¦q	N	–rup, –rit
marluliaateqa¦rpoq	V	–nngilaq
marlulia¦q	N	–p, –t
marluli¦aq	N	–ssap, –ssat
marluligaju¦ppoq	V	–nngilaq
marlul¦ik	N	{–iup, –lip, –lup}, –lit
marlulissat	N, pl.	-
marluli¦voq	V	–nngilaq
marlunngorlua¦rpoq	V	–nngilaq
marlunngorne¦q	N	–rup, –rit
marlunngorneru¦voq	V	–nngilaq
marlunng¦orpaa	V	–unngilaa
marlunngorpia¦rpoq	V	–nngilaq
marlunng¦orpoq	V	–unngilaq
marlunngorti¦ppaa	V	–nngilaa
marlunngortiterisaa¦seq	N	–tsip, –tsit
marlunngort¦oq	N	–up, –ut
marlussa¦q	N	–p, –t
marlussuit	N, pl.	-
marl¦ussuit	N, pl.	{–orsuit, –ussuit}
Marluuffi¦k	N	–up, –it
marluuniat	N, pl.	-
marluussa¦q	N	–p, –t
marluussu¦seq	N	–tsip, –tsit
marluuttari¦aq	N	{–ssap, –ap}, {–ssat, –at}
marluuttari¦aq	N	–ssap, –ssat
marm¦oorpoq	V	–uunngilaq
marneeru¦ppoq	V	–tinngilaq
marne¦q	N	–rup, –rit
marnersunni	N	–p, –t
marnersunni	N	–up, –it
marnginna¦rpoq	V	–nngilaq
marngusa¦q	N	–p, –t
marnil¦ik	N	{–iup, –lip, –lup}, –lit
marniliorne¦q	N	–rup, –rit
marnili¦orpoq	V	–unngilaq
marniliort¦oq	N	–up, –ut
marniliuttoorne¦q	N	–rup, –rit
marniliuunne¦q	N	–rup, –rit
marniliuu¦ppoq	V	–tinngilaq
marniliuuttoorne¦q	N	–rup, –rit
marnininne¦q	N	–rup, –rit
marnini¦ppoq	V	–nngilaq
marninissa¦rpoq	V	–nngilaq
marnini¦ssarpoq	V	–ttanngilaq
marnu¦saq	N	–tsap, –tsat
Marokko	Prop	–p, –t
Marokkom¦eersoq	N	{–eersup, –eertup, –inngaanneersup, –inngaanneertup, –inngaanninngaanneersup, –inngaanninngaanneertup}, {–eersut, –eertut, –inngaanneersut, –inngaanneertut, –inngaanninngaanneersut, –inngaanninngaanneertut}
Marokkomioq	N	(no generation)
Marokko¦miu	N	{–miup, –rmiup}, {–miut, –rmiut}
marraanna¦q	N	–ap, –at
marraasal¦ik	N	{–iup, –lip, –lup}, –lit
marraasa¦q	N	–p, –t
marraasartuu¦voq	V	–nngilaq
marraasivi¦k	N	–up, –it
marraat	N	–ip, –it
marraa¦voq	V	–nngilaq
marram¦ineq	N	–ernup, –ernit
marranga¦voq	V	–nngilaq
marra¦q	N	–ap, –at
marraqart¦oq	N	–up, –ut
marrarasa¦ppoq	V	–nngilaq
marrarasattuinnaa¦voq	V	–nngilaq
marra¦rpaa	V	–nngilaa
marrarsiorfi¦k	N	–up, –it
marrarsu¦aq	N	–up, –it
marrart¦erpaa	V	–inngilaa
marrarterut	N	–ip, –it
marria¦q	N	–p, –t
marriassa¦q	N	–p, –t
marriffi¦k	N	–up, –it
marrikkiart¦orpoq	V	–unngilaq
marrinnart¦oq	N	–up, –ut
marriorfi¦k	N	–up, –it
marriorne¦q	N	–rup, –rit
marri¦orpoq	V	–unngilaq
marriort¦oq	N	–up, –ut
marriortuu¦voq	V	–nngilaq
marri¦ppoq	V	–nngilaq
marrisimaa¦rpoq	V	–nngilaq
marriu¦gaq	N	–kkap, –kkat
marriuut	N	–ip, –it
marriuutaa¦voq	V	–nngilaq
mars¦erpaa	V	–inngilaa
mars¦erpoq	V	–inngilaq
marsi	N	–p, –t
marsinaqaaq	V	(no generation)
marsi¦voq	V	–nngilaq
marujuinnaa¦voq	V	–nngilaq
maruju¦k	N	–up, –it
marulloqarfi¦k	N	–up, –it
marulluinnaa¦voq	V	–nngilaq
marullu¦k	N	–up, –it
marullul¦ik	N	{–iup, –lip, –lup}, –lit
marullussu¦aq	N	–up, –it
marulluus¦oq	N	–up, –ut
masa¦k	N	–ap, –at
masal¦erpoq	V	–inngilaq
masammiu¦voq	V	–nngilaq
masanna¦rpoq	V	–nngilaq
masannart¦oq	N	–up, –ut
masannaveeqqus¦erpaa	V	–inngilaa
masannaveeqqu¦serpaa	V	{–sinngilaa, –tilinngilaa}
masannaveeqqut	N	–ip, –it
masannaveeqqutaa¦voq	V	–nngilaq
masa¦ppoq	V	–nngilaq
masaqaaq	V	(no generation)
masarleri¦voq	V	–nngilaq
masarl¦erpaa	V	–inngilaa
masarl¦erpoq	V	–inngilaq
masarlerussu¦aq	N	–up, –it
masarlerut	N	–ip, –it
masarsoqarfi¦k	N	–up, –it
masarsu¦k	N	–up, –it
masarsuni¦ppoq	V	–nngilaq
masarsussu¦aq	N	–up, –it
masarsuus¦oq	N	–up, –ut
masarsuu¦voq	V	–nngilaq
masassimaqaaq	V	(no generation)
masatalaarnaqaaq	V	(no generation)
masatalaa¦rpoq	V	–nngilaq
masatsaalivaa	V	(no generation)
masatseri¦voq	V	–nngilaq
masats¦erpaa	V	–inngilaa
masatserut	N	–ip, –it
masattaali¦vaa	V	–nngilaa
masatt¦oq	N	–up, –ut
masattorujussu¦aq	N	–up, –it
masattorujussu¦usoq	N	{–aasup, –usup}, {–aasut, –usut}
masattuli¦orpoq	V	–unngilaq
masianniler¦soq	N	{–sup, –tup}, {–sut, –tut}
masianni¦ppoq	V	–nngilaq
masiannitt¦oq	N	–up, –ut
masianni¦ttoq	N	{–ssup, –ttup}, {–ssut, –ttut}
masigiss¦oq	N	–up, –ut
masigi¦ssoq	N	{–ssup, –ttup}, {–ssut, –ttut}
masi¦k	N	–up, –it
masilu¦ppoq	V	–nngilaq
masilutt¦oq	N	–up, –ut
masimmiu	N	–p, –t
maskiina	N	–p, –t
maskiinaajarne¦q	N	–rup, –rit
maskiinaaja¦rpoq	V	–nngilaq
maskiinaleriffi¦k	N	–up, –it
maskiinalerine¦q	N	–rup, –rit
maskiinaleris¦oq	N	–up, –ut
maskiinalerisuune¦q	N	–rup, –rit
maskiinaliorfi¦k	N	–up, –it
maskiinali¦orpoq	V	–unngilaq
maskiinaliort¦oq	N	–up, –ut
maskiinaqanngilaq	V	(no generation)
maskiinaqarfi¦k	N	–up, –it
maskiinartaa¦rpoq	V	–nngilaq
maskinmesteriune¦q	N	–rup, –rit
mass	Interj	(no generation)
massa	Interj	(no generation)
massaas¦erpaa	V	–inngilaa
massaa¦serpaa	V	{–sinngilaa, –tilinngilaa}
massaat	N	–ip, –it
massaatig¦aa	V	–inngilaa
massaa¦voq	V	–nngilaq
massa¦k	N	–ap, –at
massakkut	N, pl.	-
massakkuunngits¦oq	N	–up, –ut
massalaanngu¦aq	N	–up, –it
massala¦voq	V	–nngilaq
massali¦ppoq	V	–nngilaq
massalitt¦oq	N	–up, –ut
massali¦ttoq	N	{–ssup, –ttup}, {–ssut, –ttut}
massami	Interj	(no generation)
massa¦ppaa	V	–nngilaa
massappalla¦ppoq	V	–nngilaq
massap¦pallappoq	V	{–allanngilaq, –pallanngilaq}
massarlua¦rpaa	V	–nngilaa
massa¦rpaa	V	–nngilaa
masseria¦rpoq	V	–nngilaq
masserii¦ppoq	V	–nngilaq
mass¦erpaa	V	–inngilaa
mass¦erpoq	V	–inngilaq
massers¦oq	N	–up, –ut
masser¦soq	N	{–sup, –tup}, {–sut, –tut}
massii¦ppoq	V	–nngilaq
massii¦voq	V	–nngilaq
massika¦rpoq	V	–nngilaq
massili¦ppoq	V	–nngilaq
massimaa¦rpoq	V	–nngilaq
massi¦ppoq	V	–nngilaq
massisimaa¦rpoq	V	–nngilaq
massisima¦voq	V	–nngilaq
massis¦imavoq	V	–simanngilaq
massisi¦ppaa	V	–nngilaa
massivillarpoq	V	(no generation)
massorarsi¦vaa	V	–nngilaa
mass¦orpaa	V	–unngilaa
massuanert¦ooq	N	–uup, –uut
massuati¦ppaa	V	–nngilaa
massua¦voq	V	–nngilaq
massui¦ppoq	V	–nngilaq
massula¦voq	V	–nngilaq
massuli¦ppoq	V	–nngilaq
massulitt¦oq	N	–up, –ut
massuli¦ttoq	N	{–ssup, –ttup}, {–ssut, –ttut}
massulittuinnaa¦voq	V	–nngilaq
massuli¦ttuinnaavoq	V	{–ssuinnaanngilaq, –ttuinnaanngilaq}
massull¦erpoq	V	–inngilaq
massunnaas¦erpaa	V	–inngilaa
massu¦ppaa	V	–nngilaa
massussaa¦voq	V	–nngilaq
massussa¦q	N	–p, –t
matematikki	N	(no generation)
matertaaja¦rpoq	V	–nngilaq
matertaa¦rpaa	V	–nngilaa
materteq	N	(no generation)
matertersiut	N	–ip, –it
materti	N	–p, –t
matertik¦oq	N	–up, –ut
matertilers¦orpoq	V	–unngilaq
matoorneqa¦rpoq	V	–nngilaq
mat¦oorpaa	V	–uunngilaa
matoorti¦ppaa	V	–nngilaa
matooru¦ppaa	V	–tinngilaa
matoorussaa¦voq	V	–nngilaq
matoorussa¦q	N	–p, –t
matoorussi¦voq	V	–nngilaq
matoqanngilaq	V	(no generation)
matoqanngits¦oq	N	–up, –ut
matoqqarpaa	V	(no generation)
matoqqas¦oq	N	–up, –ut
matoqqavoq	V	(no generation)
matorlu¦ppaa	V	–nngilaa
matorlu¦ppoq	V	–nngilaq
mat¦orpallanneq	N	{–orpallannerup, –upallannerup}, {–orpallannerit, –upallannerit}
matorpallassa¦aq	V	–nngilaq
matorpallattarpaa	V	(no generation)
matorsu¦aq	N	–up, –it
matsappalu¦ppoq	V	–nngilaq
matsa¦ppoq	V	–nngilaq
matsats¦erpaa	V	–inngilaa
matsatsi¦gaq	N	–kkap, –kkat
matserfi¦k	N	–up, –it
matserfili¦orpoq	V	–unngilaq
matserfissa¦q	N	–p, –t
matserfiss¦ooq	N	–uup, –uut
matserfittaa¦rpoq	V	–nngilaq
mats¦erpaa	V	–inngilaa
matsiu¦ppaa	V	–tinngilaa
matsui¦ppoq	V	–nngilaq
matsuitsoqa¦rpoq	V	–nngilaq
mattaajaa¦voq	V	–nngilaq
mattaajagaa¦voq	V	–nngilaq
mattaaja¦rpaa	V	–nngilaa
mattaangajui¦ppoq	V	–nngilaq
mattaangajunnaa¦rpoq	V	–nngilaq
mattaanga¦voq	V	–nngilaq
mattaarnia¦q	N	–p, –t
mattaarniart¦oq	N	–up, –ut
mattaas¦orpoq	V	–unngilaq
mattagu¦ppoq	V	–nngilaq
matta¦k	N	–ap, –at
mattaka¦rpaa	V	–nngilaa
mattaka¦rpoq	V	–nngilaq
mattakarsima¦voq	V	–nngilaq
mattal¦ik	N	{–iup, –lip, –lup}, –lit
mattalinnia¦rpoq	V	–nngilaq
mattali¦ppoq	V	–nngilaq
mattalissu¦aq	N	–up, –it
mattal¦issuaq	N	{–ersuup, –issuup}, {–ersuit, –issuit}
mattall¦erpoq	V	–inngilaq
mattaminaatsia¦q	N	–rup, –rit
mattam¦ineq	N	–ernup, –ernit
mattanna¦ppoq	V	–nngilaq
mattanng¦erpoq	V	–inngilaq
mattapa¦ppoq	V	–nngilaq
matta¦rpaa	V	–nngilaa
matta¦rpoq	V	–nngilaq
mattart¦erpoq	V	–inngilaq
mattassi¦ppaa	V	–nngilaa
mattassi¦voq	V	–nngilaq
mattatt¦orpoq	V	–unngilaq
mattoqut	N	–ip, –it
mattorl¦erpoq	V	–inngilaq
mattorlugaa¦voq	V	–nngilaq
mattorlu¦ppaa	V	–nngilaa
mattorlu¦ppoq	V	–nngilaq
mattuallaaqaaq	V	(no generation)
mattuffi¦k	N	–up, –it
mattuffitoq¦aq	N	–qap, –qat
mattulaa¦rpoq	V	–nngilaq
mattune¦q	N	–rup, –rit
mattunersa¦q	N	–p, –t
mattunnillua¦rpoq	V	–nngilaq
mattunni¦ppoq	V	–nngilaq
mattu¦ppaa	V	–tinngilaa
mattu¦ppoq	V	–tinngilaq
mattu¦serpaa	V	{–sinngilaa, –tilinngilaa}
mattu¦serpaa	V	–tilinngilaa
mattu¦sersimasoq	N	{–sersimasup, –tilersimasup}, {–sersimasut, –tilersimasut}
mattusersorne¦q	N	–rup, –rit
mattu¦sersorneq	N	{–sersornerup, –tilersornerup}, {–sersornerit, –tilersornerit}
mattu¦sersorpaa	V	{–sersunngilaa, –tilersunngilaa}
mattu¦sersorpoq	V	{–sersunngilaq, –tilersunngilaq}
mattu¦sersuivoq	V	{–sersuinngilaq, –tilersuinngilaq}
mattu¦sigaaneq	N	{–sigaanerup, –tiligaanerup}, {–sigaanerit, –tiligaanerit}
mattu¦sigaavoq	V	{–sigaanngilaq, –tiligaanngilaq}
mattusiine¦q	N	–rup, –rit
mattus¦iineq	N	{–iinerup, –siinerup}, {–iinerit, –siinerit}
mattu¦siineq	N	{–siinerup, –tiliinerup}, {–siinerit, –tiliinerit}
mattu¦siivoq	V	{–siinngilaq, –tiliinngilaq}
mattusimaannarne¦q	N	–rup, –rit
mattusimaannarpoq	V	(no generation)
mattusimatinneqa¦rpoq	V	–nngilaq
mattusimati¦ppaa	V	–nngilaa
mattusiu¦ppaa	V	–tinngilaa
mattu¦siuppaa	V	{–siutinngilaa, –tiliutinngilaa}
mattusiussa¦q	N	–p, –t
mattu¦siussaq	N	{–siussap, –tiliussap}, {–siussat, –tiliussat}
mattu¦sooq	N	{–suup, –tuup}, {–suut, –tuut}
mattu¦soorsuaq	N	{–soorsuup, –toorsuup}, {–soorsuit, –toorsuit}
mattussaagallarfi¦k	N	–up, –it
mattussaane¦q	N	–rup, –rit
mattussaa¦voq	V	–nngilaq
mattussine¦q	N	–rup, –rit
mattussi¦vik	N	{–ffiup, –viup}, {–ffiit, –viit}
mattussi¦voq	V	–nngilaq
mattussui¦voq	V	–nngilaq
mattussu¦seq	N	–tsip, –tsit
mattut	N	–ip, –it
mattutaari¦voq	V	–nngilaq
mattutaa¦rpaa	V	–nngilaa
mattutaa¦voq	V	–nngilaq
mattutissaliort¦oq	N	–up, –ut
mattutiss¦aliortoq	N	{–aliortup, –iortup}, {–aliortut, –iortut}
mattutissa¦q	N	–p, –t
mattutissia¦q	N	–p, –t
mattut¦sinneq	N	{–innerup, –sinnerup, –itinnerup}, {–innerit, –sinnerit, –itinnerit}
mattut¦sippoq	V	{–itinngilaq, –sinngilaq}
mattutsisaane¦q	N	–rup, –rit
mattutt¦oq	N	–up, –ut
mattuttoqarne¦q	N	–rup, –rit
mattuttoqatigiit	N, pl.	-
mattu¦voq	V	–nngilaq
matu	N	–p, –t
matu¦aa	V	–nngilaa
matua¦raq	N	–qqap, –qqat
matuerfig¦aa	V	–inngilaa
matu¦erpaa	V	–inngilaa
matu¦erpoq	V	–inngilaq
matuersaaserfi¦k	N	–up, –it
matuersaa¦serfik	N	{–serfiup, –tilerfiup}, {–serfiit, –tilerfiit}
matuer¦saaserfik	N	{–saaserfiup, –saatilerfiup, –taaserfiup, –taatilerfiup, –saaterfiup}, {–saaserfiit, –saatilerfiit, –taaserfiit, –taatilerfiit, –saaterfiit}
matuersaat	N	–ip, –it
matuer¦saat	N	{–saatip, –taatip}, {–saatit, –taatit}
matuersart¦oq	N	–up, –ut
matuers¦oorpoq	V	–uunngilaq
matuffissa¦q	N	–p, –t
matugisaliussa¦q	N	–p, –t
matugisa¦q	N	–p, –t
matuiiffig¦aa	V	–inngilaa
matuiisart¦oq	N	–up, –ut
matuiu¦ppaa	V	–tinngilaa
matujumaarpoq	V	(no generation)
matujuminaatta¦rpoq	V	–nngilaq
matujunna¦rpaa	V	–nngilaa
matukannerpoq	V	(no generation)
matukkaa¦q	N	–p, –t
matuleris¦oq	N	–up, –ut
matul¦erpaa	V	–inngilaa
matulers¦orpaa	V	–unngilaa
matul¦ik	N	{–iup, –lip, –lup}, –lit
matuliu¦ppaa	V	–tinngilaa
matuliussaa¦voq	V	–nngilaq
matuliussa¦q	N	–p, –t
matuliutta¦gaq	N	–kkap, –kkat
matulluarsinnaanngilaq	V	(no generation)
matullu¦innarpoq	V	{–innanngilaq, –aannanngilaq}
matumanii¦ppoq	V	–nngilaq
ma¦tumaniippoq	V	{–ssumaniinngilaq, –tumaniinngilaq}
matuneqanngits¦oq	N	–up, –ut
matuneqarne¦q	N	–rup, –rit
matunissa¦q	N	–p, –t
matunngu¦aq	N	–up, –it
mat¦upallappaa	V	{–orpallanngilaa, –upallanngilaa}
matupallassaaq	V	(no generation)
matupallattarpaa	V	(no generation)
matusaaqqajaas¦oq	N	–up, –ut
matusaat	N	–ip, –it
matusaa¦voq	V	–nngilaq
matusart¦oq	N	–up, –ut
matusimas¦oq	N	–up, –ut
matusima¦voq	V	–nngilaq
matusine¦q	N	–rup, –rit
matusinia¦rpoq	V	–nngilaq
matusiniut	N	–ip, –it
matusiort¦oq	N	–up, –ut
matusissutissaqanngits¦oq	N	–up, –ut
matusissutissat	N, pl.	-
matusi¦voq	V	–nngilaq
matussu¦serpaa	V	{–sinngilaa, –tilinngilaa}
matussu¦siisinnaassuseq	N	{–siisinnaassutsip, –tiliisinnaassutsip}, {–siisinnaassutsit, –tiliisinnaassutsit}
matussutissa¦q	N	–p, –t
matussutissaqanngits¦oq	N	–up, –ut
matutaat	N, pl.	-
matuta¦rpaa	V	–nngilaa
matutartaas¦erpaa	V	–inngilaa
matutartaa¦serpaa	V	{–sinngilaa, –tilinngilaa}
matuuisart¦oq	N	–up, –ut
matu¦voq	V	–nngilaq
Mauretanien	Prop	(no generation)
medaalia	N	(no generation)
medaaliannanne¦q	N	–rup, –rit
meeqqanoort¦oq	N	–up, –ut
meeqqat	N, pl.	-
meeqqerillaqqi¦ppoq	V	–nngilaq
meeqqerisaanna¦rpoq	V	–nngilaq
meeqqeris¦oq	N	–up, –ut
meeqqerisuu¦voq	V	–nngilaq
meeqqeriviit	N, pl.	-
meeqqerivi¦k	N	–up, –it
meeqqerivimmii¦titsineq	N	{–sitsinerup, –titsinerup, –tsitsinerup}, {–sitsinerit, –titsinerit, –tsitsinerit}
meeqqeri¦voq	V	–nngilaq
meeqqi¦orpoq	V	–unngilaq
meeqqisaa¦rpoq	V	–nngilaq
meeqqisakatatta¦rpoq	V	–nngilaq
meeqqisa¦rpoq	V	–nngilaq
meeraaffi¦k	N	–up, –it
meeraajunnaa¦rpoq	V	–nngilaq
meeraane¦q	N	–rup, –rit
meeraanilersaarutit	N, pl.	-
meeraaqqeriffi¦k	N	–up, –it
meeraaqqerivi¦k	N	–up, –it
meeraa¦raq	N	–qqap, –qqat
meeraasaa¦rpoq	V	–nngilaq
meeraats¦oq	N	–up, –ut
meeraavallaa¦rpoq	V	–nngilaq
meeraa¦voq	V	–nngilaq
meeralisa¦rpoq	V	–nngilaq
meerangas¦oq	N	–up, –ut
meerangassu¦seq	N	–tsip, –tsit
meeranngu¦aq	N	–up, –it
meerapalaa¦q	N	–p, –t
mee¦raq	N	–qqap, –qqat
meeraqarfig¦aa	V	–inngilaa
meeraqarluart¦oq	N	–up, –ut
meeraqat	N	–ip, –it
meerarpallanne¦q	N	–rup, –rit
meerarpalla¦ppoq	V	–nngilaq
meerarpallatt¦oq	N	–up, –ut
meerarpalunne¦q	N	–rup, –rit
meerarpalu¦ppoq	V	–nngilaq
meerarpalussu¦seq	N	–tsip, –tsit
meerarpalutt¦oq	N	–up, –ut
meerarsia¦q	N	–p, –t
meerartaa¦rpoq	V	–nngilaq
meerartaarsinnaajunnaar¦sitaaneq	N	{–sitaanerup, –titaanerup}, {–sitaanerit, –titaanerit}
meerartaarsinnaannginne¦q	N	–rup, –rit
meerartaarta¦rpoq	V	–nngilaq
meerassa¦q	N	–p, –t
meerassi¦voq	V	–nngilaq
meeratua¦q	N	–p, –t
meeravissial¦ik	N	{–iup, –lip, –lup}, –lit
meeravissiallit	N, pl.	-
meeravissia¦q	N	–p, –t
meeravissiartaarne¦q	N	–rup, –rit
meerpalla¦ppoq	V	–nngilaq
m¦eerpallappoq	V	{–eerpallanngilaq, –iipallanngilaq}
m¦eerpoq	V	–iinngilaq
meertorne¦q	N	–rup, –rit
meert¦orpoq	V	–unngilaq
meerujussa¦rpaa	V	–nngilaa
meerujutsi¦ppoq	V	–nngilaq
meerujuus¦oq	N	–up, –ut
meerujuussu¦seq	N	–tsip, –tsit
meerujuu¦voq	V	–nngilaq
Melanesien	Prop	(no generation)
meqqerfi¦k	N	–up, –it
meqqerfiki¦ppoq	V	–nngilaq
meqqerfissu¦voq	V	–nngilaq
meqqi	N	–p, –t
meqqil¦erpaa	V	–inngilaa
meqqilii¦voq	V	–nngilaq
meqqit	N, pl.	-
meqq¦oq	N	–up, –ut
meqqoqanngits¦oq	N	–up, –ut
meqqoqarfi¦k	N	–up, –it
meqqoqart¦oq	N	–up, –ut
meqqori¦ppoq	V	–nngilaq
meqqorissaa¦voq	V	–nngilaq
meqqorissa¦rpaa	V	–nngilaa
meqqori¦ssarpoq	V	–ttanngilaq
meqqorissi¦voq	V	–nngilaq
meqqoriss¦oq	N	–up, –ut
meqqori¦ssoq	N	{–ssup, –ttup}, {–ssut, –ttut}
meqqorl¦erpoq	V	–inngilaq
meqqorlu¦ppoq	V	–nngilaq
meqqort¦erpaa	V	–inngilaa
meqqor¦tujaarpoq	V	{–tujaanngilaq, –sujaanngilaq}
meqqortusi¦voq	V	–nngilaq
meqqu¦erpoq	V	–inngilaq
meqquersima¦voq	V	–nngilaq
meqqueru¦ppoq	V	–tinngilaq
meqquiaane¦q	N	–rup, –rit
meqqu¦iaaneq	N	{–ajaanerup, –iaanerup}, {–ajaanerit, –iaanerit}
meqquiaanna¦rpaa	V	–nngilaa
meqqu¦iaannarpaa	V	{–ajaannanngilaa, –iaannanngilaa}
meqquia¦rpaa	V	–nngilaa
meqqu¦iarpaa	V	{–ajanngilaa, –ianngilaa}
meqquinnavi¦k	N	–up, –it
meqqui¦ppoq	V	–nngilaq
meqquits¦oq	N	–up, –ut
meqquj¦ooq	N	–uup, –uut
meqqujoorsu¦aq	N	–up, –it
meqqul¦erpaa	V	–inngilaa
meqqul¦ik	N	{–iup, –lip, –lup}, –lit
meqqulinng¦orpaa	V	–unngilaa
meqqulissu¦aq	N	–up, –it
meqqul¦issuaq	N	{–ersuup, –issuup}, {–ersuit, –issuit}
meqqulual¦ik	N	{–iup, –lip, –lup}, –lit
meqqulualius¦oq	N	–up, –ut
meqquluani¦ppoq	V	–nngilaq
meqqulua¦q	N	–p, –t
meqquluart¦ooq	N	–uup, –uut
meqqunikkiart¦orpoq	V	–unngilaq
meqquni¦ppoq	V	–nngilaq
meqqu¦ppoq	V	–tinngilaq
meqqus¦erpaa	V	–inngilaa
meqqu¦serpaa	V	{–sinngilaa, –tilinngilaa}
meqqus¦erpoq	V	–inngilaq
meqqu¦serpoq	V	{–sinngilaq, –tilinngilaq}
meqqusersuu¦ppaa	V	–tinngilaa
meqqusi¦orpoq	V	–unngilaq
meqqu¦siorpoq	V	{–siunngilaq, –tiliunngilaq}
meqqusiort¦oq	N	–up, –ut
meqqu¦siortoq	N	{–siortup, –tiliortup}, {–siortut, –tiliortut}
meqqusiuu¦ppaa	V	–tinngilaa
meqqu¦siuuppaa	V	{–siuutinngilaa, –tiliuutinngilaa}
meqqusivi¦k	N	–up, –it
meqqusi¦voq	V	–nngilaq
meqqussu¦aq	N	–up, –it
meqqut	N	–ip, –it
meqqut	N, pl.	-
meqqutaaja¦rpoq	V	–nngilaq
meqqutaars¦erpoq	V	–inngilaq
meqqutaasal¦ik	N	{–iup, –lip, –lup}, –lit
meqqutaasa¦q	N	–p, –t
meqqutaasa¦rpoq	V	–nngilaq
meqqutaasat	N, pl.	-
meqqutaasivi¦k	N	–up, –it
meqqutee¦raq	N	–qqap, –qqat
meqqutili¦orpoq	V	–unngilaq
meqqu¦tiliorpoq	V	{–siunngilaq, –tiliunngilaq}
meqqutisi¦voq	V	–nngilaq
meqqut¦orpoq	V	–unngilaq
meqquusaal¦ik	N	{–iup, –lip, –lup}, –lit
meqquusal¦ik	N	{–iup, –lip, –lup}, –lit
merallu¦k	N	–up, –it
merane¦q	N	–rup, –rit
merfi¦voq	V	–nngilaq
meriaa¦q	N	–p, –t
meriaar¦aa	V	–inngilaa
meriaat	N	–ip, –it
meriaat	N, pl.	-
merianngujaats¦oq	N	–up, –ut
merianngunaqaaq	V	(no generation)
meriannguna¦rpoq	V	–nngilaq
merianngunart¦oq	N	–up, –ut
merianngunaveersaat	N	–ip, –it
merianngunaveer¦saat	N	{–saatip, –taatip}, {–saatit, –taatit}
merianngune¦q	N	–rup, –rit
merianngusa¦rpoq	V	–nngilaq
merianngus¦oq	N	–up, –ut
meriannguulluinna¦rpaa	V	–nngilaa
meriannguullu¦innarpaa	V	{–aannanngilaa, –innanngilaa}
meriannguu¦ppaa	V	–tinngilaa
merianngu¦voq	V	–nngilaq
meri¦aq	N	–ssap, –ssat
meriar¦aa	V	–inngilaa
meriarfi¦k	N	–up, –it
meriarna¦rpoq	V	–nngilaq
meriarnart¦oq	N	–up, –ut
meriarne¦q	N	–rup, –rit
meria¦rpaa	V	–nngilaa
meria¦rpoq	V	–nngilaq
meriarsaas¦erpaa	V	–inngilaa
meriarsaa¦serpaa	V	{–sinngilaa, –tilinngilaa}
meriarsaat	N	–ip, –it
meriarsa¦rpaa	V	–nngilaa
meriarsarpoq	V	(no generation)
meriarti¦ppaa	V	–nngilaa
merissataa¦voq	V	–nngilaq
merissatig¦aa	V	–inngilaa
merlaaju¦voq	V	–nngilaq
merlaa¦q	N	–p, –t
merlert¦oq	N	–up, –ut
merlertunngu¦aq	N	–up, –it
merlertuujunnaa¦rpoq	V	–nngilaq
merng¦orpoq	V	–unngilaq
merngors¦erpoq	V	–inngilaq
merngorti¦ppaa	V	–nngilaa
merngort¦oq	N	–up, –ut
merngort¦orpoq	V	–unngilaq
mernguernart¦oq	N	–up, –ut
merngu¦erpoq	V	–inngilaq
mernguersaat	N	–ip, –it
mernguer¦saat	N	{–saatip, –taatip}, {–saatit, –taatit}
mernguersa¦rpoq	V	–nngilaq
mernguers¦erpoq	V	–inngilaq
merser¦aa	V	–inngilaa
merserinngilaa	V	(no generation)
merserinni¦ppoq	V	–nngilaq
mersernarpallaaqaaq	V	(no generation)
mersernarpalu¦ppoq	V	–nngilaq
mersernarpalussu¦seq	N	–tsip, –tsit
mersernarpalutt¦oq	N	–up, –ut
merserna¦rpoq	V	–nngilaq
mersernarsaart¦oq	N	–up, –ut
mersernart¦oq	N	–up, –ut
mersernassu¦seq	N	–tsip, –tsit
mersersaa¦rpoq	V	–nngilaq
merserusu¦ppoq	V	–nngilaq
mersorfi¦k	N	–up, –it
mersorne¦q	N	–rup, –rit
mersornianngu¦aq	N	–up, –it
mers¦orpaa	V	–unngilaa
mers¦orpoq	V	–unngilaq
mersortarfi¦k	N	–up, –it
mersortart¦oq	N	–up, –ut
mersortartuussu¦seq	N	–tsip, –tsit
mersorti	N	–p, –t
mersortig¦aa	V	–inngilaa
mersortinne¦q	N	–rup, –rit
mersorti¦ppaa	V	–nngilaa
mersortitsi¦voq	V	–nngilaq
mersugaarnia¦rpoq	V	–nngilaq
mersugaasivi¦k	N	–up, –it
mersu¦gaq	N	–kkap, –kkat
mersugassa¦q	N	–p, –t
mersullamma¦k	N	–ap, –at
mersullaqqi¦ppoq	V	–nngilaq
mersullaqqissi¦voq	V	–nngilaq
mersullaqqissuu¦voq	V	–nngilaq
mersullaqqi¦ssuuvoq	V	{–ssuunngilaq, –ttuunngilaq}
mersuukkuma¦vaa	V	–nngilaa
mersuullua¦rpaa	V	–nngilaa
mersuu¦ppaa	V	–tinngilaa
mersuussine¦q	N	–rup, –rit
mersuussi¦voq	V	–nngilaq
mersuut	N	–ip, –it
Mesopotamiamiu	N	–p, –t
Mesopotamia¦miu	N	{–miup, –rmiup}, {–miut, –rmiut}
Mestersvig	Prop	–ip
Mexico	Prop	–p, –t
Mexicom¦eersoq	N	{–eersup, –eertup, –inngaanneersup, –inngaanneertup, –inngaanninngaanneersup, –inngaanninngaanneertup}, {–eersut, –eertut, –inngaanneersut, –inngaanneertut, –inngaanninngaanneersut, –inngaanninngaanneertut}
Mexico¦miu	N	{–miup, –rmiup}, {–miut, –rmiut}
miaa¦rpoq	V	–nngilaq
miaat	N	–ip, –it
miaggoorne¦q	N	–rup, –rit
miaggoorpalu¦ppoq	V	–nngilaq
miagg¦oorpoq	V	–uunngilaq
miaggoortaanna¦rpoq	V	–nngilaq
mianer¦aa	V	–inngilaa
mianerinni¦ppoq	V	–nngilaq
mianerinnitt¦oq	N	–up, –ut
mianerinni¦ttoq	N	{–ssup, –ttup}, {–ssut, –ttut}
mianerisarial¦ik	N	{–iup, –lip, –lup}, –lit
mianernanngits¦oq	N	–up, –ut
mianernaqaaq	V	(no generation)
mianerna¦rpoq	V	–nngilaq
mianernart¦oq	N	–up, –ut
mianernassu¦seq	N	–tsip, –tsit
mianersoqqu¦aa	V	–nngilaa
mianersoqqusine¦q	N	–rup, –rit
mianersoqqusi¦voq	V	–nngilaq
mianersoqqussut	N	–ip, –it
mianersorfig¦aa	V	–inngilaa
mianersorna¦rpoq	V	–nngilaq
mianersornart¦oq	N	–up, –ut
mianersornartoqart¦oq	N	–up, –ut
mianersorne¦q	N	–rup, –rit
mianers¦orpoq	V	–unngilaq
mianersort¦oq	N	–up, –ut
mianersuaalliorne¦q	N	–rup, –rit
mianersu¦aalliorneq	N	{–aalliornerup, –ulliornerup}, {–aalliornerit, –ulliornerit}
mianersuaalli¦orpoq	V	–unngilaq
mianersu¦aalliorpoq	V	{–aalliunngilaq, –ulliunngilaq}
mianersuaalliort¦oq	N	–up, –ut
mianersu¦aalliortoq	N	{–aalliortup, –ulliortup}, {–aalliortut, –ulliortut}
mianersuaanne¦q	N	–rup, –rit
mianersuaa¦ppoq	V	–nngilaq
mianersuaassu¦seq	N	–tsip, –tsit
mianersu¦aassuseq	N	{–aassutsip, –ussutsip}, {–aassutsit, –ussutsit}
mianersuaats¦oq	N	–up, –ut
mianersuaatsuliuutaas¦oq	N	–up, –ut
mianersuaatsuliuutaa¦voq	V	–nngilaq
mianersuunnart¦oq	N	–up, –ut
mianersuu¦ppaa	V	–tinngilaa
mianersuussi¦voq	V	–nngilaq
mianersuutigeqquneqa¦rpoq	V	–nngilaq
mianersuuttariaqarlua¦rpoq	V	–nngilaq
mianisaa¦rpoq	V	–nngilaq
miani¦voq	V	–nngilaq
Middelfart	Prop	–ip
miffig¦aa	V	–inngilaa
miffi¦k	N	–up, –it
miffissaaru¦ppoq	V	–tinngilaq
miffissarsi¦orpoq	V	–unngilaq
miffiusinnaas¦oq	N	–up, –ut
miileqa¦rpoq	V	–nngilaq
mikagi¦ak	N	{–aap, –ssap}, {–aat, –ssat}
mikagiatt¦orpoq	V	–unngilaq
mikagia¦ttorpoq	V	{–ssunngilaq, –ttunngilaq}
mikeqaaq	V	(no generation)
mikersaatig¦aa	V	–inngilaa
mikersa¦rpoq	V	–nngilaq
mikialaali¦orpoq	V	–unngilaq
mikialaart¦orpoq	V	–unngilaq
mikialaar¦torpoq	V	{–sunngilaq, –tunngilaq}
mikialaat	N, pl.	-
mikial¦erpoq	V	–inngilaq
miki¦aq	N	–ssap, –ssat
mikiarne¦q	N	–rup, –rit
mikiarni¦ppoq	V	–nngilaq
mikia¦rpoq	V	–nngilaq
mikiars¦erpaa	V	–inngilaa
mikiarsia¦q	N	–p, –t
mikiarsii¦voq	V	–nngilaq
mikiarsimas¦oq	N	–up, –ut
mikiarsimassu¦seq	N	–tsip, –tsit
mikiart¦oq	N	–up, –ut
mikiart¦orpoq	V	–unngilaq
mikiar¦torpoq	V	{–sunngilaq, –tunngilaq}
mikig¦aa	V	–inngilaa
mikigalaa¦q	N	–p, –t
miki¦gaq	N	–kkap, –kkat
mikiga¦rpoq	V	–nngilaq
mikigars¦erpaa	V	–inngilaa
mikigarsia¦q	N	–p, –t
mikigarsii¦voq	V	–nngilaq
mikigart¦orpoq	V	–unngilaq
mikigar¦torpoq	V	{–sunngilaq, –tunngilaq}
mikiginni¦ppoq	V	–nngilaq
mikilaatsiart¦oq	N	–up, –ut
mikileraaja¦rpoq	V	–nngilaq
mikile¦raq	N	–qqap, –qqat
mikilerarmi¦ppaa	V	–nngilaa
mikilua¦rpoq	V	–nngilaq
mikinaa¦rpaa	V	–nngilaa
mikine¦q	N	–rup, –rit
mikinerpaa¦q	N	–p, –t
mikinerus¦oq	N	–up, –ut
mikinngilaq	V	(no generation)
miki¦ppaa	V	–nngilaa
miki¦ppoq	V	–nngilaq
mikisoo¦raq	N	–qqap, –qqat
mikis¦oq	N	–up, –ut
mikisoralaanngu¦aq	N	–up, –it
mikisoralaa¦q	N	–p, –t
mikisorala¦k	N	–p, –t
mikisoralanngu¦aq	N	–up, –it
mikisoralaralaanngu¦aq	N	–up, –it
mikissi¦ppoq	V	–nngilaq
mikissu¦seq	N	–tsip, –tsit
mikisualuit	N, pl.	-
mikisuaraaranngu¦aq	N	–up, –it
mikisuaranngu¦aq	N	–up, –it
mikisua¦raq	N	–qqap, –qqat
mikisukulla¦k	N	–ap, –at
mikisunnguanng¦orpaa	V	–unngilaa
mikisunnguanngorti¦ppaa	V	–nngilaa
mikisunngu¦aq	N	–up, –it
mikisuunngits¦oq	N	–up, –ut
mikitig¦aaq	V	–inngilaq
mikitsi¦ppaa	V	–nngilaa
mikitsi¦voq	V	–nngilaq
mikivallaalaa¦rpoq	V	–nngilaq
mikivallaangajappoq	V	(no generation)
mikivallaanngikkaluarpoq	V	(no generation)
mikivallaanngilaq	V	(no generation)
mikivallaaqaaq	V	(no generation)
mikivallaaqinaaq	V	(no generation)
mikivallaa¦rpoq	V	–nngilaq
mikivallaarsinnaa¦voq	V	–nngilaq
mikivallaarsor¦aa	V	–inngilaa
mikivallaart¦oq	N	–up, –ut
mikivallaarunnaa¦rpoq	V	–nngilaq
mikivinngilaq	V	(no generation)
miki¦voq	V	–nngilaq
mikkagaa¦voq	V	–nngilaq
mikka¦ppaa	V	–nngilaa
mikka¦ppoq	V	–nngilaq
mikkatt¦orpaa	V	–unngilaa
mikkattorti¦ppoq	V	–nngilaq
mikkiartorfig¦aa	V	–inngilaa
mikkiart¦orpoq	V	–unngilaq
mikkunnarsi¦voq	V	–nngilaq
Mikladalur	Prop	–ip
Mikronesien	Prop	(no generation)
milaaqi	N	–p, –t
milaaral¦ik	N	{–iup, –lip, –lup}, –lit
milaa¦raq	N	–qqap, –qqat
milaa¦voq	V	–nngilaq
milagu¦aq	N	–ssap, –ssat
milaguart¦oq	N	–up, –ut
mila¦k	N	–ap, –at
milaki¦ppoq	V	–nngilaq
milakulaanngu¦aq	N	–up, –it
milakulaanngua¦rpoq	V	–nngilaq
milakulaa¦q	N	–p, –t
milakulaa¦rpoq	V	–nngilaq
milakulaarsu¦aq	N	–up, –it
milakulaart¦oq	N	–up, –ut
milakula¦k	N	–ap, –at
milakula¦ppoq	V	–nngilaq
milal¦ik	N	{–iup, –lip, –lup}, –lit
milalinngu¦aq	N	–up, –it
milaqa¦rpoq	V	–nngilaq
milassu¦aq	N	–up, –it
milatta¦rpoq	V	–nngilaq
milatt¦ooq	N	–uup, –uut
milattus¦oq	N	–up, –ut
milattuu¦voq	V	–nngilaq
milattu¦voq	V	–nngilaq
mileqqort¦ooq	N	–uup, –uut
mileqqortoorsi¦voq	V	–nngilaq
miligaas¦erpaa	V	–inngilaa
miligaa¦serpaa	V	{–sinngilaa, –tilinngilaa}
miligaat	N	–ip, –it
mili¦gaq	N	–kkap, –kkat
miliga¦rpaa	V	–nngilaa
miliga¦rpoq	V	–nngilaq
miligarsima¦voq	V	–nngilaq
miligartaat	N	–ip, –it
miligartaat	N, pl.	-
miligarta¦rpoq	V	–nngilaq
mili¦k	N	{–ngup, –p, –up}, {–it, –ngit, –t}
milika¦rpoq	V	–nngilaq
milikartaat	N	–ip, –it
milikartoorne¦q	N	–rup, –rit
milikkiu¦ppoq	V	–tinngilaq
milinga¦voq	V	–nngilaq
milinngane¦q	N	–rup, –rit
milinngas¦oq	N	–up, –ut
milinngatitsine¦q	N	–rup, –rit
milinngatsi¦voq	V	–nngilaq
milinnga¦voq	V	–nngilaq
mili¦ppaa	V	–nngilaa
mili¦ppoq	V	–nngilaq
milis¦simasoq	N	{–imasup, –simasup}, {–imasut, –simasut}
milita¦q	N	–p, –t
milittaas¦erpaa	V	–inngilaa
milittaa¦serpaa	V	{–sinngilaa, –tilinngilaa}
mili¦ttaaserpaa	V	{–ssaasinngilaa, –ssaatilinngilaa, –ttaasinngilaa, –ttaatilinngilaa}
milittaat	N	–ip, –it
milittaat	N, pl.	-
mili¦ttaat	N	{–ssaatip, –ttaatip}, {–ssaatit, –ttaatit}
militta¦k	N	–ap, –at
milittakkaa¦q	N	–p, –t
militta¦q	N	–p, –t
milittoorne¦q	N	–rup, –rit
milit¦toorneq	N	{–toornerup, –oornerup}, {–toornerit, –oornerit}
militt¦orpaa	V	–unngilaa
millalaa¦rpoq	V	–nngilaq
millequs¦erpaa	V	–inngilaa
millequ¦serpaa	V	{–sinngilaa, –tilinngilaa}
millequt	N	–ip, –it
millersuu¦ppaa	V	–tinngilaa
millersuussi¦voq	V	–nngilaq
milli¦alerpaa	V	{–alinngilaa, –ssinngilaa}
milliallatsitaane¦q	N	–rup, –rit
milli¦aq	N	–ssap, –ssat
milliartorne¦q	N	–rup, –rit
milliar¦torneq	N	{–sornerup, –tornerup}, {–sornerit, –tornerit}
milliart¦orpoq	V	–unngilaq
milliar¦torpoq	V	{–sunngilaq, –tunngilaq}
milliartort¦oq	N	–up, –ut
milliar¦tortoq	N	{–sortup, –tortup}, {–sortut, –tortut}
milligaluttuinnarpoq	V	(no generation)
millil¦erpaa	V	–inngilaa
millilerut	N	–ip, –it
millil¦iineq	N	{–erinerup, –iinerup}, {–erinerit, –iinerit}
milline¦q	N	–rup, –rit
millineqanngits¦oq	N	–up, –ut
million	Num	{–it, –ip}, {–er, –it}
millionerpassuit	N, pl.	-
mil¦lioni	Num	{–iuunip, –liuunip}, {–iuun, –iuunit, –liuun, –liuunit}
millisaane¦q	N	–rup, –rit
millisaas¦erpaa	V	–inngilaa
millisaa¦serpaa	V	{–sinngilaa, –tilinngilaa}
millisaat	N	–ip, –it
millisaa¦voq	V	–nngilaq
millisa¦q	N	–p, –t
millisa¦rpaa	V	–nngilaa
millisinneqa¦rpoq	V	–nngilaq
millisi¦ppaa	V	–nngilaa
millisitaane¦q	N	–rup, –rit
millisita¦q	N	–p, –t
millisitsine¦q	N	–rup, –rit
milli¦sserpaa	V	{–alinngilaa, –ssinngilaa}
millisserpoq	V	(no generation)
milli¦ssersorpaa	V	{–alersunngilaa, –ssersunngilaa}
millissiu¦ppaa	V	–tinngilaa
milli¦ssiuppaa	V	{–aliutinngilaa, –ssiutinngilaa}
millissutigitita¦q	N	–p, –t
milliu¦ppoq	V	–tinngilaq
milli¦voq	V	–nngilaq
milloorajuppoq	V	(no generation)
millooraluarnera¦rpaa	V	–nngilaa
milloornia¦rpaa	V	–nngilaa
milloornia¦rpoq	V	–nngilaq
mill¦oorpaa	V	–uunngilaa
mill¦oorpoq	V	–uunngilaq
milluaane¦q	N	–rup, –rit
milluaasart¦oq	N	–up, –ut
milluaas¦erpoq	V	–inngilaq
milluaa¦serpoq	V	{–sinngilaq, –tilinngilaq}
milluaassut	N	–ip, –it
milluaat	N	–ip, –it
milluaa¦voq	V	–nngilaq
millua¦rpaa	V	–nngilaa
millua¦rpoq	V	–nngilaq
milluartaat	N	–ip, –it
milluarta¦gaq	N	–kkap, –kkat
milluart¦oq	N	–up, –ut
millugunneqa¦rpoq	V	–nngilaq
millugu¦ppaa	V	–tinngilaa
millugu¦ppoq	V	–tinngilaq
millugus¦erpaa	V	–inngilaa
millugu¦serpaa	V	{–sinngilaa, –tilinngilaa}
millugu¦serpaa	V	–tilinngilaa
millugusimane¦q	N	–rup, –rit
millugusima¦voq	V	–nngilaq
millugussaa¦voq	V	–nngilaq
millugussa¦q	N	–p, –t
millugussine¦q	N	–rup, –rit
millugussi¦voq	V	–nngilaq
millugut	N	–ip, –it
millunga¦voq	V	–nngilaq
millunne¦q	N	–rup, –rit
millu¦ppaa	V	–tinngilaa
millu¦ppoq	V	–tinngilaq
millussine¦q	N	–rup, –rit
millussi¦voq	V	–nngilaq
milluss¦orpaa	V	–unngilaa
millusukaari¦voq	V	–nngilaq
millusuka¦rpaa	V	–nngilaa
millusuka¦rpoq	V	–nngilaq
millusukartuarpaa	V	(no generation)
millut¦sinneq	N	{–innerup, –sinnerup, –itinnerup}, {–innerit, –sinnerit, –itinnerit}
milluu¦serpaa	V	{–sinngilaa, –tilinngilaa}
milluusi¦orpoq	V	–unngilaq
milluu¦siorpoq	V	{–siunngilaq, –tiliunngilaq}
milluut	N	–ip, –it
milluutig¦aa	V	–inngilaa
milluutissa¦q	N	–p, –t
miloriallaqqi¦ppoq	V	–nngilaq
miloriarne¦q	N	–rup, –rit
mil¦oriarneq	N	{–oriarnerup, –uperiarnerup}, {–oriarnerit, –uperiarnerit}
miloriarnert¦ooq	N	–uup, –uut
mil¦oriarnertooq	N	{–oriarnertuup, –uperiarnertuup}, {–oriarnertuut, –uperiarnertuut}
miloriarnertu¦voq	V	–nngilaq
mil¦oriarnertuvoq	V	{–oriarnertunngilaq, –uperiarnertunngilaq}
miloria¦rpaa	V	–nngilaa
miloria¦rpoq	V	–nngilaq
miloriu¦ppaa	V	–tinngilaa
miloriussaa¦voq	V	–nngilaq
miloriussine¦q	N	–rup, –rit
miloriussi¦voq	V	–nngilaq
milornippoq	V	(no generation)
mil¦orpaa	V	–unngilaa
milor¦sivoq	V	{–ninnngilaq, –sinngilaq}
milorta¦q	N	–p, –t
milu¦erpoq	V	–inngilaq
miluerser¦eerpaa	V	–iinngilaa
miluersi¦ppaa	V	–nngilaa
miluersitsine¦q	N	–rup, –rit
miluer¦toq	N	{–sup, –tup}, {–sut, –tut}
miluffi¦k	N	–up, –it
miluffiusaa¦q	N	–p, –t
milugaaru¦ppoq	V	–tinngilaq
milu¦gaq	N	–kkap, –kkat
milugar¦aa	V	–inngilaa
milugiaa¦raq	N	–qqap, –qqat
milugiaarsu¦k	N	–up, –it
milugi¦ak	N	–ssap, –ssat
milugiassu¦aq	N	–up, –it
milugukkajuppoq	V	(no generation)
milugu¦ppaa	V	–nngilaa
milugu¦ppoq	V	–tinngilaq
milu¦k	N	–up, –it
milukaa¦q	N	–p, –t
milukaa¦rpoq	V	–nngilaq
milukaarti¦ppaa	V	–nngilaa
milukaarumatoqaaq	V	(no generation)
milukkunnaa¦rpoq	V	–nngilaq
milunne¦q	N	–rup, –rit
milu¦ppaa	V	–nngilaa
milu¦ppoq	V	–nngilaq
milussi¦orpoq	V	–unngilaq
miluss¦iorpoq	V	{–iunngilaq, –aliunngilaq}
milutsi	N	–p, –t
milutsi¦ppaa	V	–nngilaa
milut¦sitsineq	N	{–sitsinerup, –itsinerup}, {–sitsinerit, –itsinerit}
milutsitsisi	N	–p, –t
milut¦sitsisinnaasoq	N	{–sitsisinnaasup, –itsisinnaasup}, {–sitsisinnaasut, –itsisinnaasut}
milut¦sitsisoq	N	{–sitsisup, –itsisup}, {–sitsisut, –itsisut}
milut¦sitsiunnaarneq	N	{–sitsiunnaarnerup, –itsiunnaarnerup}, {–sitsiunnaarnerit, –itsiunnaarnerit}
milut¦sitsivoq	V	{–sitsinngilaq, –itsinngilaq}
milutt¦oq	N	–up, –ut
miluukkaluttuinna¦rpoq	V	–nngilaq
miluumas¦oq	N	–up, –ut
miluumasut	N, pl.	-
miluu¦ppoq	V	–tinngilaq
miluussimaannart¦oq	N	–up, –ut
miluut	N	–ip, –it
miluutivi¦ppoq	V	–nngilaq
minaa¦ppaa	V	–tinngilaa
minaa¦q	N	–p, –t
minaar¦aa	V	–inngilaa
minaassi¦voq	V	–nngilaq
minarniaanna¦rpoq	V	–nngilaq
mina¦rpoq	V	–nngilaq
minarta¦rpoq	V	–nngilaq
minerujoorne¦q	N	–rup, –rit
ming¦erpoq	V	–inngilaq
mingiu¦ppaa	V	–tinngilaa
mingiu¦ppoq	V	–tinngilaq
mingiutimisaarfig¦aa	V	–inngilaa
mingiut¦imisaarfigaa	V	{–imisaarfiginngilaa, –simisaarfiginngilaa}
mingiutimisaa¦rpoq	V	–nngilaq
mingoqassu¦seq	N	–tsip, –tsit
mingortu¦voq	V	–nngilaq
minguerlua¦rpoq	V	–nngilaq
mingu¦erpaa	V	–inngilaa
mingu¦erpoq	V	–inngilaq
minguersaat	N	–ip, –it
minguer¦saat	N	{–saatip, –taatip}, {–saatit, –taatit}
minguersa¦rpaa	V	–nngilaa
minguersi¦ppaa	V	–nngilaa
minguiaane¦q	N	–rup, –rit
minguiaa¦veqarfik	N	{–ffeqarfiup, –veqarfiup}, {–ffeqarfiit, –veqarfiit}
minguia¦rpaa	V	–nngilaa
minguillisaa¦rpoq	V	–nngilaq
minguillisinneqarne¦q	N	–rup, –rit
minguilli¦voq	V	–nngilaq
minguilluinna¦rpoq	V	–nngilaq
mingui¦ppoq	V	–nngilaq
minguissu¦seq	N	–tsip, –tsit
minguits¦oq	N	–up, –ut
minguitsuu¦voq	V	–nngilaq
mingu¦k	N	–up, –it
mingulerisit	N	–ip, –it
minguleri¦voq	V	–nngilaq
mingulerteri¦voq	V	–nngilaq
mingulert¦erpaa	V	–inngilaa
mingunnaa¦ppoq	V	–nngilaq
mingunna¦rpoq	V	–nngilaq
mingunnartuleri¦voq	V	–nngilaq
mingu¦ppoq	V	–nngilaq
mingussu¦aq	N	–up, –it
mingussu¦seq	N	–tsip, –tsit
mingutserine¦q	N	–rup, –rit
minguts¦erpaa	V	–inngilaa
mingutsersimas¦oq	N	–up, –ut
mingutsinneqanngits¦oq	N	–up, –ut
mingutsinneqarne¦q	N	–rup, –rit
mingutsinneqarsimane¦q	N	–rup, –rit
mingutsi¦ppaa	V	–nngilaa
mingutsi¦ppoq	V	–nngilaq
mingutsitaane¦q	N	–rup, –rit
mingutsitsine¦q	N	–rup, –rit
mingutsitsis¦oq	N	–up, –ut
mingutsitsissutaasinnaas¦oq	N	–up, –ut
mingutsitsi¦voq	V	–nngilaq
mingutt¦ooq	N	–uup, –uut
mingutt¦oq	N	–up, –ut
minguttussu¦seq	N	–tsip, –tsit
minguttuussu¦seq	N	–tsip, –tsit
minguuffig¦aa	V	–inngilaa
minguu¦voq	V	–nngilaq
mini	N	–p, –t
minialaa¦rpoq	V	–nngilaq
mini¦k	N	–up, –it
minilaa¦rpoq	V	–nngilaq
minillalasorsuu¦voq	V	–nngilaq
minillalasorsu¦uvoq	V	{–aanngilaq, –unngilaq}
minillala¦voq	V	–nngilaq
minillug¦aa	V	–inngilaa
mini¦ppaa	V	–nngilaa
mini¦ppoq	V	–nngilaq
minis¦oq	N	–up, –ut
minisorujussuu¦voq	V	–nngilaq
minisorujussu¦uvoq	V	{–aanngilaq, –unngilaq}
ministeeria	N	(no generation)
ministeeriaqarfik	N	(no generation)
ministereqarfi¦k	N	–up, –it
ministeria	N	(no generation)
minitaane¦q	N	–rup, –rit
minitaa¦voq	V	–nngilaq
minita¦q	N	–p, –t
minitaqanngilaq	V	(no generation)
minitseri¦voq	V	–nngilaq
minits¦erpaa	V	–inngilaa
minitsine¦q	N	–rup, –rit
minitsi¦voq	V	–nngilaq
minitsui¦ppaa	V	–nngilaa
minitsuisaa¦q	N	–p, –t
minitsuisaa¦rpaa	V	–nngilaa
minitsuisaarut	N	–ip, –it
minittorne¦q	N	–rup, –rit
minitt¦orpoq	V	–unngilaq
miniula¦voq	V	–nngilaq
miniunnaa¦rpoq	V	–nngilaq
minnaaqqu¦ppaa	V	–tinngilaa
minnaar¦iniartoq	N	{–iniartup, –siniartup}, {–iniartut, –siniartut}
minnaar¦ivoq	V	{–inngilaq, –sinngilaq}
minnaa¦rpaa	V	–nngilaa
minnaarpallaaqaa	V	(no generation)
minnaar¦sivoq	V	{–inngilaq, –sinngilaq}
minne¦q	N	–rup, –rit
mi¦nneq	N	{–kinerup, –nnerup}, {–kinerit, –nnerit}
minneralaarsuu¦voq	V	–nngilaq
minneralaarsu¦uvoq	V	{–aanngilaq, –unngilaq}
mi¦nneralaarsuuvoq	V	{–kineralaarsuaanngilaq, –kineralaarsuunngilaq, –nneralaarsuaanngilaq, –nneralaarsuunngilaq}
minnerpaaffi¦k	N	–up, –it
minnerpaa¦ffik	N	{–ffiup, –juffiup}, {–ffiit, –juffiit}
minnerpaaffissa¦q	N	–p, –t
minnerpaa¦ffissaq	N	{–ffissap, –juffissap}, {–ffissat, –juffissat}
minnerpaa¦q	N	–p, –t
mi¦nnerpaaq	N	{–kinerpaap, –nnerpaap}, {–kinerpaat, –nnerpaat}
minnerpaa¦voq	V	{–junngilaq, –nngilaq}
minnerpaa¦voq	V	–nngilaq
minnersaas¦oq	N	–up, –ut
minnersaat	N	–ip, –it
minnersaa¦voq	V	–nngilaq
minnersa¦q	N	–p, –t
minnersi¦orpoq	V	–unngilaq
mi¦nnersiorpoq	V	{–kinersiunngilaq, –nnersiunngilaq}
minnersiuu¦ppaa	V	–tinngilaa
mi¦nnersiuuppaa	V	{–kinersiuutinngilaa, –nnersiuutinngilaa}
minnerta¦q	N	–p, –t
mi¦nnertaq	N	{–kinertap, –nnertap}, {–kinertat, –nnertat}
minnerul¦erpoq	V	–inngilaq
mi¦nnerulerpoq	V	{–kinerulinngilaq, –nnerulinngilaq}
minneruler¦sippaa	V	{–sinngilaa, –tinngilaa}
mi¦nnerulersippaa	V	{–kinerulersinngilaa, –kinerulertinngilaa, –nnerulersinngilaa, –nnerulertinngilaa}
minnerus¦oq	N	–up, –ut
mi¦nnerusoq	N	{–kinerusup, –nnerusup}, {–kinerusut, –nnerusut}
minneruti¦ppaa	V	–nngilaa
mi¦nnerutippaa	V	{–kinerutinngilaa, –nnerutinngilaa}
minnerutippoq	V	(no generation)
minneru¦voq	V	–nngilaq
mi¦nneruvoq	V	{–kinerunngilaq, –nnerunngilaq}
minngaa¦ppoq	V	{–nngilaq, –tinngilaq}
minngaats¦oq	N	–up, –ut
minngaat¦soq	N	{–sup, –tup}, {–sut, –tut}
minnga¦voq	V	–nngilaq
minngeri¦t	N	–sip, –sit
minngeri¦voq	V	–nngilaq
minngerna¦rpoq	V	–nngilaq
minngernartuleri¦voq	V	–nngilaq
minng¦erpoq	V	–inngilaq
minngersaane¦q	N	–rup, –rit
minngersaat	N	–ip, –it
minnger¦saat	N	{–saatip, –taatip}, {–saatit, –taatit}
minngersa¦rpoq	V	–nngilaq
minngers¦oorpoq	V	–uunngilaq
minngertuaanna¦rpoq	V	–nngilaq
minngi¦ppoq	V	–nngilaq
minng¦oq	N	–up, –ut
minngorsu¦aq	N	–up, –it
minngort¦ooq	N	–uup, –uut
minngua¦raq	N	–qqap, –qqat
minnguni¦ppoq	V	–nngilaq
mio	N	(no generation)
mippaaria¦q	N	–p, –t
mippaa¦rpoq	V	–nngilaq
mipperia¦q	N	–p, –t
mipperia¦rpoq	V	–nngilaq
mipperne¦q	N	–rup, –rit
mipp¦erpoq	V	–inngilaq
mippersart¦oq	N	–up, –ut
mippers¦oq	N	–up, –ut
mipper¦soq	N	{–sup, –tup}, {–sut, –tut}
mi¦ppoq	V	–nngilaq
misaqqarna¦q	N	–p, –t
misaqqa¦rpoq	V	–nngilaq
misaqqas¦oq	N	–up, –ut
misaria¦rpoq	V	–nngilaq
misarne¦q	N	–rup, –rit
misa¦rpallappoq	V	{–pallanngilaq, –rpallanngilaq}
misarpalu¦ppoq	V	–nngilaq
misa¦rpoq	V	–nngilaq
miseqqi¦orpoq	V	–unngilaq
miseraasivi¦k	N	–up, –it
mise¦raq	N	–qqap, –qqat
miserartorfig¦aa	V	–inngilaa
miserar¦torfigaa	V	{–sorfiginngilaa, –torfiginngilaa}
miserartorfi¦k	N	–up, –it
miserar¦torfik	N	{–sorfiup, –torfiup}, {–sorfiit, –torfiit}
miserart¦orpaa	V	–unngilaa
miserart¦orpoq	V	–unngilaq
miserar¦torpoq	V	{–sunngilaq, –tunngilaq}
miserra¦ppaa	V	–nngilaa
miserrari¦ppoq	V	–nngilaq
miserrassi¦voq	V	–nngilaq
miserratig¦aa	V	–inngilaa
miserratigineqarsinnaanngits¦oq	N	–up, –ut
miserratiginngilaa	V	(no generation)
miserratiginnikkunnaarne¦q	N	–rup, –rit
miserratiginninne¦q	N	–rup, –rit
miserratiginni¦ppoq	V	–nngilaq
miserratiginnitt¦oq	N	–up, –ut
miserratigisassaanngits¦oq	N	–up, –ut
misiaanna¦rpoq	V	–nngilaq
misiannginne¦q	N	–rup, –rit
misiarfig¦aa	V	–inngilaa
misiarne¦q	N	–rup, –rit
misia¦rpoq	V	–nngilaq
misig¦aa	V	–inngilaa
misigeqataane¦q	N	–rup, –rit
misigeqatig¦aa	V	–inngilaa
misigeqatigiinne¦q	N	–rup, –rit
misigeqatiginnias¦oq	N	–up, –ut
misigeqatiginni¦ppoq	V	–nngilaq
misigeqatiginnitt¦oq	N	–up, –ut
misigeqqi¦ppaa	V	–nngilaa
misigeqqita¦q	N	–p, –t
misigiits¦oorpaa	V	–uunngilaa
misigiits¦oorpoq	V	–uunngilaq
misigilernerpaa	V	(no generation)
misigil¦erpoq	V	–inngilaq
misigine¦q	N	–rup, –rit
misigineqarsinnaas¦oq	N	–up, –ut
misiginertoqaaq	V	(no generation)
misiginneqataane¦q	N	–rup, –rit
misiginneqataanngits¦oq	N	–up, –ut
misiginneqataas¦oq	N	–up, –ut
misiginneqataa¦voq	V	–nngilaq
misiginneqatig¦aa	V	–inngilaa
misiginneqatigigaluaqaa	V	(no generation)
misiginneqatiginninne¦q	N	–rup, –rit
misiginneqatiginnitt¦oq	N	–up, –ut
misiginngitsoorne¦q	N	–rup, –rit
misiginngitsoorpoq	V	(no generation)
misiginngitsoortippaa	V	(no generation)
misiginninne¦q	N	–rup, –rit
misiginni¦ppoq	V	–nngilaq
misigisaarutt¦oq	N	–up, –ut
misigisaas¦oq	N	–up, –ut
misigisalersaa¦rpoq	V	–nngilaq
misigisa¦q	N	–p, –t
misigisaqarne¦q	N	–rup, –rit
misigisar¦aa	V	–inngilaa
misigisart¦ooq	N	–uup, –uut
misigisartussu¦seq	N	–tsip, –tsit
misigisar¦tussuseq	N	{–tussutsip, –sussutsip}, {–tussutsit, –sussutsit}
misigisartuu¦voq	V	–nngilaq
misigisassarsi¦orpoq	V	–unngilaq
misigisat	N	–ip, –it
misigisat	N, pl.	-
misigisimane¦q	N	–rup, –rit
misigissu¦seq	N	–tsip, –tsit
misigissuseqanngits¦oq	N	–up, –ut
misigissuseqarluarne¦q	N	–rup, –rit
misigissuseqarne¦q	N	–rup, –rit
misigissuseqarpalutt¦oq	N	–up, –ut
misigissuseqarsinnaane¦q	N	–rup, –rit
misigissusil¦ik	N	{–iup, –lip, –lup}, –lit
misigissut	N	–ip, –it
misigittaanne¦q	N	–rup, –rit
misigittaa¦ppoq	V	–nngilaq
misigittaassu¦seq	N	–tsip, –tsit
misigittaats¦oq	N	–up, –ut
misigittarne¦q	N	–rup, –rit
misigitta¦rpoq	V	–nngilaq
misigittartuu¦voq	V	–nngilaq
misikkareqaaq	V	(no generation)
misikkari¦ppoq	V	–nngilaq
misikkariss¦oq	N	–up, –ut
misikkari¦ssoq	N	{–ssup, –ttup}, {–ssut, –ttut}
misikkart¦ooq	N	–uup, –uut
misikkeerne¦q	N	–rup, –rit
misikk¦eerpaa	V	–iinngilaa
misikk¦eerpoq	V	–iinngilaq
misikkeersimaannarpaa	V	(no generation)
misikkeersimas¦oq	N	–up, –ut
misikkeersi¦ppaa	V	–nngilaa
misikkiivi¦ppaa	V	–nngilaa
misikkiivi¦ppoq	V	–nngilaq
misileeqqaarallarne¦q	N	–rup, –rit
misileeqqaarne¦q	N	–rup, –rit
misileeqqissaarne¦q	N	–rup, –rit
misileqqissaa¦rpaa	V	–nngilaa
misileraaffeqarfi¦k	N	–up, –it
misileraaffi¦k	N	–up, –it
misileraane¦q	N	–rup, –rit
misileraas¦oq	N	–up, –ut
misileraa¦vik	N	{–ffiup, –viup}, {–ffiit, –viit}
misileraa¦voq	V	–nngilaq
misilera¦rpaa	V	–nngilaa
misiligaallua¦rpoq	V	–nngilaq
misiligaane¦q	N	–rup, –rit
misiligaaqqissaarne¦q	N	–rup, –rit
misiligaaqqissaa¦rpoq	V	–nngilaq
misiligaas¦oq	N	–up, –ut
misiligaa¦voq	V	–nngilaq
misili¦gaq	N	–kkap, –kkat
misiligart¦ooq	N	–uup, –uut
misiligassa¦q	N	–p, –t
misiligu¦serpoq	V	{–sinngilaq, –tilinngilaq}
misiligut	N	–ip, –it
misiligutaas¦oq	N	–up, –ut
misiligutaa¦voq	V	–nngilaq
misiligutig¦aa	V	–inngilaa
misiliiartorallarpoq	V	(no generation)
misiliiartorsinnaavoq	V	(no generation)
misiliiartortariaqa¦rpoq	V	–nngilaq
misiliiartort¦oq	N	–up, –ut
misiliiartulerpoq	V	(no generation)
misiliilaaraluarpoq	V	(no generation)
misiliillattaarne¦q	N	–rup, –rit
misiliine¦q	N	–rup, –rit
misiliisaanna¦rpoq	V	–nngilaq
misiliisariaqalersima¦voq	V	–nngilaq
misiliisariaqassa¦aq	V	–nngilaq
misiliisariaqassagaluarpoq	V	(no generation)
misiliisarne¦q	N	–rup, –rit
misiliisi¦ppaa	V	–nngilaa
misiliis¦oq	N	–up, –ut
misiliissut	N	–ip, –it
misiliissut	N, pl.	-
misiliisuune¦q	N	–rup, –rit
misiliisuutita¦q	N	–p, –t
misilii¦voq	V	–nngilaq
misilikkaluallarpaa	V	(no generation)
misilikkaluarniarpaa	V	(no generation)
misilikkiartorallassavaa	V	(no generation)
misilinneqanngits¦oq	N	–up, –ut
misilinneqarne¦q	N	–rup, –rit
misilinneqa¦rpoq	V	–nngilaq
misilinnia¦rpaa	V	–nngilaa
misili¦ppaa	V	–nngilaa
misilitsinne¦q	N	–rup, –rit
misilitsi¦ppoq	V	–nngilaq
misilittaane¦q	N	–rup, –rit
misilittaat	N	–ip, –it
misilittaa¦voq	V	–nngilaq
misilittagal¦ik	N	{–iup, –lip, –lup}, –lit
misilitta¦gaq	N	–kkap, –kkat
misilittagaqarfig¦aa	V	–inngilaa
misilittagaqarne¦q	N	–rup, –rit
misilittagaqart¦oq	N	–up, –ut
misilittakkat	N, pl.	-
misilittariaqarnera¦rpaa	V	–nngilaa
misilittariaqarsimavaa	V	(no generation)
misilittarluarneqarnik¦oq	N	–up, –ut
misilitta¦rpaa	V	–nngilaa
misiliut	N	–ip, –it
misiliut¦aannaq	N	{–aannaap, –iinnaap}, {–aannaat, –iinnaat}
misilivikkumavaa	V	(no generation)
misilivikkusuppaa	V	(no generation)
misillerfig¦aa	V	–inngilaa
misillernaqaaq	V	(no generation)
misill¦erpoq	V	–inngilaq
misillersi¦ppaa	V	–nngilaa
misillersitaane¦q	N	–rup, –rit
misinnaa¦ppoq	V	–nngilaq
misinnaat	N	–ip, –it
misinnaataa¦voq	V	–nngilaq
misinnaatig¦aa	V	–inngilaa
misinnaats¦oorpoq	V	–uunngilaq
misinnaatsoorti¦ppaa	V	–nngilaa
misinnaqaaq	V	(no generation)
misinna¦rpoq	V	–nngilaq
misinnarsi¦voq	V	–nngilaq
misinnartua¦rpoq	V	–nngilaq
misissarii¦ppoq	V	–nngilaq
misissari¦ppoq	V	–nngilaq
misissarissuunngilaq	V	(no generation)
misissarl¦erpoq	V	–inngilaq
misissoqqi¦ppaa	V	–nngilaa
misissoqqissaa¦gaq	N	–kkap, –kkat
misissoqqissaarneqarsinnaas¦oq	N	–up, –ut
misissoqqissaa¦rpaa	V	–nngilaa
misissorne¦q	N	–rup, –rit
misissorneqanngits¦oq	N	–up, –ut
misissorneqa¦rpoq	V	–nngilaq
misissorneqarsinnaas¦oq	N	–up, –ut
misiss¦orpaa	V	–unngilaa
misissorpoq	V	(no generation)
misissortinne¦q	N	–rup, –rit
misissorti¦ppoq	V	–nngilaq
misissortittarfi¦k	N	–up, –it
misissorti¦ttarfik	N	{–ttarfiup, –ssarfiup}, {–ttarfiit, –ssarfiit}
misissort¦oq	N	–up, –ut
misissortuune¦q	N	–rup, –rit
misissuaalliorne¦q	N	–rup, –rit
misissuaalli¦orpoq	V	–unngilaq
misissuaanne¦q	N	–rup, –rit
misissuaa¦ppoq	V	–nngilaq
misissuaassu¦seq	N	–tsip, –tsit
misissuaats¦oq	N	–up, –ut
misissua¦rpoq	V	–nngilaq
misissuataarpaa	V	(no generation)
misissueqqaarne¦q	N	–rup, –rit
misissueqqinne¦q	N	–rup, –rit
misissueqqissaarne¦q	N	–rup, –rit
misissueqqissaart¦oq	N	–up, –ut
misissuerusunne¦q	N	–rup, –rit
misissugaane¦q	N	–rup, –rit
misissu¦gaq	N	–kkap, –kkat
misissugarinninne¦q	N	–rup, –rit
misissugassa¦q	N	–p, –t
misissuiartorallarpoq	V	(no generation)
misissuiffig¦aa	V	–inngilaa
misissuiffigineqarne¦q	N	–rup, –rit
misissuiffiginninne¦q	N	–rup, –rit
misissuiffigitinne¦q	N	–rup, –rit
misissuiffi¦k	N	–up, –it
Misissuigallarne¦q	N	–rup, –rit
misissuilernikuu¦voq	V	–nngilaq
misissuilluarne¦q	N	–rup, –rit
misissuillua¦rpoq	V	–nngilaq
misissuine¦q	N	–rup, –rit
misissuisart¦oq	N	–up, –ut
misissuis¦oq	N	–up, –ut
misissuisunngortita¦q	N	–p, –t
misissuisut	N, pl.	-
misissuisuune¦q	N	–rup, –rit
misissui¦vik	N	{–ffiup, –viup}, {–ffiit, –viit}
misissui¦voq	V	–nngilaq
misissujui¦ppoq	V	–nngilaq
misissunngits¦oq	N	–up, –ut
misissussu¦seq	N	–tsip, –tsit
misissuukkunnaa¦rpaa	V	–nngilaa
misissuullua¦rpaa	V	–nngilaa
misissuu¦ppaa	V	–tinngilaa
misissuut	N	–ip, –it
misiu¦ppaa	V	–tinngilaa
misiu¦ppoq	V	–tinngilaq
misiussaa¦voq	V	–nngilaq
misiussa¦q	N	–p, –t
misiussi¦voq	V	–nngilaq
misiutig¦aa	V	–inngilaa
misoqqaa¦rpoq	V	–nngilaq
miso¦raq	N	–qqap, –qqat
missaanniitt¦oq	N	–up, –ut
missa¦q	N	–p, –t
missersuu¦ppaa	V	–tinngilaa
missersuut	N	–ip, –it
missersuutig¦aa	V	–inngilaa
missi	N	–p, –t
Missiarsi	Prop	–p
M¦issiarsi	Prop	{–essiasip, –issiarsiip}
missig¦aa	V	–inngilaa
missigillu¦innarpaa	V	{–aannanngilaa, –innanngilaa}
missigisa¦q	N	–p, –t
missigivi¦ppaa	V	–nngilaa
missi¦k	N	{–ngup, –up}, {–it, –ngit}
missikor¦aa	V	–inngilaa
missilia¦q	N	–p, –t
missiliorlu¦innarpaa	V	{–aannanngilaa, –innanngilaa}
missili¦orpaa	V	–unngilaa
missiliu¦gaq	N	–kkap, –kkat
missiliuine¦q	N	–rup, –rit
missiliui¦voq	V	–nngilaq
missiliungajatt¦oq	N	–up, –ut
missiliu¦ppaa	V	–tinngilaa
missiliuu¦ppaa	V	–tinngilaa
missiliuussa¦q	N	–p, –t
missiliuussine¦q	N	–rup, –rit
missiliuussi¦voq	V	–nngilaq
missiliuut	N	–ip, –it
missiliuutaanna¦q	N	–ap, –at
missiliuut¦aannaq	N	{–aannaap, –iinnaap}, {–aannaat, –iinnaat}
missili¦voq	V	–nngilaq
missingeeriarne¦q	N	–rup, –rit
missing¦erpaa	V	–inngilaa
missingers¦orpaa	V	–unngilaa
missingersuine¦q	N	–rup, –rit
missingersuu¦ppaa	V	–tinngilaa
missingersuu¦siorsinnaatitaaneq	N	{–siorsinnaatitaanerup, –tiliorsinnaatitaanerup}, {–siorsinnaatitaanerit, –tiliorsinnaatitaanerit}
missingersuussi¦voq	V	–nngilaq
missingersuut	N	–ip, –it
missingersuutig¦aa	V	–inngilaa
missingiine¦q	N	–rup, –rit
missingiinna¦gaq	N	–kkap, –kkat
missingius¦erpaa	V	–inngilaa
missingiu¦serpaa	V	{–sinngilaa, –tilinngilaa}
missingiu¦serpaa	V	–tilinngilaa
missingiut	N	–ip, –it
missingiutaa¦voq	V	–nngilaq
missingiuteqanngilaq	V	(no generation)
missis¦orpoq	V	–unngilaq
missi¦sorpoq	V	{–sunngilaq, –tunngilaq}
missit¦orpoq	V	–unngilaq
missi¦torpoq	V	{–sunngilaq, –tunngilaq}
missi¦voq	V	–nngilaq
missug¦aa	V	–inngilaa
missuginni¦ppoq	V	–nngilaq
missukug¦aa	V	–inngilaa
missukuginni¦ppoq	V	–nngilaq
missukutaa¦voq	V	–nngilaq
missu¦ppaa	V	–nngilaa
misu¦ppaa	V	–nngilaa
misu¦ppoq	V	–nngilaq
misussima¦vaa	V	–nngilaa
misussivoq	V	(no generation)
misuta¦q	N	–p, –t
misutsine¦q	N	–rup, –rit
misutsissut	N	–ip, –it
misuttaallaqqi¦ppoq	V	–nngilaq
misuttaane¦q	N	–rup, –rit
misuttaasarfi¦k	N	–up, –it
misuttaasart¦oq	N	–up, –ut
misuttaas¦oq	N	–up, –ut
misuttaat	N	–ip, –it
misuttaatissat	N, pl.	-
misuttaavi¦k	N	–up, –it
misuttaa¦vik	N	{–ffiup, –viup}, {–ffiit, –viit}
misuttaa¦voq	V	–nngilaq
misutta¦rpaa	V	–nngilaa
misuutissat	N, pl.	-
mitaarfi¦k	N	–up, –it
mitaa¦rpaa	V	–nngilaa
mitaa¦rpoq	V	–nngilaq
mitaartaanna¦rpoq	V	–nngilaq
mitaartaa¦ppoq	V	{–nngilaq, –tinngilaq}
mitaart¦oq	N	–up, –ut
mitaarus¦erpoq	V	–inngilaq
mitaaru¦serpoq	V	{–sinngilaq, –tilinngilaq}
mitaarusi¦orpoq	V	–unngilaq
mitaaru¦siorpoq	V	{–siunngilaq, –tiliunngilaq}
mitaarut	N	–ip, –it
mitaarutserpoq	V	(no generation)
mitaatig¦aa	V	–inngilaa
mitaatigineqangaarne¦q	N	–rup, –rit
mitaatigineqarne¦q	N	–rup, –rit
mitaatiginninne¦q	N	–rup, –rit
mitaatiginni¦ppoq	V	–nngilaq
mitaatigisaane¦q	N	–rup, –rit
mitaatigisaa¦voq	V	–nngilaq
mitaatilleerpalutt¦oq	N	–up, –ut
mitaatill¦erpaa	V	–inngilaa
mitaatilliine¦q	N	–rup, –rit
mitaatilliis¦oq	N	–up, –ut
mitaatilliissut	N	–ip, –it
mitaatilliissut	N, pl.	-
mitaatillii¦voq	V	–nngilaq
mitagaane¦q	N	–rup, –rit
mitagaa¦voq	V	–nngilaq
mita¦gaq	N	–kkap, –kkat
mitallerajuppoq	V	(no generation)
mitallerne¦q	N	–rup, –rit
mitallerpalu¦ppoq	V	–nngilaq
mitallerpalutt¦oq	N	–up, –ut
mitall¦erpoq	V	–inngilaq
mitallersig¦aa	V	–inngilaa
mitallers¦oq	N	–up, –ut
mitaller¦soq	N	{–sup, –tup}, {–sut, –tut}
mitallersorsu¦uvoq	V	{–aanngilaq, –unngilaq}
mitaller¦sorsuuvoq	V	{–sorsuaanngilaq, –sorsuunngilaq, –torsuaanngilaq, –torsuunngilaq}
mitalliine¦q	N	–rup, –rit
mitalliisaanna¦rpoq	V	–nngilaq
mitalliut	N	–ip, –it
mitanna¦rpoq	V	–nngilaq
mitannarsissutig¦aa	V	–inngilaa
mitannarsivoq	V	(no generation)
mitanne¦q	N	–rup, –rit
mitanneqarne¦q	N	–rup, –rit
mita¦ppaa	V	–nngilaa
mitarrart¦ooq	N	–uup, –uut
mitass¦erpoq	V	–inngilaq
mitassiffig¦aa	V	–inngilaa
mitassinne¦q	N	–rup, –rit
mitassi¦ppoq	V	–nngilaq
mitassi¦voq	V	–nngilaq
mitata¦q	N	–p, –t
mitee¦raq	N	–qqap, –qqat
mit¦eeraq	N	{–eeqqap, –iaqqap}, {–eeqqat, –iaqqat}
mit¦eq	N	–ip, –it
miteraa¦voq	V	–nngilaq
mit¦eraavoq	V	{–eraanngilaq, –seraanngilaq}
mite¦raq	N	–qqap, –qqat
miternia¦q	N	–p, –t
miternia¦rpoq	V	–nngilaq
miterniart¦oq	N	–up, –ut
miterpassuit	N, pl.	-
mit¦erpoq	V	–inngilaq
mitersi¦orpoq	V	–unngilaq
mitersi¦voq	V	–nngilaq
miterta¦q	N	–p, –t
mitiisa¦ppoq	V	–nngilaq
mitilia¦rpoq	V	–nngilaq
mitili¦orpoq	V	–unngilaq
mitilli¦voq	V	–nngilaq
mitini¦ppoq	V	–nngilaq
mitit	N, pl.	-
mitiusa¦q	N	–p, –t
mitsa¦ppoq	V	–nngilaq
mitsa¦q	N	–p, –t
mitsa¦rpoq	V	–nngilaq
mitsars¦erpaa	V	–inngilaa
mitsart¦orpoq	V	–unngilaq
mitsar¦torpoq	V	{–sunngilaq, –tunngilaq}
mitsass¦erpaa	V	–inngilaa
mitsassia¦q	N	–p, –t
mitseri¦voq	V	–nngilaq
mits¦erpoq	V	–inngilaq
mitsiaqat	N	–ip, –it
mitsia¦rpoq	V	–nngilaq
mitsimaanna¦rpoq	V	–nngilaq
mitsimaffi¦k	N	–up, –it
mitsimagaju¦ppoq	V	–nngilaq
mitsimaqqissaa¦rpoq	V	–nngilaq
mitsima¦voq	V	–nngilaq
mitsimmas¦eq	N	–ip, –it
mitsimmat	N	–ip, –it
mitsimmavi¦k	N	–up, –it
mitsimmavinnaa¦q	N	–p, –t
mitsimmaviu¦voq	V	–nngilaq
mittaa¦voq	V	–nngilaq
mitta¦q	N	–p, –t
mittar¦aa	V	–inngilaa
Mittarfeqarfiit	N, pl.	-
Mittarfeqarfiit	Prop, pl.	-
mittarfeqarfiit	N, pl.	-
mittarfeqarfi¦k	N	–up, –it
mittarfi¦k	N	–up, –it
mittarfiliorne¦q	N	–rup, –rit
mittarfissu¦aq	N	–up, –it
mittarfiu¦voq	V	–nngilaq
mittat	N	–ip, –it
mittat	N, pl.	-
mittataa¦voq	V	–nngilaq
mittatig¦aa	V	–inngilaa
mittatigineqa¦rpoq	V	–nngilaq
mittatiginni¦ppoq	V	–nngilaq
mittatill¦erpaa	V	–inngilaa
mittatilliigajuppoq	V	(no generation)
mittatilliine¦q	N	–rup, –rit
mittatilliis¦oq	N	–up, –ut
mittatillii¦voq	V	–nngilaq
mm	N	(no generation)
Mocambique	Prop	–p, –t
m¦oorpoq	V	–uunngilaq
moort¦orpoq	V	–unngilaq
mor¦eerpaa	V	–iinngilaa
mor¦eerpoq	V	–iinngilaq
moreersisaasa¦q	N	–p, –t
moreersisart¦oq	N	–up, –ut
moreersit	N, pl.	-
moreersivi¦k	N	–up, –it
moreersi¦voq	V	–nngilaq
moreerti¦ppaa	V	–nngilaa
mor¦erpoq	V	–inngilaq
morfiini	N	(no generation)
morfi¦ppoq	V	–nngilaq
moriillisaane¦q	N	–rup, –rit
moriillisa¦rpaa	V	–nngilaa
moriillisarsima¦voq	V	–nngilaq
moriilli¦voq	V	–nngilaq
morii¦ppoq	V	–nngilaq
Moriusa¦q	Prop	–p
moriu¦voq	V	–nngilaq
mor¦orpoq	V	–unngilaq
morpa¦rpoq	V	–nngilaq
morpartaa¦rpoq	V	–nngilaq
morr¦oorpoq	V	–uunngilaq
morroortuarpoq	V	(no generation)
Mors	Prop	–ip
morsoqqa¦voq	V	–nngilaq
morsuallatta¦rpoq	V	–nngilaq
morsuffig¦aa	V	–inngilaa
morsuffi¦k	N	–up, –it
morsukkiart¦orpoq	V	–unngilaq
morsu¦ppoq	V	–nngilaq
morsusima¦voq	V	–nngilaq
morsuts¦erpoq	V	–inngilaq
morsutsikkaluarsinnaavaa	V	(no generation)
morsutsi¦ppaa	V	–nngilaa
morsutsitsine¦q	N	–rup, –rit
morsuttaa¦rpoq	V	–nngilaq
morsuu¦ppaa	V	–tinngilaa
morsuussinnaa¦vaa	V	–nngilaa
morsuussi¦voq	V	–nngilaq
Moskva	Prop	–p
Mossø	Prop	–p
motooreqarfi¦k	N	–up, –it
motoorers¦orpoq	V	–unngilaq
motoori	N	–p, –t
motooriia¦rpoq	V	–nngilaq
motoorileris¦oq	N	–up, –ut
motooril¦ik	N	{–iup, –lip, –lup}, –lit
motoorit	N, pl.	-
Mozambique	Prop	–p, –t
mu	Interj	(no generation)
Muldrup	Prop	–ip
mul¦eq	N	–ip, –it
mulequt	N	–ip, –it
mulertu¦voq	V	–nngilaq
muli¦k	N	{–ngup, –up}, {–it, –ngit}
mulikinaa¦rpaa	V	–nngilaa
muliki¦ppoq	V	–nngilaq
mulitu¦voq	V	–nngilaq
mullort¦ooq	N	–uup, –uut
mullortoorsu¦aq	N	–up, –it
mullortuallaaqaaq	V	(no generation)
mullortunersaat	N	–ip, –it
mullortunersaa¦voq	V	–nngilaq
mullortusi¦voq	V	–nngilaq
mullortu¦voq	V	–nngilaq
mullukkalla¦rpaa	V	–nngilaa
mullu¦ppaa	V	–tinngilaa
mullus¦erpoq	V	–inngilaq
mullu¦serpoq	V	{–sinngilaq, –tilinngilaq}
mullusinngua¦rpoq	V	–nngilaq
mullu¦sinnguarpoq	V	{–sinnguanngilaq, –tilinnguanngilaq}
mullussi¦voq	V	–nngilaq
mullut	N	–ip, –it
mullutaa¦voq	V	–nngilaq
mullutig¦aa	V	–inngilaa
mul¦oorpoq	V	–uunngilaq
muloortuarpoq	V	(no generation)
mulooru¦ppaa	V	–tinngilaa
muluallaaqaaq	V	(no generation)
muluallaa¦rpoq	V	–nngilaq
mulugajunnarnerusa¦rpoq	V	–nngilaq
mulugallarsinnaavoq	V	(no generation)
mulujuippoq	V	(no generation)
mulujumall¦erpoq	V	–inngilaq
mulummers¦orpoq	V	–unngilaq
mulungaatsiarpoq	V	(no generation)
mulusaa¦rpoq	V	–nngilaq
mulussut	N	–ip, –it
mulussut	N, pl.	-
mulussutig¦aa	V	–inngilaa
mulu¦voq	V	–nngilaq
mumeqqutaatig¦aa	V	–inngilaa
mumeqquta¦ppoq	V	–nngilaq
mum¦erpoq	V	–inngilaq
mumertuannguart¦oq	N	–up, –ut
mumigus¦erpoq	V	–inngilaq
mumigu¦serpoq	V	{–sinngilaq, –tilinngilaq}
mumigut	N	–ip, –it
mumigutaaja¦rpoq	V	–nngilaq
mumigutissa¦q	N	–p, –t
mumi¦k	N	–p, –t
muminga	N	–p, –t
muminganii¦ppoq	V	–nngilaq
mumingas¦oq	N	–up, –ut
muminga¦voq	V	–nngilaq
muminngaa¦rpoq	V	–nngilaq
muminngas¦oorpoq	V	–uunngilaq
muminngas¦oq	N	–up, –ut
muminngassu¦seq	N	–tsip, –tsit
muminngati¦ppaa	V	–nngilaa
muminnga¦voq	V	–nngilaq
mumi¦ppaa	V	–nngilaa
mumi¦ppoq	V	–nngilaq
mumisi¦ppaa	V	–nngilaa
mumisiteri¦voq	V	–nngilaq
mumisitsine¦q	N	–rup, –rit
mumisitsiniart¦oq	N	–up, –ut
mumisitsi¦voq	V	–nngilaq
mumitsine¦q	N	–rup, –rit
mumitsi¦ppaa	V	–nngilaa
mumi¦tsippaa	V	{–ssinngilaa, –tsinngilaa}
mumitsit	N	–ip, –it
mumitsi¦voq	V	–nngilaq
mumitt¦oorpoq	V	–uunngilaq
mumittoorsima¦voq	V	–nngilaq
mumiut	N	–ip, –it
mumiut	N, pl.	-
mumm¦eq	N	–ip, –it
mummi	N	–p, –t
mummianii¦ppoq	V	–nngilaq
musaasa¦q	N	–p, –t
musaasat	N, pl.	-
musa¦q	N	–p, –t
musliimi	N	(no generation)
muss¦oorpoq	V	–uunngilaq
mussuula¦voq	V	–nngilaq
mut¦eq	N	–ip, –it
mutit	N, pl.	-
mutius¦oq	N	–up, –ut
muuamaakkuus¦oq	N	–up, –ut
muukul¦ooq	N	–uup, –uut
Møn	Prop	–ip
møtrikki	N	(no generation)
