Lexeme	WC	Flexion
ee	Interj	(no generation)
eeq	Interj	(no generation)
eeqa¦k	N	–ap, –at
eeqqatu¦k	N	–up, –it
eequja¦voq	V	–nngilaq
eer¦aa	V	–inngilaa
eerna¦rpoq	V	–nngilaq
eernart¦oq	N	–up, –ut
eersi¦orpoq	V	–unngilaq
eertaa¦ppoq	V	–nngilaq
eertaasa¦q	N	–p, –t
eertaat	N	–ip, –it
eertali¦orpoq	V	–unngilaq
eertallit	N, pl.	-
eerta¦q	N	–p, –t
eertarne¦q	N	–rup, –rit
eertarpaluk	N	–up, –it
eertarpalu¦k	N	–up, –it
eertarpalunne¦q	N	–rup, –rit
eerta¦rpoq	V	–nngilaq
eert¦orpoq	V	–unngilaq
efterskolerne¦q	N	–rup, –rit
efterskol¦erpoq	V	–inngilaq
efterskoler¦toq	N	{–sup, –tup}, {–sut, –tut}
Egyptenim¦eersoq	N	{–eersup, –eertup, –inngaanneersup, –inngaanneertup, –inngaanninngaanneersup, –inngaanninngaanneertup}, {–eersut, –eertut, –inngaanneersut, –inngaanneertut, –inngaanninngaanneersut, –inngaanninngaanneertut}
Egyptenim¦eersoq	N	{–eersup, –eertup, –inngaanneersup, –inngaanneertup}, {–eersut, –eertut, –inngaanneersut, –inngaanneertut}
Egyptenimioq	N	(no generation)
Egypten¦imiu	N	{–ermiup, –imiup}, {–ermiut, –imiut}
ekkoloddi	N	(no generation)
eqaallisaane¦q	N	–rup, –rit
eqaallisarne¦q	N	–rup, –rit
eqaallisa¦rpaa	V	–nngilaa
eqaallisa¦rpoq	V	–nngilaq
eqaalli¦voq	V	–nngilaq
eqaannersaa¦voq	V	–nngilaq
eqaa¦ppoq	V	–nngilaq
eqaa¦rpoq	V	–nngilaq
eqaarsaallamma¦k	N	–ap, –at
eqaarsaallaqqi¦ppoq	V	–nngilaq
eqaarsaarfi¦k	N	–up, –it
eqaarsaarne¦q	N	–rup, –rit
eqaarsaa¦rpoq	V	–nngilaq
eqaarsaartart¦oq	N	–up, –ut
eqaassu¦seq	N	–tsip, –tsit
eqaats¦oq	N	–up, –ut
eqaatsoriinna¦rpaa	V	–nngilaa
eqaatsuune¦q	N	–rup, –rit
eqall¦erpoq	V	–inngilaq
eqalliarajuppoq	V	(no generation)
eqalliarfi¦k	N	–up, –it
eqallia¦rpoq	V	–nngilaq
eqalo¦raq	N	–qqap, –qqat
eqalua¦q	N	–p, –t
eqalua¦raq	N	–qqap, –qqat
eqaluatsia¦q	N	–ap, –at
Eqalugaarsuit	N, pl.	-
eqalugaasa¦q	N	–p, –t
eqalu¦gaq	N	–kkap, –kkat
eqalugi¦aq	N	–ssap, –ssat
eqalui¦k	N	–up, –it
Eqaluit	N, pl.	-
Eqaluit	Prop, pl.	-
eqalu¦k	N	–up, –it
eqalukaa¦q	N	–p, –t
eqalukilligaluttuinnarpoq	V	(no generation)
eqalullukaa¦q	N	–p, –t
eqalunnia¦q	N	–p, –t
eqalunniarajuppoq	V	(no generation)
eqalunniarfi¦k	N	–up, –it
eqalunnia¦rpoq	V	–nngilaq
eqalu¦ppoq	V	–nngilaq
eqalussi¦orpoq	V	–unngilaq
eqaluss¦iorpoq	V	{–iunngilaq, –aliunngilaq}
eqalussuanngu¦voq	V	–nngilaq
eqalussu¦aq	N	–up, –it
eqalussuarnia¦rpoq	V	–nngilaq
eqalussuarniut	N	–ip, –it
eqalussuarniutissarsi¦voq	V	–nngilaq
eqaluusa¦q	N	–p, –t
eqar¦aa	V	–inngilaa
eqarisaqanngilaq	V	(no generation)
eqa¦rpoq	V	–nngilaq
eqartaaru¦ppoq	V	–tinngilaq
eqartang¦erpoq	V	–inngilaq
eqartangersimas¦oq	N	–up, –ut
eqarti	N	–p, –t
eqartil¦ik	N	{–iup, –lip, –lup}, –lit
eqartill¦erpoq	V	–inngilaq
eqartilu¦ppoq	V	–nngilaq
eqarti¦ppoq	V	–nngilaq
eqart¦oq	N	–up, –ut
eqatalaa¦rpoq	V	–nngilaq
eqeeraluttuinnarpoq	V	(no generation)
eq¦eerpoq	V	–iinngilaq
eqeersaasart¦oq	N	–up, –ut
eqeersaas¦oq	N	–up, –ut
eqeersaat	N	–ip, –it
eqeer¦saat	N	{–saatip, –taatip}, {–saatit, –taatit}
eqeersaatissa¦q	N	–p, –t
eqeer¦saatissaq	N	{–saatissap, –taatissap}, {–saatissat, –taatissat}
eqeersagaane¦q	N	–rup, –rit
eqeersarne¦q	N	–rup, –rit
eqeersa¦rpaa	V	–nngilaa
eqeersimaarluart¦oq	N	–up, –ut
eqeersimaart¦oq	N	–up, –ut
eqeers¦oorpoq	V	–uunngilaq
eqeersuummisaa¦rpoq	V	–nngilaq
eqeersuummi¦voq	V	–nngilaq
eq¦eq	N	–ip, –it
eqeqq¦oq	N	–up, –ut
eqeqqormi¦ppaa	V	–nngilaa
eqerlunne¦q	N	–rup, –rit
eqert¦ooq	N	–uup, –uut
eqi	N	–p, –t
eqiag¦aa	V	–inngilaa
eqiana¦rpoq	V	–nngilaq
eqianni¦voq	V	–nngilaq
eqiasui¦ppoq	V	–nngilaq
eqiasuits¦oq	N	–up, –ut
eqiasuppaalu¦k	N	–up, –it
eqiasuppalu¦k	N	–up, –it
eqiasu¦ppoq	V	–nngilaq
eqiasussu¦seq	N	–tsip, –tsit
eqiasutt¦oq	N	–up, –ut
eqiasuttorsu¦aq	N	–up, –it
eqiatitaa¦rpoq	V	–nngilaq
eqiatitaart¦oq	N	–up, –ut
eqiatsaa¦ppaa	V	–tinngilaa
eqiatta¦rpoq	V	–nngilaq
eqiattortu¦voq	V	–nngilaq
eqig¦aaq	V	–inngilaq
eqiiallaatig¦aa	V	–inngilaa
eqiiallappoq	V	(no generation)
eqiingasaa¦rpoq	V	–nngilaq
eqiingas¦oq	N	–up, –ut
eqiingasuu¦voq	V	–nngilaq
eqiinga¦voq	V	–nngilaq
eqiivissima¦voq	V	–nngilaq
eqi¦k	N	{–ngup, –up}, {–it, –ngit}
eqikkaane¦q	N	–rup, –rit
eqikkaa¦neq	N	{–junerup, –nerup}, {–junerit, –nerit}
eqikkaa¦voq	V	{–junngilaq, –nngilaq}
eqikkaa¦voq	V	–nngilaq
eqikka¦gaq	N	–kkap, –kkat
eqikkakkat	N, pl.	-
eqikkarne¦q	N	–rup, –rit
eqikka¦rpaa	V	–nngilaa
eqikka¦rpoq	V	–nngilaq
eqill¦erpoq	V	–inngilaq
eqilu¦ppoq	V	–nngilaq
eqimattakkuutaat	N, pl.	-
eqimat¦tat	N, pl.	{–at, –tat}
eqima¦voq	V	–nngilaq
eqine¦q	N	–rup, –rit
eqingane¦q	N	–rup, –rit
eqi¦nganiippoq	V	{–aniinngilaq, –nganiinngilaq}
eqingas¦oorpoq	V	–uunngilaq
eqingasuli¦ppoq	V	–nngilaq
eqingasuli¦ttoq	N	{–ssup, –ttup}, {–ssut, –ttut}
eqinga¦voq	V	–nngilaq
eqinnaalli¦orpoq	V	–unngilaq
eqinnaanne¦q	N	–rup, –rit
eqinnaa¦ppoq	V	–nngilaq
eqinnaasaa¦rpoq	V	–nngilaq
eqinnaas¦erpoq	V	–inngilaq
eqinnaats¦oq	N	–up, –ut
eqi¦ppaa	V	–nngilaa
eqi¦ppoq	V	–nngilaq
eqisaava¦q	N	–p, –t
eqisalul¦erpoq	V	–inngilaq
eqisalu¦ppoq	V	–nngilaq
eqisalutsi¦ppoq	V	–nngilaq
eqisalutt¦oq	N	–up, –ut
eqisarne¦q	N	–rup, –rit
eqisa¦rpoq	V	–nngilaq
eqisartitsi¦voq	V	–nngilaq
eqisimaarpaa	V	(no generation)
eqisimi¦aq	N	–ssap, –ssat
eqisimia¦rpaa	V	–nngilaa
eqisimissat	N, pl.	-
eqisimiss¦erpoq	V	–inngilaq
eqisimissiu¦ppaa	V	–tinngilaa
eqissu¦ppaa	V	–tinngilaa
eqissu¦ppoq	V	–nngilaq
eqissussi¦voq	V	–nngilaq
eqita¦q	N	–p, –t
eqiteriffi¦k	N	–up, –it
eqiterine¦q	N	–rup, –rit
eqiteri¦voq	V	–nngilaq
eqiterneqart¦oq	N	–up, –ut
eqit¦erneqartoq	N	{–erneqartup, –serneqartup}, {–erneqartut, –serneqartut}
eqi¦terneqartoq	N	{–serneqartup, –terneqartup}, {–serneqartut, –terneqartut}
eqit¦erpaa	V	–inngilaa
eqitersimas¦oq	N	–up, –ut
eqi¦tersimasoq	N	{–sersimasup, –tersimasup}, {–sersimasut, –tersimasut}
eqiterut	N	–ip, –it
eqiterutit	N, pl.	-
eqiterutitaa¦rpoq	V	–nngilaq
eqiti¦ppaa	V	–nngilaa
eqit¦ippaa	V	–sinngilaa
eqitsine¦q	N	–rup, –rit
eqitsi¦t	N	–sip, –sit
eqi¦tsitsineq	N	{–ssitsinerup, –tsitsinerup, –titsinerup}, {–ssitsinerit, –tsitsinerit, –titsinerit}
eqitsi¦voq	V	–nngilaq
eqittaa¦voq	V	–nngilaq
eqi¦voq	V	–nngilaq
eqoqittaa¦voq	V	–nngilaq
eqorii¦ppoq	V	–nngilaq
eq¦orpaa	V	–unngilaa
eq¦orpoq	V	–unngilaq
eqorti¦ppoq	V	–nngilaq
eqort¦orpoq	V	–unngilaq
eqqaamajuminarsa¦gaq	N	–kkap, –kkat
eqqaamaneeru¦ppoq	V	–tinngilaq
eqqaamane¦q	N	–rup, –rit
eqqaamanni¦ppoq	V	–nngilaq
eqqaamannissinnaane¦q	N	–rup, –rit
eqqaamannissu¦seq	N	–tsip, –tsit
eqqaamasaarullu¦innarneq	N	{–innarnerup, –aannarnerup}, {–innarnerit, –aannarnerit}
eqqaamasaarunne¦q	N	–rup, –rit
eqqaamasaaru¦ppoq	V	–tinngilaq
eqqaamasalersaarut	N	–ip, –it
eqqaamasalersaarutit	N, pl.	-
eqqaamasalikkersaarut	N	–ip, –it
eqqaamasa¦q	N	–p, –t
eqqaamasaqarfig¦aa	V	–inngilaa
eqqaamasassa¦q	N	–p, –t
eqqaamasat	N, pl.	-
eqqaamasinnaane¦q	N	–rup, –rit
eqqaamassut	N	–ip, –it
eqqaamassutissia¦q	N	–p, –t
eqqaamassutiss¦iorneq	N	{–aliornerup, –iornerup}, {–aliornerit, –iornerit}
eqqaamassutiss¦iorpoq	V	{–aliunngilaq, –iunngilaq}
eqqaama¦vaa	V	–nngilaa
eqqaama¦voq	V	–nngilaq
eqqaamioqarfi¦k	N	–up, –it
eqqaamiu	N	–p, –t
eqqaamiut	N, pl.	-
eqqaana¦rpoq	V	–nngilaq
eqqaane¦q	N	–rup, –rit
eqqaaneqareer¦soq	N	{–sup, –tup}, {–sut, –tut}
eqqaaneqarsinnaas¦oq	N	–up, –ut
eqqaaniaane¦q	N	–rup, –rit
eqqaaniarne¦q	N	–rup, –rit
eqqaania¦rpaa	V	–nngilaa
eqqaanii¦ppoq	V	–nngilaq
eqqaaniut	N	–ip, –it
eqqaaniutig¦aa	V	–inngilaa
eqqaa¦ppaa	V	–tinngilaa
eqqaar¦aa	V	–inngilaa
eqqaariinna¦rpaa	V	–nngilaa
eqqaarsu¦ppoq	V	–nngilaq
eqqaartuussisutigoortippaa	V	(no generation)
eqqaasaqa¦rpoq	V	–nngilaq
eqqaasi¦orpaa	V	–unngilaa
eqqaasi¦ppaa	V	–nngilaa
eqqaa¦sippaa	V	{–sinngilaa, –tinngilaa}
eqqaasissutig¦aa	V	–inngilaa
eqqaasitsissut	N	–ip, –it
eqqaa¦sitsissut	N	{–sitsissutip, –titsissutip}, {–sitsissutit, –titsissutit}
eqqaasitsissutig¦aa	V	–inngilaa
eqqaa¦sitsissutigaa	V	{–sitsissutiginngilaa, –titsissutiginngilaa}
eqqaasiuine¦q	N	–rup, –rit
eqqaassaa¦rpaa	V	–nngilaa
eqqaassi¦voq	V	–nngilaq
eqqaassu¦seq	N	–tsip, –tsit
eqqaassutig¦aa	V	–inngilaa
eqqaassutissa¦q	N	–p, –t
eqqaassutissat	N, pl.	-
eqqaassutissia¦q	N	–p, –t
eqqaa¦vaa	V	–nngilaa
eqqaa¦veqarfik	N	{–ffeqarfiup, –veqarfiup}, {–ffeqarfiit, –veqarfiit}
eqqaa¦vik	N	{–ffiup, –viup}, {–ffiit, –viit}
eqqaa¦vissiorpoq	V	{–ffissiunngilaq, –vissiunngilaq, –ffissaliunngilaq, –vissaliunngilaq}
eqqaa¦vissuaq	N	{–ffissuup, –vissuup}, {–ffissuit, –vissuit}
eqqaa¦voq	V	–nngilaq
eqqag¦aa	V	–inngilaa
eqqagassalerine¦q	N	–rup, –rit
eqqagassanngortitsis¦oq	N	–up, –ut
eqqagassaqaler¦sitsisoq	N	{–sitsisup, –titsisup}, {–sitsisut, –titsisut}
eqqagassat	N, pl.	-
eqqakkat	N, pl.	-
eqqalu¦k	N	–up, –it
eqqanaarna¦rpoq	V	–nngilaq
eqqanaa¦rpaa	V	–nngilaa
eqqanaa¦rpoq	V	–nngilaq
eqqanaarsaane¦q	N	–rup, –rit
eqqanaarsaa¦ppaa	V	–tinngilaa
eqqanaarsa¦rpoq	V	–nngilaq
eqqanaart¦orpoq	V	–unngilaq
eqqanaraluttu¦aq	N	–up, –it
eqqana¦rpoq	V	–nngilaq
eqqanarsilat	Interj	(no generation)
eqqa¦q	N	–p, –t
eqqarasuartaat	N	–ip, –it
eqqarisa¦q	N	–p, –t
eqqarl¦eq	N	–iup, –iit
eqqarler¦aa	V	–inngilaa
eqqarleriissu¦seq	N	–tsip, –tsit
eqqarleriit	N, pl.	-
eqqarlerisa¦q	N	–p, –t
eqqarlimaa¦rpaa	V	–nngilaa
eqqarlimaarut	N	–ip, –it
eqqarpaluk	N	–up, –it
eqqarpalu¦k	N	–up, –it
eqqa¦rpoq	V	–nngilaq
eqqarsaat	N	–ip, –it
eqqarsaat¦aannaq	N	{–aannaap, –iinnaap}, {–aannaat, –iinnaat}
eqqarsaateqanngits¦oq	N	–up, –ut
eqqarsaatersorne¦q	N	–rup, –rit
eqqarsaaters¦orpoq	V	–unngilaq
eqqarsaatersuut	N	–ip, –it
eqqarsaatersuuteqarne¦q	N	–rup, –rit
eqqarsaatig¦aa	V	–inngilaa
eqqarsaatigileriataarpaa	V	(no generation)
eqqarsaatigilluagaanngits¦oq	N	–up, –ut
eqqarsaatigilluagaas¦oq	N	–up, –ut
eqqarsaatigillua¦gaq	N	–kkap, –kkat
eqqarsaatigilluaqqaagaanngits¦oq	N	–up, –ut
eqqarsaatigilluaqqaa¦gaq	N	–kkap, –kkat
eqqarsaatiginneqqinne¦q	N	–rup, –rit
eqqarsaatiginneqqissaa¦rpoq	V	–nngilaq
eqqarsaatiginnilluaqqaartart¦oq	N	–up, –ut
eqqarsaatiginni¦ppoq	V	–nngilaq
eqqarsaatigiuaanna¦rpaa	V	–nngilaa
eqqarsaatigiuma¦vaa	V	–nngilaa
eqqarsaatigiunnaa¦rpaa	V	–nngilaa
eqqarsaatiss¦iissut	N	{–aliissutip, –iissutip}, {–aliissutit, –iissutit}
eqqarsallaqqi¦ppoq	V	–nngilaq
eqqarsaqatigiit	N, pl.	-
eqqarsaqqissaarne¦q	N	–rup, –rit
eqqarsariaallatsitsi¦voq	V	–nngilaq
eqqarsariaa¦seq	N	–tsip, –tsit
eqqarsarluarne¦q	N	–rup, –rit
eqqarsarluarsinnaanngits¦oq	N	–up, –ut
eqqarsarna¦rpoq	V	–nngilaq
eqqarsarnart¦oq	N	–up, –ut
eqqarsarnartoqal¦erpoq	V	–inngilaq
eqqarsarnartoqa¦rpoq	V	–nngilaq
eqqarsarne¦q	N	–rup, –rit
eqqarsarpallaanngikkallarpoq	V	(no generation)
eqqarsa¦rpoq	V	–nngilaq
eqqarsartaa¦seq	N	–tsip, –tsit
eqqarsartart¦oq	N	–up, –ut
eqqartorneqart¦oq	N	–up, –ut
eqqar¦torneqartoq	N	{–sorneqartup, –torneqartup}, {–sorneqartut, –torneqartut}
eqqart¦orpaa	V	–unngilaa
eqqartortu¦aannagaq	N	{–aannakkap, –innakkap}, {–aannakkat, –innakkat}
eqqartorumanngisa¦q	N	–p, –t
eqqartuerusunnginne¦q	N	–rup, –rit
eqqartu¦gaq	N	–kkap, –kkat
eqqar¦tugaq	N	{–sukkap, –tukkap}, {–sukkat, –tukkat}
eqqartuiluumivoq	V	(no generation)
eqqartuine¦q	N	–rup, –rit
eqqartui¦voq	V	–nngilaq
eqqartukulavaa	V	(no generation)
eqqartul¦erpaa	V	–inngilaa
eqqartunnaagar¦aa	V	–inngilaa
eqqartuunneqartussanngortitaane¦q	N	–rup, –rit
eqqartuunneqassa¦aq	V	–nngilaq
eqqartuu¦ppaa	V	–tinngilaa
eqqartuusiviit	N, pl.	-
eqqar¦tuusiviit	N, pl.	{–tuusiviit, –suusiviit}
eqqartuussaasimane¦q	N	–rup, –rit
eqqartuussaa¦voq	V	–nngilaq
eqqartuussa¦q	N	–p, –t
eqqartuusseqataasart¦oq	N	–up, –ut
eqqartuusseqataasartut	N, pl.	-
eqqartuusseqataas¦oq	N	–up, –ut
eqqartuusseriaa¦seq	N	–tsip, –tsit
eqqartuussine¦q	N	–rup, –rit
eqqartuussinertaqanngits¦oq	N	–up, –ut
eqqartuussisaa¦seq	N	–tsip, –tsit
eqqartuussisarfi¦k	N	–up, –it
eqqartuussisarne¦q	N	–rup, –rit
eqqartuussisinnaaffi¦k	N	–up, –it
eqqartuussisinnaane¦q	N	–rup, –rit
eqqartuussisinnaas¦oq	N	–up, –ut
eqqartuussisinnaatitaas¦oq	N	–up, –ut
eqqartuussisinnaatitaasut	N, pl.	-
eqqartuussisooqataasart¦oq	N	–up, –ut
eqqartuussis¦oq	N	–up, –ut
eqqartuussisoqarfi¦k	N	–up, –it
Eqqartuussisoqarfik Sermers¦ooq	Prop	–uup
eqqartuussisoqarne¦q	N	–rup, –rit
eqqartuussissuseris¦oq	N	–up, –ut
eqqartuussissu¦serisoq	N	{–serisup, –tilerisup}, {–serisut, –tilerisut}
eqqartuussissuserisoqarfi¦k	N	–up, –it
eqqartuussissu¦serisoqarfik	N	{–serisoqarfiup, –tilerisoqarfiup}, {–serisoqarfiit, –tilerisoqarfiit}
eqqartuussissuserisoqarne¦q	N	–rup, –rit
eqqartuussissu¦serisoqarneq	N	{–serisoqarnerup, –tilerisoqarnerup}, {–serisoqarnerit, –tilerisoqarnerit}
eqqartuussissut	N	–ip, –it
eqqartuussissutigineqart¦oq	N	–up, –ut
eqqartuussissutigisa¦q	N	–p, –t
eqqartuussissutissa¦q	N	–p, –t
eqqartuussisulersuussassaannginne¦q	N	–rup, –rit
eqqartuussisuler¦suussineq	N	{–suussinerup, –tuussinerup}, {–suussinerit, –tuussinerit}
eqqartuussisussaatitaane¦q	N	–rup, –rit
eqqartuussisut	N, pl.	-
eqqartuussisutigoorti¦ppaa	V	–nngilaa
eqqartuussisutigoortitsine¦q	N	–rup, –rit
eqqartuussisutigoort¦oq	N	–up, –ut
eqqartuussisuune¦q	N	–rup, –rit
eqqartuussisuuneqarfi¦k	N	–up, –it
eqqartuussiveqarfi¦k	N	–up, –it
eqqartuussi¦veqarfik	N	{–ffeqarfiup, –veqarfiup}, {–ffeqarfiit, –veqarfiit}
eqqartuussiveqarne¦q	N	–rup, –rit
eqqartuussi¦veqarneq	N	{–ffeqarnerup, –veqarnerup}, {–ffeqarnerit, –veqarnerit}
eqqartuussivi¦k	N	–up, –it
eqqartuussi¦vik	N	{–ffiup, –viup}, {–ffiit, –viit}
eqqartuussi¦voq	V	–nngilaq
eqqartuussut	N	–ip, –it
eqqartuussutig¦aa	V	–inngilaa
eqqartuussutigineqar¦eerpoq	V	–iinngilaq
eqqartuussutigisa¦q	N	–p, –t
eqqartuussutigisassanngorti¦ppaa	V	–nngilaa
eqqartuussutit	N, pl.	-
eqqartuutiffissa¦q	N	–p, –t
eqqartuut¦iffissaq	N	{–iffissap, –itiffissap, –siffissap}, {–iffissat, –itiffissat, –siffissat}
eqqartuuti¦ppaa	V	–nngilaa
eqqartuut¦ippaa	V	{–itinngilaa, –sinngilaa}
eqqartuut¦ippoq	V	{–itinngilaq, –sinngilaq}
eqqartuut¦itinniagaq	N	{–itinniakkap, –sinniakkap}, {–itinniakkat, –sinniakkat}
eqqartuutitinniarpaa	V	(no generation)
eqqartuutit¦itsiniartoq	N	{–itsiniartup, –sitsiniartup}, {–itsiniartut, –sitsiniartut}
eqqasunne¦q	N	–rup, –rit
eqqasu¦ppoq	V	–nngilaq
eqqasutt¦oq	N	–up, –ut
eqqasuu¦ppaa	V	–tinngilaa
eqqasuut	N	–ip, –it
eqqasuuteqanngits¦oq	N	–up, –ut
eqqasuutig¦aa	V	–inngilaa
eqqatsaa¦ppaa	V	–tinngilaa
eqqatsaatig¦aa	V	–inngilaa
eqqatsanna¦rpoq	V	–nngilaq
eqqatsa¦ppoq	V	–nngilaq
eqqattaa¦rpoq	V	–nngilaq
eqq¦eq	N	–ip, –it
eqq¦erpoq	V	–inngilaq
eqqiaas¦oq	N	–up, –ut
eqqiaassutit	N, pl.	-
eqqiaat	N	–ip, –it
eqqia¦rpaa	V	–nngilaa
eqqia¦rpoq	V	–nngilaq
eqqil¦ik	N	{–iup, –lip, –lup}, –lit
eqqili¦orpoq	V	–unngilaq
eqqillit	N, pl.	-
eqqiluillisaa¦rpoq	V	–nngilaq
eqqilui¦ppoq	V	–nngilaq
eqqiluisaarne¦q	N	–rup, –rit
eqqiluisaa¦rpoq	V	–nngilaq
eqqiluissu¦seq	N	–tsip, –tsit
eqqiluits¦oq	N	–up, –ut
eqqini¦ppoq	V	–nngilaq
eqqi¦ppoq	V	–nngilaq
eqqissaa¦rpoq	V	–nngilaq
eqqissaarunnaa¦rpoq	V	–nngilaq
eqqisseqqissaarne¦q	N	–rup, –rit
eqqi¦sseqqissaarneq	N	{–sseqqissaarnerup, –tseqqissaarnerup}, {–sseqqissaarnerit, –tseqqissaarnerit}
eqqissiallaatig¦aa	V	–inngilaa
eqqissiallannart¦oq	N	–up, –ut
eqqi¦ssiallannartoq	N	{–ssiallannartup, –tsiallannartup}, {–ssiallannartut, –tsiallannartut}
eqqissialla¦ppoq	V	–nngilaq
eqqissiallatsitsi¦voq	V	–nngilaq
eqqi¦ssiallatsitsivoq	V	{–ssiallatsitsinngilaq, –tsiallatsitsinngilaq}
eqqissinart¦oq	N	–up, –ut
eqqissine¦q	N	–rup, –rit
eqqissisaane¦q	N	–rup, –rit
eqqissisaat	N	–ip, –it
eqqissisaa¦voq	V	–nngilaq
eqqissisarneqa¦rpoq	V	–nngilaq
eqqissisa¦rpaa	V	–nngilaa
eqqissisimaarluinnart¦oq	N	–up, –ut
eqqi¦ssisimaarluinnartoq	N	{–ssisimaarluinnartup, –ssissimaarluinnartup, –tsisimaarluinnartup, –tsissimaarluinnartup}, {–ssisimaarluinnartut, –ssissimaarluinnartut, –tsisimaarluinnartut, –tsissimaarluinnartut}
eqqissisimaarpoq	V	(no generation)
eqqissisimanart¦oq	N	–up, –ut
eqqi¦ssisimanartoq	N	{–ssisimanartup, –tsisimanartup}, {–ssisimanartut, –tsisimanartut}
eqqissisimane¦q	N	–rup, –rit
eqqi¦ssisimaneq	N	{–ssisimanerup, –tsisimanerup}, {–ssisimanerit, –tsisimanerit}
eqqissisimannginne¦q	N	–rup, –rit
eqqi¦ssisimannginneq	N	{–ssisimannginnerup, –tsisimannginnerup}, {–ssisimannginnerit, –tsisimannginnerit}
eqqissisimas¦oq	N	–up, –ut
eqqi¦ssisimasoq	N	{–ssisimasup, –tsisimasup}, {–ssisimasut, –tsisimasut}
eqqissisimatitaa¦voq	V	–nngilaq
eqqi¦ssisimatitaavoq	V	{–ssisimatitaanngilaq, –tsisimatitaanngilaq}
eqqissisimatita¦q	N	–p, –t
eqqi¦ssisimatitaq	N	{–ssisimatitap, –tsisimatitap}, {–ssisimatitat, –tsisimatitat}
eqqissisimatitsine¦q	N	–rup, –rit
eqqi¦ssisimatitsineq	N	{–ssisimatitsinerup, –tsisimatitsinerup}, {–ssisimatitsinerit, –tsisimatitsinerit}
eqqissisimatitsivi¦k	N	–up, –it
eqqissisimatitsi¦vik	N	{–ffiup, –viup}, {–ffiit, –viit}
eqqissisi¦ppaa	V	–nngilaa
eqqississu¦seq	N	–tsip, –tsit
eqqi¦ssissuseq	N	{–ssissutsip, –tsissutsip}, {–ssissutsit, –tsissutsit}
eqqississutig¦aa	V	–inngilaa
eqqissiveerunne¦q	N	–rup, –rit
eqqissiveeru¦ppoq	V	–tinngilaq
eqqissiveqanngilaq	V	(no generation)
eqqissiveqannginne¦q	N	–rup, –rit
eqqissiveqanngits¦oq	N	–up, –ut
eqqissivig¦aa	V	–inngilaa
eqqissiviilliorne¦q	N	–rup, –rit
eqqissiviilliortitsine¦q	N	–rup, –rit
eqqissiviits¦oq	N	–up, –ut
eqqissiviitsunngortinneqarne¦q	N	–rup, –rit
eqqissiviitsunngorti¦ppaa	V	–nngilaa
eqqissivissaqanngilaq	V	(no generation)
eqqissivissioqatigiinne¦q	N	–rup, –rit
eqqissiviss¦ioqatigiinneq	N	{–ioqatigiinnerup, –alioqatigiinnerup}, {–ioqatigiinnerit, –alioqatigiinnerit}
eqqissi¦voq	V	–nngilaq
eqq¦oq	N	–up, –ut
eqqoqqajarpaa	V	(no generation)
eqqoqqort¦ooq	N	–uup, –uut
eqqoqut	N	–ip, –it
eqqoriaane¦q	N	–rup, –rit
eqqoriaanna¦gaq	N	–kkap, –kkat
eqqoriaa¦voq	V	–nngilaq
eqqoriarniu¦ppaa	V	–tinngilaa
eqqoriarniutig¦aa	V	–inngilaa
eqqoria¦rpaa	V	–nngilaa
eqqorluaasart¦oq	N	–up, –ut
eqqorlua¦rpaa	V	–nngilaa
eqqorluinna¦rpoq	V	–nngilaq
eqqorlu¦innarpoq	V	{–innanngilaq, –aannanngilaq}
eqqorluinnart¦oq	N	–up, –ut
eqqorlu¦innartoq	N	{–innartup, –aannartup}, {–innartut, –aannartut}
eqqorluinnartuunngits¦oq	N	–up, –ut
eqqorlu¦innartuunngitsoq	N	{–innartuunngitsup, –aannartuunngitsup}, {–innartuunngitsut, –aannartuunngitsut}
eqqornaveeqqut	N	–ip, –it
eqqornaveeqqutaasa¦q	N	–p, –t
eqqorneqajassu¦seq	N	–tsip, –tsit
eqqorneqa¦rpoq	V	–nngilaq
eqqorneqart¦oq	N	–up, –ut
eqqorniaa¦voq	V	–nngilaq
eqqorniunne¦q	N	–rup, –rit
eqq¦orpaa	V	–unngilaa
eqq¦orpoq	V	–unngilaq
eqqorsima¦voq	V	–nngilaq
eqqors¦orpoq	V	–unngilaq
eqqor¦sorpoq	V	{–sunngilaq, –tunngilaq}
eqqorsu¦ppoq	V	–nngilaq
eqqortaali¦orpoq	V	–unngilaq
eqqortinngilaa	V	(no generation)
eqqorti¦ppaa	V	–nngilaa
eqqorti¦ppoq	V	–nngilaq
eqqortitsine¦q	N	–rup, –rit
eqqortitsinnginne¦q	N	–rup, –rit
eqqort¦oq	N	–up, –ut
eqqortuli¦orpoq	V	–unngilaq
eqqortuliorsinnaane¦q	N	–rup, –rit
eqqortuune¦q	N	–rup, –rit
eqqortuuneraane¦q	N	–rup, –rit
eqqortuunera¦rpaa	V	–nngilaa
eqqortuunngits¦oq	N	–up, –ut
eqqortuuti¦ppaa	V	–nngilaa
eqqorunnaarsi¦ppaa	V	–nngilaa
eqqorutit	N, pl.	-
eqqueria¦taarneq	N	{–saarnerup, –taarnerup}, {–saarnerit, –taarnerit}
eqqugaas¦oq	N	–up, –ut
eqqu¦gaq	N	–kkap, –kkat
eqqugassa¦q	N	–p, –t
eqquigajuppoq	V	(no generation)
eqquillaqqi¦ppoq	V	–nngilaq
eqquillua¦rpoq	V	–nngilaq
eqquilluart¦oq	N	–up, –ut
eqquiniaasitsine¦q	N	–rup, –rit
eqquiniarne¦q	N	–rup, –rit
eqquinia¦rpoq	V	–nngilaq
eqquiniunne¦q	N	–rup, –rit
eqquiniut	N	–ip, –it
eqquisinnaalluarpoq	V	(no generation)
eqqui¦voq	V	–nngilaq
eqquj¦ooq	N	–uup, –uut
eqqukkiartuaarneqassa¦aq	V	–nngilaq
eqqumaffig¦aa	V	–inngilaa
eqqumania¦rpoq	V	–nngilaq
eqquma¦sivoq	V	{–nninngilaq, –sinngilaq}
eqqumas¦oq	N	–up, –ut
eqqumati¦ppaa	V	–nngilaa
eqquma¦vaa	V	–nngilaa
eqquma¦voq	V	–nngilaq
eqqumeequt	N	–ip, –it
eqqumiig¦aa	V	–inngilaa
eqqumiikajaa¦rpoq	V	–nngilaq
eqqumiikujuinnarpoq	V	(no generation)
eqqumiikujuppoq	V	(no generation)
eqqumiilli¦orpoq	V	–unngilaq
eqqumi¦illiorpoq	V	{–illiunngilaq, –nngaanniilliunngilaq}, –illiunngilaq
eqqumiilualla¦ppoq	V	–nngilaq
eqqumiippallaassaqaaq	V	(no generation)
eqqumii¦ppoq	V	–nngilaq
eqqumiits¦oq	N	–up, –ut
eqqumiitsukuju¦k	N	–up, –it
eqqumiitsulia¦q	N	–p, –t
eqqumiitsuliorne¦q	N	–rup, –rit
eqqumiitsuliortart¦oq	N	–up, –ut
eqqumiitsuliort¦oq	N	–up, –ut
eqqummari¦ppoq	V	–nngilaq
eqqunngilluinnart¦oq	N	–up, –ut
eqqunngits¦oq	N	–up, –ut
eqqunngitsulia¦q	N	–p, –t
eqqunngitsuliorfigisa¦q	N	–p, –t
eqqunngivi¦ppoq	V	–nngilaq
eqqu¦ppaa	V	–tinngilaa
eqqusa¦q	N	–p, –t
eqqussaa¦voq	V	–nngilaq
eqqusseqqusiunnaarne¦q	N	–rup, –rit
eqqussine¦q	N	–rup, –rit
eqqussi¦voq	V	–nngilaq
eqqussuine¦q	N	–rup, –rit
eqqussui¦voq	V	–nngilaq
eqquukkiart¦orpoq	V	–unngilaq
eqquu¦ppaa	V	–tinngilaa
eqquu¦ppoq	V	–tinngilaq
eqquussimaarpoq	V	(no generation)
eqquussima¦vaa	V	–nngilaa
eqquutinneqanngits¦oq	N	–up, –ut
eqquut¦inneqanngitsoq	N	{–inneqanngitsup, –sinneqanngitsup, –itinneqanngitsup}, {–inneqanngitsut, –sinneqanngitsut, –itinneqanngitsut}
eqquutinngits¦oq	N	–up, –ut
eqquut¦inngitsoq	N	{–inngitsup, –sinngitsup}, {–inngitsut, –sinngitsut}
eqquuti¦ppaa	V	–nngilaa
eqquut¦ippaa	V	{–inngilaa, –sinngilaa, –itinngilaa}
eqquut¦itippaa	V	{–itsinngilaa, –sitsinngilaa, –itinngilaa, –sinngilaa}
eqquutitsine¦q	N	–rup, –rit
eqquut¦itsineq	N	{–itsinerup, –sitsinerup}, {–itsinerit, –sitsinerit}
equngaalu¦k	N	–up, –it
equngaa¦rpoq	V	–nngilaq
equnga¦voq	V	–nngilaq
equsaarne¦q	N	–rup, –rit
equsaa¦rpoq	V	–nngilaq
equsaarti¦ppaa	V	–nngilaa
equsaava¦q	N	–p, –t
equs¦oorpoq	V	–uunngilaq
equti¦ppaa	V	–nngilaa
equtitsine¦q	N	–rup, –rit
equummi¦voq	V	–nngilaq
equut	N	–ip, –it
equutig¦aa	V	–inngilaa
equutissa¦q	N	–p, –t
equutissia¦q	N	–p, –t
equutit	N, pl.	-
equ¦voq	V	–nngilaq
erfaa¦ppoq	V	–tinngilaq
erfagiu¦ppaa	V	–tinngilaa
erfagiussaa¦voq	V	–nngilaq
erfalaa¦rpoq	V	–nngilaq
erfalas¦oq	N	–up, –ut
erfalasua¦raq	N	–qqap, –qqat
erfalasulerfi¦k	N	–up, –it
erfalasul¦erpoq	V	–inngilaq
erfalasulisart¦oq	N	–up, –ut
erfalasussia¦q	N	–p, –t
erfala¦voq	V	–nngilaq
erfali¦voq	V	–nngilaq
erfa¦q	N	–p, –t
erfa¦rpoq	V	–nngilaq
erfi¦voq	V	–nngilaq
eriag¦aa	V	–inngilaa
eriaginarnerulerne¦q	N	–rup, –rit
eriaginart¦oq	N	–up, –ut
eriaginartuu¦voq	V	–nngilaq
eriagisa¦q	N	–p, –t
eria¦narpoq	V	{–ginanngilaq, –nanngilaq}
eria¦q	N	–p, –t
erinagi¦ppoq	V	–nngilaq
erinalersuutig¦aa	V	–inngilaa
erinaler¦suutigaa	V	{–suutiginngilaa, –tuutiginngilaa}
erinal¦ik	N	{–iup, –lip, –lup}, –lit
erinall¦erpoq	V	–inngilaq
erin¦aq	N	–nap, –nat
erinaqanngits¦oq	N	–up, –ut
erinaqa¦rpoq	V	–nngilaq
erinaqassu¦seq	N	–tsip, –tsit
erinarlu¦ppoq	V	–nngilaq
erinar¦soqataavoq	V	{–soqataanngilaq, –toqataanngilaq}
erinar¦soqatigiit	N, pl.	{–soqatigiit, –toqatigiit}
erinarsoqattaarne¦q	N	–rup, –rit
erinar¦soqattaarneq	N	{–soqattaarnerup, –toqattaarnerup}, {–soqattaarnerit, –toqattaarnerit}
erinarsoqattaarut	N	–ip, –it
erinar¦sorfigaa	V	{–sorfiginngilaa, –torfiginngilaa}
erinar¦sorneq	N	{–sornerup, –tornerup}, {–sornerit, –tornerit}
erinar¦sorpoq	V	{–sunngilaq, –tunngilaq}
erinar¦sortartoq	N	{–sortartup, –tortartup}, {–sortartut, –tortartut}
erinar¦sortartoqatigiit	N, pl.	{–sortartoqatigiit, –tortartoqatigiit}
erinar¦sortitsisoq	N	{–sortitsisup, –tortitsisup}, {–sortitsisut, –tortitsisut}
erinarsuut	N	–ip, –it
erinarsuutig¦aa	V	–inngilaa
erinarsuutit	N, pl.	-
erineersaa¦rpoq	V	–nngilaq
erineersaarutig¦aa	V	–inngilaa
erinig¦aa	V	–inngilaa
erinigeqaa	V	(no generation)
erinigingaa¦rpaa	V	–nngilaa
eriniikkusers¦orpaa	V	–unngilaa
erinikku¦ppaa	V	–tinngilaa
erinikkussi¦voq	V	–nngilaq
erininanngitsukkut	N, pl.	-
erinina¦rpoq	V	–nngilaq
erininarsinngits¦oq	N	–up, –ut
erininart¦oq	N	–up, –ut
erinine¦q	N	–rup, –rit
erinisorujuu¦voq	V	–nngilaq
erinisu¦ppoq	V	–nngilaq
erinitsaa¦ppaa	V	–tinngilaa
erinitsaarlu¦erpoq	V	–inngilaq
erinitsajuingaarne¦q	N	–rup, –rit
erinitsajui¦ppoq	V	–nngilaq
erinitsajuissu¦seq	N	–tsip, –tsit
erinitsa¦juissuseq	N	{–juissutsip, –ttuissutsip}, {–juissutsit, –ttuissutsit}
erinitsa¦ppoq	V	–nngilaq
eriniusaa¦rpoq	V	–nngilaq
erini¦voq	V	–nngilaq
erinn¦erpoq	V	–inngilaq
erinnersaallaqqi¦ppoq	V	–nngilaq
erinnersaarne¦q	N	–rup, –rit
erinner¦saarneq	N	{–saarnerup, –taarnerup}, {–saarnerit, –taarnerit}
erinnersaa¦rpoq	V	–nngilaq
erinnersaarut	N	–ip, –it
erinnersaarutig¦aa	V	–inngilaa
erinnia¦q	N	–p, –t
erinniarsu¦aq	N	–up, –it
erinni¦orpaa	V	–unngilaa
erinni¦orpoq	V	–unngilaq
erinniortart¦oq	N	–up, –ut
erinniort¦oq	N	–up, –ut
erinniortut	N, pl.	-
erinniu¦gaq	N	–kkap, –kkat
erinniugassia¦q	N	–p, –t
eri¦ppaa	V	–nngilaa
eri¦ppoq	V	–nngilaq
erisaal¦ik	N	{–iup, –lip, –lup}, –lit
erisaamine¦q	N	–rup, –rit
erisaam¦ineq	N	–ernup, –ernit
erisaa¦q	N	–p, –t
erisaartaa¦rpoq	V	–nngilaq
erisaat	N, pl.	-
erisa¦gaq	N	–kkap, –kkat
erisarne¦q	N	–rup, –rit
erisa¦rpaa	V	–nngilaa
erisa¦rpoq	V	–nngilaq
erisassi¦vaa	V	–nngilaa
erisassi¦voq	V	–nngilaq
erissaa¦q	N	–p, –t
erissa¦aq	V	–nngilaq
erissaa¦rpoq	V	–nngilaq
erita¦q	N	–p, –t
eritsaats¦oq	N	–up, –ut
eritsakut	N, pl.	-
eritsa¦q	N	–p, –t
eritsari¦ppoq	V	–nngilaq
eritsas¦erpoq	V	–inngilaq
erits¦erpaa	V	–inngilaa
eritsia¦q	N	–p, –t
erivillua¦rpoq	V	–nngilaq
erivi¦ppoq	V	–nngilaq
erivissii¦vaa	V	–nngilaa
erlaa¦rpaa	V	–nngilaa
erlaa¦rpoq	V	–nngilaq
erlaarsi¦voq	V	–nngilaq
erla¦ppoq	V	–nngilaq
erla¦q	N	–p, –t
erlav¦eerpaa	V	–iinngilaa
erlaveersini¦ooq	N	–uup, –uut
erlaviit	N, pl.	-
erlavi¦k	N	–up, –it
erlavimmiu	N	–p, –t
erlaviss¦orpaa	V	–unngilaa
erlaviss¦orpoq	V	–unngilaq
erle¦q	N	–rup, –rit
erler¦aa	V	–inngilaa
erlerna¦rpoq	V	–nngilaq
erl¦erpaa	V	–inngilaa
erliataa¦rpoq	V	–nngilaq
erlig¦aa	V	–inngilaa
erligisa¦q	N	–p, –t
erliguu¦ppaa	V	–tinngilaa
erliguussa¦q	N	–p, –t
erliguussi¦voq	V	–nngilaq
erlikk¦eerpoq	V	–iinngilaq
erlinnangaart¦oq	N	–up, –ut
erlinna¦rpoq	V	–nngilaq
erlinnart¦oq	N	–up, –ut
erlinnartorsi¦orpoq	V	–unngilaq
erlinnartulia¦q	N	–p, –t
erlinnartut	N, pl.	-
erlinnartuut	N	–ip, –it
erlippaa¦raq	N	–qqap, –qqat
erlippa¦k	N	–ap, –at
erlippani¦ppoq	V	–nngilaq
erli¦ppoq	V	–nngilaq
erlit¦ooq	N	–uup, –uut
erlitt¦ooq	N	–uup, –uut
erlitune¦q	N	–rup, –rit
erl¦oq	N	–up, –ut
erloqina¦rpoq	V	–nngilaq
erloqinart¦oq	N	–up, –ut
erloqinartorsi¦orpoq	V	–unngilaq
erloqine¦q	N	–rup, –rit
erloqisinneqart¦oq	N	–up, –ut
erloqisi¦ppaa	V	–nngilaa
erloqisitsine¦q	N	–rup, –rit
erloqisitsis¦oq	N	–up, –ut
erloqisitsi¦voq	V	–nngilaq
erloqis¦oq	N	–up, –ut
erloqissut	N	–ip, –it
erloqissutig¦aa	V	–inngilaa
erloqi¦voq	V	–nngilaq
erloqqunna¦rpoq	V	–nngilaq
erloqqu¦ppaa	V	–tinngilaa
erloqqussine¦q	N	–rup, –rit
erloqqussi¦voq	V	–nngilaq
erloqqutig¦aa	V	–inngilaa
erlu¦k	N	–up, –it
erlunnguummina¦rpoq	V	–nngilaq
erlunnguummisaa¦rpoq	V	–nngilaq
erlunnguummi¦voq	V	–nngilaq
ermali¦saq	N	–tsap, –tsat
ermalitserpoq	V	(no generation)
ermia¦q	N	–p, –t
ermiaqqaanni¦voq	V	–nngilaq
ermiffi¦k	N	–up, –it
ermi¦k	N	–up, –it
ermikkiartoqqaarallarpoq	V	(no generation)
ermikkiartoqqaarpoq	V	(no generation)
ermikkiartoqqaarumagaluarpoq	V	(no generation)
ermikkiartoqqaarumavoq	V	(no generation)
ermikkiartoqqinniarpoq	V	(no generation)
ermikkiartoqqissimagaluarpoq	V	(no generation)
ermikkiartoqqissimavoq	V	(no generation)
ermikkiartoqqu¦aa	V	–nngilaa
ermikkiartorsimagaluarpoq	V	(no generation)
ermikkiartorsimavoq	V	(no generation)
ermikkiartorsinnaassavaa	V	(no generation)
ermi¦orpoq	V	–unngilaq
ermi¦ppaa	V	–nngilaa
ermi¦ppoq	V	–nngilaq
ermiu¦gaq	N	–kkap, –kkat
ermiut	N	–ip, –it
ermu¦seq	N	–tsip, –tsit
ermusiusa¦q	N	–p, –t
ermutig¦aa	V	–inngilaa
ernaa¦q	N	–p, –t
ernaaserfi¦k	N	–up, –it
ernaat	N, pl.	-
ernaataasa¦q	N	–p, –t
ernannaaru¦ppoq	V	–tinngilaq
ernanna¦q	N	–p, –t
ernannartaa¦rpoq	V	–nngilaq
ernarpalu¦ppoq	V	–nngilaq
erna¦rpoq	V	–nngilaq
erne¦q	N	–rup, –rit
erner¦aa	V	–inngilaa
erneriit	N, pl.	-
ernerlaa¦q	N	–p, –t
ern¦erpoq	V	–inngilaq
ernersia¦q	N	–p, –t
ernertaa¦ppaa	V	–tinngilaa
ernertaar¦aa	V	–inngilaa
ernertaa¦rpoq	V	–nngilaq
ernertu¦voq	V	–nngilaq
erngaaserfi¦k	N	–up, –it
erngaasivi¦k	N	–up, –it
erngaataasa¦q	N	–p, –t
erngali¦saq	N	–tsap, –tsat
erngarpalu¦ppoq	V	–nngilaq
ernga¦rpoq	V	–nngilaq
erngasu¦ppoq	V	–nngilaq
erngiinnannguaq	Interj	(no generation)
erngiinnaq	Interj	(no generation)
erngumag¦aa	V	–inngilaa
erngumassutig¦aa	V	–inngilaa
ernguma¦voq	V	–nngilaq
erngumma¦ppaa	V	–tinngilaa
erngummassi¦voq	V	–nngilaq
ern¦gummassivoq	V	{–gummassinngilaq, –umassussinngilaq, –ummassinngilaq}
erngu¦seq	N	–tsip, –tsit
erngusiusa¦q	N	–p, –t
erngut¦aq	N	{–ap, –tap}, {–at, –tat}
erngutaqqiut	N	–ip, –it
erngutartaa¦rpoq	V	–nngilaq
ernialersuine¦q	N	–rup, –rit
ernialiine¦q	N	–rup, –rit
ernia¦q	N	–p, –t
erniar¦aa	V	–inngilaa
erniaritita¦q	N	–p, –t
erniat	N, pl.	-
erniffiussangatita¦q	N	–p, –t
ernigalua¦rpoq	V	–nngilaq
erniinnakanne¦q	N	–rup, –rit
erniinnakann¦eq	N	–ip, –it
erniinnanngu¦aq	N	–up, –it
erniinna¦q	N	–p, –t
ern¦iinnaq	N	{–erinnaap, –iinnaap}, {–erinnaat, –iinnaat}
erniinnarluinna¦q	N	–ap, –at
ernik¦oq	N	–up, –ut
ernine¦q	N	–rup, –rit
erninerlu¦ppoq	V	–nngilaq
ernioqqinne¦q	N	–rup, –rit
ernioqqi¦ppoq	V	–nngilaq
erniorlaa¦q	N	–p, –t
erni¦orpoq	V	–unngilaq
ernisarfi¦k	N	–up, –it
ernis¦oq	N	–up, –ut
ernissa¦q	N	–p, –t
ernisui¦ppoq	V	–nngilaq
ernisuissu¦seq	N	–tsip, –tsit
ernisuits¦oq	N	–up, –ut
ernisu¦ppoq	V	–nngilaq
ernisussiornilerine¦q	N	–rup, –rit
ernisuss¦iornilerineq	N	{–aliornilerinerup, –iornilerinerup}, {–aliornilerinerit, –iornilerinerit}
ernisussi¦orpoq	V	–unngilaq
ernisuss¦iorpoq	V	{–aliunngilaq, –iunngilaq}
ernisussiort¦oq	N	–up, –ut
ernisuss¦iortoq	N	{–aliortup, –iortup}, {–aliortut, –iortut}
ernitsorlu¦ppoq	V	–nngilaq
ernitua¦q	N	–p, –t
erniu¦voq	V	–nngilaq
erni¦voq	V	–nngilaq
ernumag¦aa	V	–inngilaa
ernumajunnaar¦saat	N	{–saatip, –taatip}, {–saatit, –taatit}
ernumakatalluinnalerpoq	V	(no generation)
ernumakatattaraluaqaaq	V	(no generation)
ernumakatatta¦rpoq	V	–nngilaq
ernumakatavippoq	V	(no generation)
ernumananngits¦oq	N	–up, –ut
ernumanaqaaq	V	(no generation)
ernumana¦rpoq	V	–nngilaq
ernumane¦q	N	–rup, –rit
ernumas¦oq	N	–up, –ut
ernumassutig¦aa	V	–inngilaa
ern¦umassutigaa	V	{–umassutiginngilaa, –gummatiginngilaa, –ummatiginngilaa}
ernumatsaa¦ppaa	V	–tinngilaa
ernumatsa¦ppoq	V	–nngilaq
ernumavallaarunnaarpoq	V	(no generation)
ernuma¦voq	V	–nngilaq
ernumma¦ppaa	V	–nngilaa
ern¦ummassivoq	V	{–gummassinngilaq, –umassussinngilaq, –ummassinngilaq}
ern¦ummatigaa	V	{–gummatiginngilaa, –umassutiginngilaa, –ummatiginngilaa}
ernut¦aq	N	{–ap, –tap}, {–at, –tat}
ernutaqqiut	N	–ip, –it
ernutartaa¦rpoq	V	–nngilaq
erroraluarsinnaavaa	V	(no generation)
err¦orpaa	V	–unngilaa
errorsa¦rpoq	V	–nngilaq
err¦orsineq	N	{–orsinerup, –uinerup}, {–orsinerit, –uinerit}
errorsisarfi¦k	N	–up, –it
err¦orsisarfik	N	{–orsisarfiup, –uisarfiup}, {–orsisarfiit, –uisarfiit}
errorsisart¦oq	N	–up, –ut
err¦orsisartoq	N	{–orsisartup, –uisartup}, {–orsisartut, –uisartut}
errorsissu¦ppaa	V	–tinngilaa
errorsissut	N	–ip, –it
err¦orsissut	N	{–orsissutip, –uissutip}, {–orsissutit, –uissutit}
err¦orsivoq	V	{–orsinngilaq, –uinngilaq}
errorta¦q	N	–p, –t
errortassa¦q	N	–p, –t
errortassat	N, pl.	-
errortat	N, pl.	-
errortorfi¦k	N	–up, –it
errortori¦aq	N	–ssap, –ssat
errortorne¦q	N	–rup, –rit
errort¦orpaa	V	–unngilaa
errort¦orpoq	V	–unngilaq
errortortarfi¦k	N	–up, –it
errortuine¦q	N	–rup, –rit
errortuut	N	–ip, –it
errortuutik¦oq	N	–up, –ut
erru¦gaq	N	–kkap, –kkat
errugassa¦q	N	–p, –t
err¦uineq	N	{–orsinerup, –uinerup}, {–orsinerit, –uinerit}
erruissut	N	–ip, –it
err¦uissut	N	{–orsissutip, –uissutip, –uissut, –uittut}, {–orsissutit, –uissutit}
err¦uivik	N	{–orsiffiup, –uiffiup, –uiviup}, {–orsiffiit, –uiffiit, –uiviit}
err¦uivoq	V	{–orsinngilaq, –uinngilaq}
erru¦ppaa	V	–tinngilaa
erruus¦erpoq	V	–inngilaq
ersaanne¦q	N	–rup, –rit
ersaa¦ppoq	V	–nngilaq
ersaa¦rpaa	V	–nngilaa
ersaa¦rpoq	V	–nngilaq
ersaartaassine¦q	N	–rup, –rit
ersaartarne¦q	N	–rup, –rit
ersaarta¦rpoq	V	–nngilaq
ersakkoort¦oq	N	–up, –ut
ersali¦ppoq	V	–nngilaq
ersanga¦voq	V	–nngilaq
ersanne¦q	N	–rup, –rit
ersa¦ppoq	V	–nngilaq
ersa¦q	N	–p, –t
ersaqut	N	–ip, –it
ersaqutit	N, pl.	-
ersarilluinnart¦oq	N	–up, –ut
ersarillu¦innartoq	N	{–aannartup, –innartup}, {–aannartut, –innartut}
ersarinngits¦oq	N	–up, –ut
ersari¦ppoq	V	–nngilaq
ersarissa¦rpaa	V	–nngilaa
ersari¦ssoq	N	{–ssup, –ttup}, {–ssut, –ttut}
ersarissu¦seq	N	–tsip, –tsit
ersarmi¦ppaa	V	–nngilaa
ersa¦roq	N	–qqup, –qqut
ersaroqut	N	–ip, –it
ersarunngu¦voq	V	–nngilaq
ersaru¦serpaa	V	{–sinngilaa, –tilinngilaa}
ersarut	N	–ip, –it
ersarut¦serpaa	V	{–italinngilaa, –sinngilaa}
erseqqaari¦ppoq	V	–nngilaq
erseqqaari¦ssoq	N	{–ssup, –ttup}, {–ssut, –ttut}
erseqqarilluinnart¦oq	N	–up, –ut
erseqqari¦ppoq	V	–nngilaq
erseqqarissaane¦q	N	–rup, –rit
erseqqari¦ssoq	N	{–ssup, –ttup}, {–ssut, –ttut}
erseqqarissu¦seq	N	–tsip, –tsit
erseqqarivinngits¦oq	N	–up, –ut
erseqqarlutt¦oq	N	–up, –ut
erseqqilluanngits¦oq	N	–up, –ut
erseqqilluart¦oq	N	–up, –ut
erseqqinnerus¦oq	N	–up, –ut
erseqqinngilaq	V	(no generation)
erseqqinngits¦oq	N	–up, –ut
erseqqi¦ppoq	V	–nngilaq
erseqqissaane¦q	N	–rup, –rit
erseqqissaasinnaane¦q	N	–rup, –rit
erseqqissaat	N	–ip, –it
erseqqi¦ssaat	N	{–ssaatip, –ttaatip}, {–ssaatit, –ttaatit}
erseqqissaatig¦aa	V	–inngilaa
erseqqi¦ssaatigaa	V	{–ssaatiginngilaa, –ttaatiginngilaa}
erseqqissaa¦voq	V	–nngilaq
erseqqissa¦rpaa	V	–nngilaa
erseqqissisaat	N	–ip, –it
erseqqissisinneqart¦oq	N	–up, –ut
erseqqi¦ssoq	N	{–ssup, –ttup}, {–ssut, –ttut}
erseqqi¦ssuliorfigaa	V	{–ssuliorfiginngilaa, –ttuliorfiginngilaa}
erseqqissu¦seq	N	–tsip, –tsit
erserne¦q	N	–rup, –rit
ersernerlu¦ppoq	V	–nngilaq
ersernerlutt¦oq	N	–up, –ut
ers¦erpaa	V	–inngilaa
ers¦erpoq	V	–inngilaq
erser¦saat	N	{–saatip, –taatip}, {–saatit, –taatit}
ersersa¦rpaa	V	–nngilaa
ersersinneqa¦rpoq	V	–nngilaq
ersersi¦ppaa	V	–nngilaa
ersersitsine¦q	N	–rup, –rit
ersersitsi¦voq	V	–nngilaq
ersias¦oq	N	–up, –ut
ersia¦voq	V	–nngilaq
ersig¦aa	V	–inngilaa
ersigisaqarne¦q	N	–rup, –rit
ersigiummerpaa	V	(no generation)
ersigunnaarpoq	V	(no generation)
ersiinnart¦oq	N	–up, –ut
ersi¦k	N	{–ngup, –up}, {–it, –ngit}
ersikkaluanngilaq	V	(no generation)
ersikkunnaarniarpoq	V	(no generation)
ersikkunnaa¦rpoq	V	–nngilaq
ersikujukkaluarpoq	V	(no generation)
ersikujukkunarpoq	V	(no generation)
ersinaqaaq	V	(no generation)
ersina¦rpoq	V	–nngilaq
ersinart¦oq	N	–up, –ut
ersinartulersaarutit	N, pl.	-
ersine¦q	N	–rup, –rit
ersinneeru¦ppoq	V	–tinngilaq
ersinngilaq	V	(no generation)
ersinngits¦oq	N	–up, –ut
ersiorne¦q	N	–rup, –rit
ersi¦orpoq	V	–unngilaq
ersipajaaraluarpoq	V	(no generation)
ersipajaarpoq	V	(no generation)
ersipajaarunarpoq	V	(no generation)
ersi¦ppoq	V	–nngilaq
ersisaa¦rpaa	V	–nngilaa
ersisaarut	N	–ip, –it
ersis¦oq	N	–up, –ut
ersissut	N	–ip, –it
ersi¦ssut	N, pl.	{–ssut, –ttut}
ersisui¦ppoq	V	–nngilaq
ersit¦ooq	N	–uup, –uut
ersitsaa¦ppaa	V	–tinngilaa
ersitsa¦ppoq	V	–nngilaq
ersi¦tsoq	N	{–ssup, –tsup, –ttup}, {–ssut, –tsut, –ttut}
ersi¦ttoq	N	{–ssup, –ttup}, {–ssut, –ttut}
ersiumm¦erpoq	V	–inngilaq
ersiummisaarpoq	V	(no generation)
ersiu¦ppaa	V	–tinngilaa
ersiut	N	–ip, –it
ersiutaalluart¦oq	N	–up, –ut
ersiutaas¦oq	N	–up, –ut
ersiutaats¦oq	N	–up, –ut
ersiutileria¦q	N	–p, –t
ersi¦voq	V	–nngilaq
ers¦orpaa	V	–unngilaa
ers¦orpoq	V	–unngilaq
ersorsisissa¦q	N	–p, –t
ersorsis¦oq	N	–up, –ut
ersorsi¦t	N	–sip, –sit
ersorsi¦voq	V	–nngilaq
ersorta¦q	N	–p, –t
ersu¦gaq	N	–kkap, –kkat
ersukk¦erpoq	V	–inngilaq
ersukkers¦orpoq	V	–unngilaq
ersukkiu¦ppaa	V	–tinngilaa
ersu¦ppaa	V	{–nngilaa, –tinngilaa}
ersu¦ppoq	V	–nngilaq
ersu¦ssivoq	V	{–ssinngilaq, –tsinngilaq}
ersuttaat	N	–ip, –it
ersuusi¦orpoq	V	–unngilaq
ersuu¦siorpoq	V	{–siunngilaq, –tiliunngilaq}
ersuut	N	–ip, –it
ersuutit	N, pl.	-
erui¦ppoq	V	–nngilaq
eruisa¦rpaa	V	–nngilaa
erullu¦ppoq	V	–nngilaq
erussaa¦rpoq	V	–nngilaq
eruss¦erpaa	V	–inngilaa
e¦skimooq	N	{–ksimuup, –skimuup}, {–ksimuut, –skimuut}
Etiopiam¦eersoq	N	{–eersup, –eertup, –inngaanneersup, –inngaanneertup, –inngaanninngaanneersup, –inngaanninngaanneertup}, {–eersut, –eertut, –inngaanneersut, –inngaanneertut, –inngaanninngaanneersut, –inngaanninngaanneertut}
Etiopiam¦eersoq	N	{–eersup, –eertup, –inngaanneersup, –inngaanneertup}, {–eersut, –eertut, –inngaanneersut, –inngaanneertut}
Etiopiamioq	N	(no generation)
Etiopiamiu	N	–p, –t
Etiopia¦miu	N	{–miup, –rmiup}, {–miut, –rmiut}
EU	Prop	–ip
Europa¦miu	N	{–miup, –rmiup}, {–miut, –rmiut}
