Lexeme	WC	Flexion
uaa	Interj	(no generation)
uaagaju¦ppoq	V	–nngilaq
uaajeerne¦q	N	–rup, –rit
uaajeert¦oq	N	–up, –ut
uaal¦oorpoq	V	–uunngilaq
uaaloortaanna¦rpoq	V	–nngilaq
uaalu	Interj	(no generation)
uaalu¦ppoq	V	–nngilaq
uaane¦q	N	–rup, –rit
uaaqisaa¦rpoq	V	–nngilaq
uaa¦rpoq	V	–nngilaq
uaartorpalaa¦q	N	–p, –t
uaartorpaluk	N	–up, –it
uaartorpalu¦k	N	–up, –it
uaart¦orpoq	V	–unngilaq
uaarusaa¦rpoq	V	–nngilaq
uaas¦oq	N	–up, –ut
uaati¦ppaa	V	–nngilaa
uaa¦voq	V	–nngilaq
uaggi¦ppaa	V	–nngilaa
ua¦gutsinniippoq	V	{–gutsinniinngilaq, –tsinniinngilaq}
ual¦eq	N	–ip, –it
ualersu¦aq	N	–up, –it
ualiarsaa¦q	N	–p, –t
ualiart¦oq	N	–up, –ut
ualikkut	N, pl.	-
ualilluinnart¦oq	N	–up, –ut
Ualine¦q	N	–rup, –rit
ualis¦oq	N	–up, –ut
ualissu¦ppaa	V	–tinngilaa
ualivallaa¦rpoq	V	–nngilaq
uali¦voq	V	–nngilaq
ualli¦ppaa	V	–nngilaa
uallu¦ppaa	V	–tinngilaa
uaneralaanngu¦aq	N	–up, –it
uaneralanngu¦aq	N	–up, –it
uangaanna¦q	N	–ap, –at
uangaanngits¦oq	N	–up, –ut
uangaanngits¦oq	N	–ut
uangaart¦orpoq	V	–unngilaq
uangapalaa¦q	N	–p, –t
uanii¦ppoq	V	–nngilaq
uaniissinnaanngilaq	V	(no generation)
uaniiti¦ppaa	V	–nngilaa
uanii¦tippaa	V	{–sinngilaa, –tinngilaa, –tsinngilaa}
uanits¦oq	N	–up, –ut
uanitsorsunni	N	–p, –t
uanitsua¦raq	N	–qqap, –qqat
uanneqa¦rpoq	V	–nngilaq
uannii¦ppoq	V	–nngilaq
uannii¦tippaa	V	{–sinngilaa, –tinngilaa, –tsinngilaa}
uanniittuarpoq	V	(no generation)
ua¦ppaa	V	–nngilaa
uarta¦q	N	–p, –t
uatseerajuppoq	V	(no generation)
uats¦eerpaa	V	–iinngilaa
uats¦eerpoq	V	–iinngilaq
uatseertaanna¦rpoq	V	–nngilaq
uatsi	Interj	(no generation)
uatsia¦q	N	–ap, –at
uatsilaaq	Interj	(no generation)
uatsinniikkajuppoq	V	(no generation)
uatsinniikkumatoqaaq	V	(no generation)
ua¦tsinniippoq	V	{–gutsinniinngilaq, –tsinniinngilaq}
ua¦tsinnukarpoq	V	{–gutsinnukanngilaq, –tsinnukanngilaq}
ua¦tsinnukartippaa	V	{–gutsinnukartinngilaa, –tsinnukartinngilaa}
uatsi¦voq	V	–nngilaq
uattut	N, pl.	-
uavaa¦rpoq	V	–nngilaq
uavaartorsu¦uvoq	V	{–aanngilaq, –unngilaq}
uavaarutig¦aa	V	–inngilaa
uavi¦ppoq	V	–nngilaq
uavisa¦rpoq	V	–nngilaq
ueqanngilaq	V	(no generation)
ueqarne¦q	N	–rup, –rit
ueqa¦rpoq	V	–nngilaq
ueqattaa¦rpoq	V	–nngilaq
ueqqivig¦aa	V	–inngilaa
ueqqivigivi¦ppaa	V	–nngilaa
ueqqu¦ppaa	V	–tinngilaa
ueqqussa¦q	N	–p, –t
ueqqussi¦voq	V	–nngilaq
uer¦aaq	V	–inngilaq
ueriffig¦aa	V	–inngilaa
uerigaluanngilaq	V	(no generation)
uerinartut	N, pl.	-
uerine¦q	N	–rup, –rit
uerisaa¦voq	V	–nngilaq
uerisimane¦q	N	–rup, –rit
ueris¦imaneq	N	{–imanerup, –simanerup}, {–imanerit, –simanerit}
uerisitaa¦voq	V	–nngilaq
uerisita¦q	N	–p, –t
uerisoorne¦q	N	–rup, –rit
ueris¦oorpoq	V	–uunngilaq
uerissu¦seq	N	–tsip, –tsit
uerissutig¦aa	V	–inngilaa
ueriti¦ppaa	V	–nngilaa
ueritsaa¦ppaa	V	–tinngilaa
ueritsaasi¦orpaa	V	–unngilaa
ueritsaffig¦aa	V	–inngilaa
ueritsanne¦q	N	–rup, –rit
ueritsa¦ppoq	V	–nngilaq
uerivi¦ppoq	V	–nngilaq
ueri¦voq	V	–nngilaq
uernaasa¦rpoq	V	–nngilaq
uernajaa¦rpoq	V	–nngilaq
uernakujuinna¦rpoq	V	–nngilaq
uernakujulaa¦rpoq	V	–nngilaq
uernakuju¦ppoq	V	–nngilaq
uernalernart¦oq	N	–up, –ut
uernarna¦rpoq	V	–nngilaq
uernarne¦q	N	–rup, –rit
uernarpallaaginna¦rpoq	V	–nngilaq
uernarpallaal¦erpoq	V	–inngilaq
uernarpallaalerumaarpoq	V	(no generation)
uernarpallaalinngilaq	V	(no generation)
uernarpallaanngikkunarpoq	V	(no generation)
uernarpallaaqaaq	V	(no generation)
uernarpallaaraluarpoq	V	(no generation)
uernarpallaarpasi¦ppoq	V	–nngilaq
uernarpallaa¦rpoq	V	–nngilaq
uernarpallaarunanngilaq	V	(no generation)
uernarpallaaruna¦rpoq	V	–nngilaq
uerna¦rpoq	V	–nngilaq
uernassaaru¦ppoq	V	–tinngilaq
uernassaqanngilaq	V	(no generation)
uerngaasa¦rpoq	V	–nngilaq
uerngajaa¦rpoq	V	–nngilaq
uernga¦rpoq	V	–nngilaq
uerngassaaru¦ppoq	V	–tinngilaq
uerpallaaqaaq	V	(no generation)
u¦erpoq	V	–inngilaq
uersaaffig¦aa	V	–inngilaa
uersaanni¦ppoq	V	–nngilaq
uersaa¦vaa	V	–nngilaa
uersaavig¦aa	V	–inngilaa
uersaa¦vigaa	V	{–ffiginngilaa, –viginngilaa}
uersaa¦voq	V	–nngilaq
uersagaa¦voq	V	–nngilaq
uersa¦gaq	N	–kkap, –kkat
uersagarsu¦aq	N	–up, –it
uersarne¦q	N	–rup, –rit
uersa¦rpoq	V	–nngilaq
uerti¦ppaa	V	–nngilaa
uert¦oorpoq	V	–uunngilaq
ueruala¦voq	V	–nngilaq
ueruatornaqaaq	V	(no generation)
ueruat¦orpoq	V	–unngilaq
ueruatortaanna¦rpoq	V	–nngilaq
uerujussua¦rpoq	V	–nngilaq
uerujussuarsima¦voq	V	–nngilaq
uerul¦oorpoq	V	–uunngilaq
ueruloorti¦ppaa	V	–nngilaa
uerulu¦ppoq	V	–nngilaq
uffa	Interj	(no generation)
uffaat	N	–ip, –it
uffaataasinnaa¦voq	V	–nngilaq
uffaataa¦voq	V	–nngilaq
uffagaa¦voq	V	–nngilaq
uffa¦gaq	N	–kkap, –kkat
uffagassa¦q	N	–p, –t
uffarfi¦k	N	–up, –it
uffarne¦q	N	–rup, –rit
uffa¦rpaa	V	–nngilaa
uffa¦rpoq	V	–nngilaq
uffarsima¦voq	V	–nngilaq
uffartaanna¦rpoq	V	–nngilaq
uffartarfi¦k	N	–up, –it
ugg	Interj	(no generation)
ugga	Interj	(no generation)
uggor¦aa	V	–inngilaa
uggornaqaaq	V	(no generation)
uggornaralua¦rpoq	V	–nngilaq
uggornaraluart¦oq	N	–up, –ut
uggorna¦rpoq	V	–nngilaq
uggornart¦oq	N	–up, –ut
uggorsaa¦rpaa	V	–nngilaa
uggorsaatig¦aa	V	–inngilaa
uggorsarne¦q	N	–rup, –rit
uggorsa¦rpoq	V	–nngilaq
ugguar¦aa	V	–inngilaa
ugguaraluaqaaq	V	(no generation)
ugguarnaqaaq	V	(no generation)
ugguarne¦q	N	–rup, –rit
ugguarnertu¦voq	V	–nngilaq
ugguarpallaa¦rpoq	V	–nngilaq
uggua¦rpoq	V	–nngilaq
ugguart¦oq	N	–up, –ut
ugguunaqqu¦ppaa	V	–tinngilaa
ugguunaqqu¦ppoq	V	–tinngilaq
ugguut	N	–ip, –it
ugguutaa¦voq	V	–nngilaq
ugguutig¦aa	V	–inngilaa
ugguutissaanngilaq	V	(no generation)
ui	N	–p, –t
uiaakkiart¦orpaa	V	–unngilaa
uiaania¦q	N	–p, –t
uiaa¦ppaa	V	–tinngilaa
uiaassi¦voq	V	–nngilaq
uiaassui¦voq	V	–nngilaq
uial¦ik	N	{–iup, –lip, –lup}, –lit
uiallaatig¦aa	V	–inngilaa
uiannisaa¦rpoq	V	–nngilaq
uiannisaarutig¦aa	V	–inngilaa
uia¦q	N	–p, –t
uiari¦aq	N	–ssap, –ssat
uiarne¦q	N	–rup, –rit
uia¦rpaa	V	–nngilaa
uia¦rpoq	V	–nngilaq
uiarsaa¦rpaa	V	–nngilaa
uiarsaa¦rpoq	V	–nngilaq
uiart¦erpaa	V	–inngilaa
uiartorneqa¦rpoq	V	–nngilaq
uiar¦torneqarpoq	V	{–sorneqanngilaq, –torneqanngilaq}
uiart¦orpaa	V	–unngilaa
uiartugaangajappoq	V	(no generation)
uiartugaa¦voq	V	–nngilaq
uiar¦tugaavoq	V	{–sugaanngilaq, –tugaanngilaq}
uiartu¦gaq	N	–kkap, –kkat
uiar¦tugaq	N	{–sukkap, –tukkap}, {–sukkat, –tukkat}
uiaru¦ppoq	V	–tinngilaq
uiffa¦k	N	–ap, –at
uiffa¦q	N	–ap, –at
uiffattaat	N	–ip, –it
uiffattaat	N, pl.	-
uiffatta¦rpoq	V	–nngilaq
uig¦aa	V	–inngilaa
uiggiu¦ppaa	V	–tinngilaa
uiggiu¦serpaa	V	{–sinngilaa, –tilinngilaa}
uiggiu¦serpaa	V	–tilinngilaa
uiggiu¦sersorpaa	V	{–sersunngilaa, –tilersunngilaa}
uiggiut	N	–ip, –it
uiggiutaa¦rpaa	V	–nngilaa
uiggut	N	–ip, –it
uiggutappallaaqaaq	V	(no generation)
uigguta¦ppoq	V	–nngilaq
uigiit	N, pl.	-
uigiligassa¦q	N	–p, –t
uiginngilaa	V	(no generation)
uigiuma¦vaa	V	–nngilaa
uigoori¦voq	V	–nngilaq
uig¦oorpaa	V	–uunngilaa
uig¦oq	N	–up, –ut
uigorl¦eq	N	–iup, –iit
uigorliu¦voq	V	–nngilaq
uigu	N	–p, –t
uigu¦aa	V	–nngilaa
uigukumia¦q	N	–p, –t
uigulequt	N	–ip, –it
uiguleriiaat	N, pl.	-
uiguloqutta¦q	N	–p, –t
uigune¦q	N	–rup, –rit
uiguneqanngilaq	V	(no generation)
uigunn¦erpaa	V	–inngilaa
uigunners¦orpaa	V	–unngilaa
uigusa¦q	N	–p, –t
uigusa¦rpaa	V	–nngilaa
uiguu¦serpaa	V	{–sinngilaa, –tilinngilaa}
uiguu¦sersorpaa	V	{–sersunngilaa, –tilersunngilaa}
uiguut	N	–ip, –it
uiguutaa¦voq	V	–nngilaq
uiguu¦tilerineq	N	{–serinerup, –tilerinerup}, {–serinerit, –tilerinerit}
uikkiart¦orpoq	V	–unngilaq
uikumia¦q	N	–p, –t
uiliukkuma¦vaa	V	–nngilaa
uiliu¦ppaa	V	–tinngilaa
uiliussinnaanngilaa	V	(no generation)
uiliuti¦ppaa	V	–nngilaa
uiliut¦ippaa	V	{–inngilaa, –itinngilaa, –sinngilaa}
uillaa¦t	N	{–t, –p}, –t
uillarne¦q	N	–rup, –rit
uillarnerussutisiat	N, pl.	-
uilla¦rpoq	V	–nngilaq
uilliarfi¦k	N	–up, –it
uillia¦rpoq	V	–nngilaq
uil¦oq	N	–lup, –lut
uiloraasaa¦rpoq	V	–nngilaq
uilo¦raq	N	–qqap, –qqat
uilorsi¦orpoq	V	–unngilaq
uilorsu¦aq	N	–up, –it
uilorta¦rpoq	V	–nngilaq
uilort¦orpoq	V	–unngilaq
uilua¦q	N	–p, –t
uilui¦k	N	–up, –it
uiluitta¦rpoq	V	–nngilaq
uilui¦ttarpoq	V	{–ssanngilaq, –ttanngilaq}
uiluuteqarne¦q	N	–rup, –rit
uineerulluinna¦rpoq	V	–nngilaq
uineerullu¦innarpoq	V	{–innanngilaq, –aannanngilaq}
uineeru¦ppoq	V	–tinngilaq
uineerutt¦oq	N	–up, –ut
uineqanngilaq	V	(no generation)
uineqanngits¦oq	N	–up, –ut
uineqqikkumanngilaq	V	(no generation)
uineqqi¦ppoq	V	–nngilaq
uineqqiut	N	–ip, –it
uineqqiut	N, pl.	-
uinequs¦erpoq	V	–inngilaq
uinequ¦serpoq	V	{–sinngilaq, –tilinngilaq}
uinequt	N	–ip, –it
uinequtaannaa¦voq	V	–nngilaq
uinequt¦aannaavoq	V	{–aannaanngilaq, –iinnaanngilaq}
uinequtaa¦rpoq	V	–nngilaq
uinequtig¦aa	V	–inngilaa
uinequtitaa¦rpoq	V	–nngilaq
uinerlaaju¦voq	V	–nngilaq
uinerlaa¦q	N	–p, –t
uinerlaa¦voq	V	–nngilaq
uinert¦ooq	N	–uup, –uut
uingaa¦rpoq	V	–nngilaq
uingajaa¦q	N	–p, –t
uingane¦q	N	–rup, –rit
uingas¦oq	N	–up, –ut
uingasormiu	N	–p, –t
uingassut	N	–ip, –it
uingassu¦t	N	–up, –it
uingassutig¦aa	V	–inngilaa
uingatitsi¦voq	V	–nngilaq
uingavallaa¦rpoq	V	–nngilaq
uinga¦voq	V	–nngilaq
uin¦ik	N	{–iup, –ngup}, –iit
uinikkallarfiunngilaq	V	(no generation)
uinillu¦ppoq	V	–nngilaq
uini¦ppoq	V	–nngilaq
uinissinnaanngilaq	V	(no generation)
uinissinnaanng¦orpoq	V	–unngilaq
uinittu¦voq	V	–nngilaq
uinna¦ppoq	V	–nngilaq
uinnarikkunnaa¦rpoq	V	–nngilaq
uinnari¦ppoq	V	–nngilaq
uinnariss¦oq	N	–up, –ut
uinnari¦ssoq	N	{–ssup, –ttup}, {–ssut, –ttut}
uinnarivi¦ppoq	V	–nngilaq
uinnassinnaanngilaq	V	(no generation)
uinneru¦voq	V	–nngilaq
uinngaaj¦oorpoq	V	–uunngilaq
uinngaajoorti¦ppaa	V	–nngilaa
uinnganii¦ppoq	V	–nngilaq
uinngerukkaluttuinna¦rpoq	V	–nngilaq
uinngeru¦ppoq	V	–tinngilaq
uinngerutt¦oq	N	–up, –ut
uinngialaa¦rpoq	V	–nngilaq
uinngialane¦q	N	–rup, –rit
uinngiala¦voq	V	–nngilaq
uinngiarpalla¦ppoq	V	–nngilaq
uinngia¦rpallappoq	V	{–pallanngilaq, –rpallanngilaq}
uinngia¦rpoq	V	–nngilaq
uinngiars¦orpaa	V	–unngilaa
uinngiars¦orpoq	V	–unngilaq
uinngiarsu¦ppoq	V	–nngilaq
uinnginnaa¦voq	V	–nngilaq
uinngiulaa¦rpoq	V	–nngilaq
uinngiulaartorsu¦uvoq	V	{–aanngilaq, –unngilaq}
uinngiulasorujussuu¦voq	V	–nngilaq
uinngiulasorujussu¦uvoq	V	{–aanngilaq, –unngilaq}
uinngiula¦voq	V	–nngilaq
uioori¦voq	V	–nngilaq
ui¦oorpaa	V	–uunngilaa
uiorl¦eq	N	–iup, –iit
uiorliu¦voq	V	–nngilaq
ui¦ppaa	V	–nngilaa
uippakajaarne¦q	N	–rup, –rit
uippalla¦ppoq	V	–nngilaq
uip¦pallappoq	V	{–allanngilaq, –pallanngilaq}
uippallernaqaaq	V	(no generation)
uippallerne¦q	N	–rup, –rit
uippall¦erpoq	V	–inngilaq
uippallersi¦ppaa	V	–nngilaa
uippalliu¦ppaa	V	–tinngilaa
uippalliussi¦voq	V	–nngilaq
ui¦ppoq	V	–nngilaq
uisaallaatig¦aa	V	–inngilaa
uisaalla¦ppoq	V	–nngilaq
uisaangaja¦ppoq	V	–nngilaq
uisaa¦voq	V	–nngilaq
uisagajunnerusa¦rpoq	V	–nngilaq
uisakajaa¦rpoq	V	–nngilaq
uisangus¦erpoq	V	–inngilaq
uisa¦q	N	–p, –t
uisaqqalaa¦rpoq	V	–nngilaq
uisarus¦erpoq	V	–inngilaq
uisati¦ppaa	V	–nngilaa
uisa¦voq	V	–nngilaq
uisillua¦rpaa	V	–nngilaa
ui¦silluarpaa	V	{–silluanngilaa, –tilluanngilaa, –tsilluanngilaa}
uisi¦ppaa	V	–nngilaa
ui¦sippaa	V	{–sinngilaa, –tinngilaa, –tsinngilaa}
uisitaa¦voq	V	–nngilaq
ui¦sitaavoq	V	{–sitaanngilaq, –titaanngilaq, –tsitaanngilaq}
uisitsis¦oq	N	–up, –ut
ui¦sitsisoq	N	{–sitsisup, –titsisup, –tsitsisup}, {–sitsisut, –titsisut, –tsitsisut}
uisi¦voq	V	–nngilaq
uisoreqattaa¦rpoq	V	–nngilaq
uisorerfig¦aa	V	–inngilaa
uisorerne¦q	N	–rup, –rit
uisor¦erpoq	V	–inngilaq
uisorer¦saat	N	{–saatip, –taatip}, {–saatit, –taatit}
uisorersarfig¦aa	V	–inngilaa
uisorersa¦rpoq	V	–nngilaq
uisorersorfig¦aa	V	–inngilaa
uisorers¦orpoq	V	–unngilaq
uisoriinna¦q	N	–p, –t
uisorilajua¦rpoq	V	–nngilaq
uisorilajunnaa¦rpoq	V	–nngilaq
uisorilasa¦rpoq	V	–nngilaq
uisorila¦voq	V	–nngilaq
uissaa¦rpoq	V	–nngilaq
uissaartaanna¦rpoq	V	–nngilaq
uissaa¦voq	V	–nngilaq
uissanngulaa¦rpoq	V	–nngilaq
uissanngunaqaaq	V	(no generation)
uissannguna¦rpoq	V	–nngilaq
uissanngune¦q	N	–rup, –rit
uissanngusa¦rpoq	V	–nngilaq
uissanngu¦voq	V	–nngilaq
uissa¦q	N	–p, –t
uissaqal¦erpoq	V	–inngilaq
uissaqqi¦ppoq	V	–nngilaq
uissia¦q	N	–p, –t
uissiaqa¦rpoq	V	–nngilaq
uissiar¦aa	V	–inngilaa
uissiars¦erpaa	V	–inngilaa
uissiartaa¦rpoq	V	–nngilaq
uissinnaanngilaq	V	(no generation)
uissukkiart¦orpaa	V	–unngilaa
uissu¦ppaa	V	–tinngilaa
uissuumminaqaaq	V	(no generation)
uissuummina¦rpoq	V	–nngilaq
uissuumminart¦oq	N	–up, –ut
uissuumminartulerine¦q	N	–rup, –rit
uissuummisi¦ppaa	V	–nngilaa
uissuummisitsi¦voq	V	–nngilaq
uissuummissutig¦aa	V	–inngilaa
uissuummi¦voq	V	–nngilaq
uisu¦k	N	–up, –it
uisul¦ik	N	{–iup, –lip, –lup}, –lit
uitaa¦rpoq	V	–nngilaq
uitsaarilluinna¦rpoq	V	–nngilaq
uitsaari¦ppoq	V	–nngilaq
uitsaarissi¦voq	V	–nngilaq
uitsanne¦q	N	–rup, –rit
uitsa¦ppaa	V	–nngilaa
uitsas¦erpoq	V	–inngilaq
uitsa¦serpoq	V	{–sinngilaq, –tilinngilaq}
uitsataa¦voq	V	–nngilaq
uitsatig¦aa	V	–inngilaa
uitsatigisa¦q	N	–p, –t
uitsaviunngilaq	V	(no generation)
uitsaviunngivippoq	V	(no generation)
uiu	N	–p, –t
uiukumi¦aq	N	–up, –it
uiune¦q	N	–rup, –rit
uiuneqanngilaq	V	(no generation)
uiunn¦erpaa	V	–inngilaa
uiusa¦q	N	–p, –t
uius¦oq	N	–up, –ut
uiuus¦erpaa	V	–inngilaa
uiuu¦serpaa	V	{–linngilaa, –sinngilaa, –tilinngilaa, –taasinngilaa, –taatilinngilaa}
uiuu¦serpaa	V	{–sinngilaa, –tilinngilaa}
uiuu¦sersorpaa	V	{–lersunngilaa, –sersunngilaa, –tilersunngilaa, –taasersunngilaa, –taatilersunngilaa}
uiuu¦sersorpaa	V	{–sersunngilaa, –tilersunngilaa}
uiuut	N	–ip, –it
uiuu¦t	N	{–p, –tip, –taatip}, {–it, –tit, –taatit}
uiuutaa¦voq	V	–nngilaq
uiuu¦taavoq	V	{–nngilaq, –taanngilaq, –taataanngilaq}
uiverne¦q	N	–rup, –rit
uiv¦erpoq	V	–inngilaq
uivi¦ppoq	V	–nngilaq
ujaa¦ppaa	V	–tinngilaa
ujaa¦q	N	–p, –t
ujaar¦aa	V	–inngilaa
ujaareqqissaa¦rpaa	V	–nngilaa
ujaarillua¦rpaa	V	–nngilaa
ujaari¦ppoq	V	–nngilaq
ujaaseqqissaarne¦q	N	–rup, –rit
ujaasiffigeqqissaa¦rpaa	V	–nngilaa
ujaasiffi¦k	N	–up, –it
ujaasiffissiat	N, pl.	-
ujaasine¦q	N	–rup, –rit
ujaasi¦voq	V	–nngilaq
ujagaa¦voq	V	–nngilaq
uja¦gaq	N	–kkap, –kkat
ujagassartallit	N, pl.	-
ujajaaffig¦aa	V	–inngilaa
ujajaa¦gaq	N	–kkap, –kkat
ujajaane¦q	N	–rup, –rit
ujajaaniat	N, pl.	-
ujajaa¦rpaa	V	–nngilaa
ujajaarsu¦ppoq	V	–nngilaq
ujajaarsuutig¦aa	V	–inngilaa
ujajaas¦oq	N	–up, –ut
ujajaa¦voq	V	–nngilaq
ujajagaa¦voq	V	–nngilaq
ujaja¦gaq	N	–kkap, –kkat
ujaja¦rpaa	V	–nngilaa
ujakkaa¦ppoq	V	–tinngilaq
ujakkaarfi¦k	N	–up, –it
ujakkaarne¦q	N	–rup, –rit
ujakkaa¦rpoq	V	–nngilaq
ujakkaartart¦oq	N	–up, –ut
ujakka¦rpaa	V	–nngilaa
ujakka¦rpoq	V	–nngilaq
ujakkart¦erpaa	V	–inngilaa
ujakkart¦erpoq	V	–inngilaq
ujakkaru¦ppoq	V	–tinngilaq
ujakkataa¦rpoq	V	–nngilaq
ujalerine¦q	N	–rup, –rit
ujaleri¦voq	V	–nngilaq
ujallerine¦q	N	–rup, –rit
ujallerisaanna¦rpoq	V	–nngilaq
ujalleri¦voq	V	–nngilaq
ujall¦erpaa	V	–inngilaa
ujallisaanna¦rpoq	V	–nngilaq
ujalli¦voq	V	–nngilaq
ujal¦oq	N	–lup, –lut
ujaloqanngilaq	V	(no generation)
ujaloqa¦rpoq	V	–nngilaq
ujalori¦ppoq	V	–nngilaq
ujalu	N	–p, –t
ujalueru¦ppoq	V	–tinngilaq
ujalugi¦ppoq	V	–nngilaq
ujalugissi¦voq	V	–nngilaq
ujalussa¦q	N	–p, –t
ujalussia¦q	N	–p, –t
ujalussiaqa¦rpoq	V	–nngilaq
ujalussiarsi¦voq	V	–nngilaq
ujalutaki¦ppoq	V	–nngilaq
ujaluta¦q	N	–p, –t
ujalut¦aq	N	{–ap, –tap}, {–at, –tat}
ujalutarsu¦aq	N	–up, –it
ujaluusat	N, pl.	-
ujaluuteqanngilaq	V	(no generation)
ujameri¦ak	N	–ssap, –ssat
ujameria¦ppoq	V	–nngilaq
ujamerissat	N, pl.	-
ujami¦k	N	–p, –t
ujamil¦erpaa	V	–inngilaa
ujamil¦erpoq	V	–inngilaq
ujamil¦ik	N	{–iup, –lip, –lup}, –lit
ujamiliu¦ppaa	V	–tinngilaa
ujaminnanniunne¦q	N	–rup, –rit
ujaminna¦ppoq	V	–nngilaq
ujami¦ppaa	V	–nngilaa
ujami¦ppoq	V	–nngilaq
ujamissaa¦rpoq	V	–nngilaq
ujamissi¦voq	V	–nngilaq
ujamittaa¦rpoq	V	–nngilaq
ujamiut	N	–ip, –it
ujamiut	N, pl.	-
ujamiutaa¦rpoq	V	–nngilaq
ujamiutaa¦voq	V	–nngilaq
ujamm¦erpaa	V	–inngilaa
ujammi¦orpoq	V	–unngilaq
ujammisaanna¦rpoq	V	–nngilaq
ujammiu¦ppaa	V	–tinngilaa
ujammi¦voq	V	–nngilaq
ujangi¦ppoq	V	–nngilaq
ujangisima¦voq	V	–nngilaq
ujangisi¦ppaa	V	–nngilaa
ujangi¦sippaa	V	{–sinngilaa, –tinngilaa, –tsinngilaa}
uja¦ppoq	V	–nngilaq
ujaqqeraaq	V	(no generation)
ujaqqerillaqqi¦ppoq	V	–nngilaq
uja¦qqerillaqqippoq	V	{–qqerillaqqinngilaq, –ralerillaqqinngilaq}
ujaqqerisa¦rpoq	V	–nngilaq
uja¦qqerisarpoq	V	{–qqerisanngilaq, –ralerisanngilaq}
ujaqqeris¦oq	N	–up, –ut
uja¦qqerisoq	N	{–qqerisup, –ralerisup}, {–qqerisut, –ralerisut}
ujaqqerisuu¦voq	V	–nngilaq
uja¦qqerisuuvoq	V	{–qqerisuunngilaq, –ralerisuunngilaq}
uja¦qqerivik	N	{–qqeriffiup, –qqeriviup, –raleriffiup}, {–qqeriffiit, –qqeriviit, –raleriffiit}
uja¦qqerivoq	V	{–qqerinngilaq, –ralerinngilaq}
uja¦qqerpaa	V	{–qqinngilaa, –ralinngilaa}
uja¦qqerpoq	V	{–qqinngilaq, –ralinngilaq}
ujaqqers¦oorpoq	V	–uunngilaq
uja¦qqersorpaa	V	{–qqersunngilaa, –ralersunngilaa}
ujaqqersuutit	N, pl.	-
uja¦qqersuutit	N, pl.	{–qqersuutit, –qqertuutit, –ralersuutit, –ralertuutit}
uja¦qqiarpoq	V	{–qqianngilaq, –ralianngilaq}
uja¦qqiartarfik	N	{–qqiartarfiup, –raliartarfiup}, {–qqiartarfiit, –raliartarfiit}
ujaqqiort¦oq	N	–up, –ut
ujaqqissaa¦rpaa	V	–nngilaa
uja¦qqissaarpaa	V	{–qqissaanngilaa, –ralissaanngilaa}
uja¦qqiuppaa	V	{–qqiutinngilaa, –raliutinngilaa}
ujaqqiu¦serpaa	V	{–sinngilaa, –tilinngilaa}
uja¦qqiuserpaa	V	{–qqiutilinngilaa, –raliutilinngilaa}
ujaqqiu¦sersorpaa	V	{–sersunngilaa, –tilersunngilaa}
ujaqqiusers¦orpoq	V	–unngilaq
ujaqqiu¦sersorpoq	V	{–sersunngilaq, –tilersunngilaq}
ujaqqi¦usersorpoq	V	{–pusersunngilaq, –usersunngilaq}
uja¦qqiusersorpoq	V	{–qqerusersunngilaq, –qqiusersunngilaq, –ralerusersunngilaq, –raliusersunngilaq}
ujaqqiut	N	–ip, –it
ujaqqiutaa¦voq	V	–nngilaq
uja¦qqiutaavoq	V	{–qqiutaanngilaq, –raliutaanngilaq}
ujaqqiutit	N, pl.	-
ujaraaqqat	N, pl.	-
ujaraaqqia¦rpoq	V	–nngilaq
ujaraa¦raq	N	–qqap, –qqat
ujaraararta¦rpoq	V	–nngilaq
ujaraars¦erpoq	V	–inngilaq
ujaraarsersima¦voq	V	–nngilaq
ujaraasia¦q	N	–p, –t
ujaraa¦voq	V	–nngilaq
uja¦rak	N	–qqap, –qqat
ujaranngorne¦q	N	–rup, –rit
ujaranngorsimas¦oq	N	–up, –ut
ujaranngort¦oq	N	–up, –ut
ujarassa¦q	N	–p, –t
ujarassi¦ooq	N	–uup, –uut
ujarassiorfi¦k	N	–up, –it
ujarass¦iorfik	N	{–iorfiup, –aliorfiup}, {–iorfiit, –aliorfiit}
ujarassiort¦oq	N	–up, –ut
ujarass¦iortoq	N	{–iortup, –aliortup}, {–iortut, –aliortut}
ujarassu¦aq	N	–up, –it
ujarasussu¦k	N	–up, –it
ujarattaat	N	–ip, –it
ujarattaat	N, pl.	-
ujarattaatissa¦q	N	–p, –t
ujaratta¦q	N	–p, –t
ujarattarfi¦k	N	–up, –it
ujaratta¦rpoq	V	–nngilaq
ujarattassa¦q	N	–p, –t
ujariag¦aa	V	–inngilaa
ujarianaqaaq	V	(no generation)
ujariana¦rpoq	V	–nngilaq
ujariarsivoq	V	(no generation)
ujariatsinaqaaq	V	(no generation)
ujariatsina¦rpoq	V	–nngilaq
ujariatsine¦q	N	–rup, –rit
ujariatsissutig¦aa	V	–inngilaa
ujariatsivallaanngilaq	V	(no generation)
ujariatsi¦voq	V	–nngilaq
ujariutu¦voq	V	–nngilaq
ujarlerfig¦aa	V	–inngilaa
ujarlerfi¦k	N	–up, –it
ujarlerne¦q	N	–rup, –rit
ujarl¦erpoq	V	–inngilaq
ujarlersart¦oq	N	–up, –ut
ujarlersita¦q	N	–p, –t
ujarliu¦ppaa	V	–tinngilaa
ujarliut	N	–ip, –it
ujarliutaa¦voq	V	–nngilaq
ujarliutit	N, pl.	-
uja¦rpaa	V	–nngilaa
ujart¦orpaa	V	–unngilaa
ujartuarpaa	V	(no generation)
ujartuine¦q	N	–rup, –rit
ujarusukkaluaqaa	V	(no generation)
ujasserala¦voq	V	–nngilaq
ujatsiuserfi¦k	N	–up, –it
ujatsiu¦serfik	N	{–serfiup, –tilerfiup}, {–serfiit, –tilerfiit}
ujatsius¦erpoq	V	–inngilaq
ujatsiu¦serpoq	V	{–sinngilaq, –tilinngilaq}
ujatsiut	N	–ip, –it
ujatsiut	N, pl.	-
ujatsiutaars¦erpoq	V	–inngilaq
ujatsiutissia¦q	N	–p, –t
ujatsiutit	N, pl.	-
ujor¦oq	N	–up, –ut
ujui¦ppoq	V	–nngilaq
ujukkua¦q	N	–p, –t
ujukkuart¦orpoq	V	–unngilaq
ujukkuar¦torpoq	V	{–sunngilaq, –tunngilaq}
ujukkuartuusi¦orpoq	V	–unngilaq
ujukkuartuu¦siorpoq	V	{–siunngilaq, –tiliunngilaq}
ujukkuartuut	N	–ip, –it
ujukkuartuut	N, pl.	-
ujumi¦k	N	–p, –t
ujumi¦ppoq	V	–nngilaq
ujunnguart¦orpoq	V	–unngilaq
ujunnguj¦oorpaa	V	–uunngilaa
ujunnguj¦oorpoq	V	–uunngilaq
ujunngujoorut	N	–ip, –it
ujunngujoorut	N, pl.	-
ujunngujoorutig¦aa	V	–inngilaa
ujussuala¦voq	V	–nngilaq
ujussula¦voq	V	–nngilaq
ujussu¦ppoq	V	–nngilaq
ukal¦eq	N	–lip, –lit
ukaleraji¦k	N	–up, –it
ukaleriaasa¦q	N	–p, –t
ukaleri¦aq	N	–ssap, –ssat
ukal¦erpoq	V	–inngilaq
ukalersal¦ik	N	{–iup, –lip, –lup}, –lit
ukalia¦q	N	–p, –t
ukaliatsia¦q	N	–ap, –at
ukaliatsia¦q	N	–p, –t
ukaliatsi¦aq	N	–up, –it
ukaliatsiaqa¦rpoq	V	–nngilaq
ukalingaja¦ppoq	V	–nngilaq
ukalinngu¦aq	N	–up, –it
ukaliusa¦q	N	–p, –t
ukallia¦q	N	–p, –t
ukalli¦orpoq	V	–unngilaq
ukamaa¦ppaa	V	–tinngilaa
ukamarfi¦k	N	–up, –it
ukama¦rpoq	V	–nngilaq
ukamart¦oq	N	–up, –ut
ukamarusaarfi¦k	N	–up, –it
ukamarusaa¦rpoq	V	–nngilaq
ukamarusaarti¦ppaa	V	–nngilaa
ukeeriaraluarniarpoq	V	(no generation)
ukeruukkaluttuinna¦rpoq	V	–nngilaq
ukeruu¦ppoq	V	–tinngilaq
ukiaa¦voq	V	–nngilaq
ukiajaa¦rpoq	V	–nngilaq
ukiakkut	N, pl.	-
ukialereeraluarpoq	V	(no generation)
ukia¦q	N	–p, –t
ukiaria¦q	N	–p, –t
ukiarpalu¦ppoq	V	–nngilaq
ukia¦rpoq	V	–nngilaq
ukiarsa¦rpoq	V	–nngilaq
ukiassa¦q	N	–p, –t
ukigaluttuinna¦rpoq	V	–nngilaq
ukiiffig¦aa	V	–inngilaa
ukiigaluarniarpoq	V	(no generation)
ukiigaluarnikuu¦voq	V	–nngilaq
ukiine¦q	N	–rup, –rit
ukiisi¦ppaa	V	–nngilaa
ukiisissa¦q	N	–p, –t
ukiivi¦k	N	–up, –it
ukiivissarsi¦voq	V	–nngilaq
ukiivissi¦ppoq	V	–nngilaq
ukiiviu¦voq	V	–nngilaq
ukii¦voq	V	–nngilaq
ukilatsis¦oq	N	–up, –ut
ukilatsi¦voq	V	–nngilaq
ukinga¦voq	V	–nngilaq
ukinngat	N	–ip, –it
ukinngataa¦voq	V	–nngilaq
ukinngatig¦aa	V	–inngilaa
uki¦oq	N	–up, –ut
ukioqal¦erpoq	V	–inngilaq
ukioqalersimagaluarpoq	V	(no generation)
ukioqa¦rpoq	V	–nngilaq
ukioqat	N	–ip, –it
ukioqatig¦aa	V	–inngilaa
ukioqatigiit	N, pl.	-
ukioqqortusilluarne¦q	N	–rup, –rit
ukioqqortussu¦seq	N	–tsip, –tsit
ukiori¦k	N	–up, –it
ukiori¦ppoq	V	–nngilaq
ukiorissaa¦rpoq	V	–nngilaq
ukiorissi¦voq	V	–nngilaq
ukiorlu¦k	N	–up, –it
ukiorluu¦voq	V	–nngilaq
uki¦orpoq	V	–unngilaq
ukiortaa¦q	N	–p, –t
ukiortaarsiorne¦q	N	–rup, –rit
ukiortaarsi¦orpoq	V	–unngilaq
ukiorta¦q	N	–p, –t
uki¦ppaa	V	–nngilaa
ukisaa¦rpoq	V	–nngilaq
ukisaasi¦orpoq	V	–unngilaq
ukisaa¦siorpoq	V	{–siunngilaq, –tiliunngilaq}
ukisaat	N	–ip, –it
ukisaa¦voq	V	–nngilaq
ukisa¦q	N	–p, –t
ukisigaju¦ppoq	V	–nngilaq
ukisine¦q	N	–rup, –rit
ukisi¦voq	V	–nngilaq
ukissut	N	–ip, –it
ukitsi¦voq	V	–nngilaq
ukiukits¦oq	N	–up, –ut
ukiukkut	N, pl.	-
ukiul¦erpoq	V	–inngilaq
ukiul¦ik	N	{–iup, –lip, –lup}, –lit
ukiumoort¦oq	N	–up, –ut
ukiutoq¦aq	N	{–qap, –ap}, {–qat, –at}
ukiutoqarsi¦orpoq	V	–unngilaq
ukiuuallaaqaaq	V	(no generation)
ukiuukkiart¦orpaa	V	–unngilaa
ukiuu¦ppaa	V	–tinngilaa
ukiuussa¦q	N	–p, –t
ukiuu¦voq	V	–nngilaq
uki¦voq	V	–nngilaq
ukkanneqal¦erpoq	V	–inngilaq
ukkanneqa¦rpoq	V	–nngilaq
ukka¦ppaa	V	–tinngilaa
ukka¦q	N	–ap, –at
ukkarmii¦ppoq	V	–nngilaq
ukkarmiu	N	–p, –t
ukkasiu¦ppaa	V	–tinngilaa
ukka¦siuppaa	V	{–siutinngilaa, –tiliutinngilaa}
ukkassine¦q	N	–rup, –rit
ukkassi¦voq	V	–nngilaq
ukkat	N	–ip, –it
ukkataa¦voq	V	–nngilaq
ukkata¦q	N	–p, –t
ukkataqal¦erpoq	V	–inngilaq
ukkatar¦aa	V	–inngilaa
ukkatarinnitt¦oq	N	–up, –ut
ukkatig¦aa	V	–inngilaa
ukkiaarne¦q	N	–rup, –rit
ukkillua¦rpaa	V	–nngilaa
ukki¦ppaa	V	–sinngilaa
ukkis¦erpaa	V	–inngilaa
ukkissa¦q	N	–p, –t
ukkissine¦q	N	–rup, –rit
ukkissi¦voq	V	–nngilaq
ukkivig¦aa	V	–inngilaa
ukkivigiinna¦rpaa	V	–nngilaa
ukkua¦q	N	–p, –t
ukkus¦erpaa	V	–inngilaa
ukku¦serpaa	V	{–sinngilaa, –tilinngilaa}
ukkusi¦k	N	–up, –it
Ukkusissa¦q	N	–p, –t
Ukkusissa¦q	Prop	–p
ukkusissa¦q	N	–p, –t
ukkusissaqa¦rpoq	V	–nngilaq
ukkusissarta¦rpoq	V	–nngilaq
Ukkusissat	N, pl.	-
Ukkusissat	Prop, pl.	-
ukkusisseraaq	V	(no generation)
ukkusisseri¦voq	V	–nngilaq
ukkusissiarfi¦k	N	–up, –it
ukkusissia¦rpoq	V	–nngilaq
ukkusissiarta¦rpoq	V	–nngilaq
ukkusissi¦orpoq	V	–unngilaq
ukkusiss¦iorpoq	V	{–iunngilaq, –aliunngilaq}
ukkusissiortaanna¦rpoq	V	–nngilaq
ukkusissiuut	N	–ip, –it
ukkusissiuuteqa¦rpoq	V	–nngilaq
ukkut	N	–ip, –it
ukkutaa¦voq	V	–nngilaq
uk¦ooq	N	–uup, –uut
ukoqatigiit	N, pl.	-
ukortiik	Interj	(no generation)
uku	Pron, pl.	–a
ukuaasa¦q	N	–p, –t
ukuak¦oq	N	–up, –ut
uku¦aq	N	–ssap, –ssat
ukuar¦aa	V	–inngilaa
ukuarluar¦aa	V	–inngilaa
ukuarluarisa¦q	N	–p, –t
ukuarlua¦rpoq	V	–nngilaq
ukuartaa¦q	N	–p, –t
ukuinna¦rpoq	V	–nngilaq
ukujart¦orpoq	V	–unngilaq
ukukkiart¦orpoq	V	–unngilaq
ukulluersaa¦rpoq	V	–nngilaq
ukullui¦ppoq	V	–nngilaq
ukulluisaa¦rpoq	V	–nngilaq
ukulluits¦oq	N	–up, –ut
ukuma¦rpoq	V	–nngilaq
ukumart¦oq	N	–up, –ut
ukumartuanngua¦rpoq	V	–nngilaq
ukungaa¦rpoq	V	–nngilaq
ukunga¦voq	V	–nngilaq
uku¦ppaa	V	–tinngilaa
uku¦ppoq	V	–nngilaq
ukusarfig¦aa	V	–inngilaa
ukusarfigiti¦ppoq	V	–nngilaq
ukusa¦rpoq	V	–nngilaq
ukusart¦oq	N	–up, –ut
ukusoorfig¦aa	V	–inngilaa
ukus¦oorpoq	V	–uunngilaq
ukussiukkuma¦vaa	V	–nngilaa
ukussiu¦ppaa	V	–tinngilaa
ukussiu¦ppoq	V	–tinngilaq
ukuti¦ppaa	V	–nngilaa
ukut¦ippaa	V	{–itinngilaa, –sinngilaa}
ukuts¦eq	N	–ip, –it
ukutserissaas¦erpaa	V	–inngilaa
ukutserissaa¦serpaa	V	{–sinngilaa, –tilinngilaa}
ukutseri¦ssaaserpaa	V	{–ssaasinngilaa, –ssaatilinngilaa, –ttaasinngilaa, –ttaatilinngilaa}
ukutserissaat	N	–ip, –it
ukutseri¦ssaat	N	{–ssaatip, –ttaatip}, {–ssaatit, –ttaatit}
ukutserissa¦rpaa	V	–nngilaa
ukutseri¦voq	V	–nngilaq
ukutserlu¦ppoq	V	–nngilaq
ukutsileri¦voq	V	–nngilaq
ukutsinnguna¦rpoq	V	–nngilaq
ukutsinngutu¦voq	V	–nngilaq
ukutsinngu¦voq	V	–nngilaq
uku¦voq	V	–nngilaq
ulam¦erpoq	V	–inngilaq
ulamersa¦rpaa	V	–nngilaa
ulamert¦oq	N	–up, –ut
ulamer¦toq	N	{–sup, –tup}, {–sut, –tut}
ulamertuinnaa¦voq	V	–nngilaq
ulamer¦tuinnaavoq	V	{–suinnaanngilaq, –tuinnaanngilaq}
ulammari¦ppoq	V	–nngilaq
ulammarissa¦rpaa	V	–nngilaa
ulammarissi¦voq	V	–nngilaq
ulammariss¦oq	N	–up, –ut
ulammari¦ssoq	N	{–ssup, –ttup}, {–ssut, –ttut}
ulammarivi¦ppoq	V	–nngilaq
ulammusa¦q	N	–p, –t
ulannerusa¦q	N	–p, –t
ulapaa¦rpoq	V	–nngilaq
ulapaarti¦ppaa	V	–nngilaa
ulapaarutig¦aa	V	–inngilaa
ulapersilluinna¦rpaa	V	–nngilaa
ulapersillu¦innarpaa	V	{–aannanngilaa, –innanngilaa}
ulapersi¦vaa	V	–nngilaa
ulapig¦aa	V	–inngilaa
ulapikatalluinnalereerpoq	V	(no generation)
ulapikatattaraluarpoq	V	(no generation)
ulapikatatta¦rpoq	V	–nngilaq
ulapippallaarpalu¦ppoq	V	–nngilaq
ulapippallaartaqaaq	V	(no generation)
ulapi¦ppoq	V	–nngilaq
ulapisaat	N	–ip, –it
ulapisaatig¦aa	V	–inngilaa
ulapisaa¦voq	V	–nngilaq
ulapisa¦rpaa	V	–nngilaa
ulapisa¦rpoq	V	–nngilaq
ulapissut	N	–ip, –it
ulapissutig¦aa	V	–inngilaa
ulapiti¦ppaa	V	–nngilaa
ulapi¦tippaa	V	{–sinngilaa, –tinngilaa, –tsinngilaa}
ulapittorsu¦uvoq	V	{–aanngilaq, –unngilaq}
ulappus¦erpoq	V	–inngilaq
ulappu¦serpoq	V	{–sinngilaq, –tilinngilaq}
ulapput	N	–ip, –it
ulapputaa¦rpoq	V	–nngilaq
ulapputaarutig¦aa	V	–inngilaa
ulapputaavi¦ppoq	V	–nngilaq
ulapputeqaqaaq	V	(no generation)
ulapputig¦aa	V	–inngilaa
ulapputil¦ik	N	{–iup, –lip, –lup}, –lit
ularu¦ppaa	V	–tinngilaa
ularussaa¦voq	V	–nngilaq
ularussine¦q	N	–rup, –rit
ularussi¦voq	V	–nngilaq
ulassu¦ppaa	V	–tinngilaa
ulatsa¦ppoq	V	–nngilaq
ulatsatsi¦ppaa	V	–nngilaa
uleerneqa¦rpoq	V	–nngilaq
ul¦eerpaa	V	–iinngilaa
ul¦eerpoq	V	–iinngilaq
uleersima¦voq	V	–nngilaq
uleersi¦ppaa	V	–nngilaa
uleersi¦voq	V	–nngilaq
uleeru¦ppoq	V	–tinngilaq
uleerutivi¦ppoq	V	–nngilaq
uleerutt¦oorpoq	V	–uunngilaq
uleqattaarfig¦aa	V	–inngilaa
uleqattaa¦rpoq	V	–nngilaq
uleqattaarti¦ppaa	V	–nngilaa
uleqqajart¦orpoq	V	–unngilaq
uleqqane¦q	N	–rup, –rit
uleqqa¦voq	V	–nngilaq
Ulersu¦aq	N	–up, –it
ulersu¦aq	N	–up, –it
uleruloorne¦q	N	–rup, –rit
ulerunnaqaaq	V	(no generation)
uleru¦ppaa	V	–tinngilaa
ulerussisi¦ppaa	V	–nngilaa
ulerussi¦voq	V	–nngilaq
uli	N	–p, –t
ulig¦aa	V	–inngilaa
uliga¦rpaa	V	–nngilaa
uligartuinnaa¦vaa	V	–nngilaa
uligiil¦ik	N	{–iup, –lip, –lup}, –lit
uligiuma¦vaa	V	–nngilaa
uligu¦aq	N	–ssap, –ssat
uliguarsu¦aq	N	–up, –it
uliguartaa¦rpoq	V	–nngilaq
uligui¦aq	N	–ssap, –ssat
uliguss¦erpoq	V	–inngilaq
uligussiu¦ppaa	V	–tinngilaa
uliine¦q	N	–rup, –rit
uli¦k	N	–up, –it
ulika¦rpoq	V	–nngilaq
ulikarti¦ppaa	V	–nngilaa
ulikattarne¦q	N	–rup, –rit
ulikatta¦rpoq	V	–nngilaq
ulikattarsimaqaaq	V	(no generation)
ulikattartua¦rpoq	V	–nngilaq
ulikkaapajaakannerpoq	V	(no generation)
ulikkaaqqinnaarpoq	V	(no generation)
ulikkaaqqius¦erpaa	V	–inngilaa
ulikkaaqqiu¦serpaa	V	{–sinngilaa, –tilinngilaa}
ulikkaaqqiut	N	–ip, –it
ulikkaa¦rpaa	V	–nngilaa
ulikkaarpallaa¦rpaa	V	–nngilaa
ulikkaarpallaa¦rpoq	V	–nngilaq
ulikkaa¦rpoq	V	–nngilaq
ulikkaart¦oorpoq	V	–uunngilaq
ulikkaartoorti¦ppaa	V	–nngilaa
ulikkaart¦oq	N	–up, –ut
ulikkaaru¦ppaa	V	–tinngilaa
ulikkaa¦rut	N	{–rutip, –qutip}, {–rutit, –qutit}
ulikkaarutig¦aa	V	–inngilaa
ulikkaa¦rutigaa	V	{–rutiginngilaa, –qutiginngilaa}
ulikkaarutissa¦q	N	–p, –t
ulikkaa¦rutissaq	N	{–rutissap, –qutissap}, {–rutissat, –qutissat}
ulikkaavikkallarpoq	V	(no generation)
ulikkaavi¦ppoq	V	–nngilaq
ulikkaavissanngilaq	V	(no generation)
ulikkaavissimas¦oq	N	–up, –ut
ulikkiartorlualersimavoq	V	(no generation)
ulikkiartornavianngilaq	V	(no generation)
ulikkiartorniarpoq	V	(no generation)
ulikkiart¦orpoq	V	–unngilaq
ulikkiartorunnaarpoq	V	(no generation)
ulikkiartorusaarpoq	V	(no generation)
ulikkiartunngilaq	V	(no generation)
ulikkiartupiloorpoq	V	(no generation)
ulikkiartussa¦aq	V	–nngilaq
ulimaa¦q	N	–p, –t
ulimaaqa¦rpoq	V	–nngilaq
ulimaasisa¦rpoq	V	–nngilaq
ulimaassa¦q	N	–p, –t
ulimaassisa¦rpoq	V	–nngilaq
ulimaassu¦aq	N	–up, –it
ulimaat	N	–ip, –it
ulimaat	N, pl.	-
ulimaatissa¦q	N	–p, –t
ulimallaqqi¦ppoq	V	–nngilaq
ulimane¦q	N	–rup, –rit
ulimasa¦q	N	–p, –t
ulimasuu¦voq	V	–nngilaq
ulima¦vaa	V	–nngilaa
ulima¦voq	V	–nngilaq
ulimmakoqanngilaq	V	(no generation)
ulimmakoqaqaaq	V	(no generation)
ulimmaku	N	–p, –t
ulimmarluku	N	–p, –t
ulimmavi¦k	N	–up, –it
ulim¦oorpoq	V	–uunngilaq
ulimukarne¦q	N	–rup, –rit
ulimukarpallaa¦rpoq	V	–nngilaq
ulimuka¦rpoq	V	–nngilaq
ulinne¦q	N	–rup, –rit
ulinnerpaaffi¦k	N	–up, –it
ulinnerpaa¦ffik	N	{–ffiup, –juffiup}, {–ffiit, –juffiit}
ulinnersu¦aq	N	–up, –it
ulinnerusaa¦q	N	–p, –t
ulinngaa¦rpoq	V	–nngilaq
ulinngas¦oorpoq	V	–uunngilaq
ulinngasoorti¦ppaa	V	–nngilaa
ulinnga¦voq	V	–nngilaq
ulinnikinnerpaa¦ffik	N	{–ffiup, –juffiup}, {–ffiit, –juffiit}
uli¦ppaa	V	–nngilaa
uli¦ppoq	V	–nngilaq
ulissa¦q	N	–p, –t
ulissimaqaaq	V	(no generation)
ulissima¦voq	V	–nngilaq
ulissi¦voq	V	–nngilaq
uliss¦orpaa	V	–unngilaa
ulissu¦aq	N	–up, –it
ulitaa¦voq	V	–nngilaq
ulita¦q	N	–p, –t
ulitassaa¦voq	V	–nngilaq
ulitassa¦q	N	–p, –t
uliti¦ppaa	V	–nngilaa
ulitsisaanna¦rpoq	V	–nngilaq
ulitsisa¦rpoq	V	–nngilaq
ulitsi¦voq	V	–nngilaq
ulittorsuu¦voq	V	–nngilaq
ulittorsu¦uvoq	V	{–aanngilaq, –unngilaq}
uli¦ttorsuuvoq	V	{–ssorsuaanngilaq, –ssorsuunngilaq, –ttorsuaanngilaq, –ttorsuunngilaq}
uliunnaa¦q	N	–p, –t
uliunna¦ppaa	V	–nngilaa
uliunna¦ppoq	V	–nngilaq
uliusaa¦q	N	–p, –t
uliut	N	–ip, –it
ullaajunnaar¦soq	N	{–sup, –tup}, {–sut, –tut}
ullaaju¦voq	V	–nngilaq
ullaakkorsiorfi¦k	N	–up, –it
ullaakkorsi¦orpoq	V	–unngilaq
ullaakkorsiorta¦rpoq	V	–nngilaq
ullaakkorsiut	N	–ip, –it
ullaakkorsiutaa¦voq	V	–nngilaq
ullaakkorsiutit	N, pl.	-
ullaakkut	N, pl.	-
ullaanngu¦aq	N	–up, –it
ullaa¦q	N	–p, –t
ullaaralaanngu¦aq	N	–up, –it
ullaaralaa¦q	N	–p, –t
ullaaria¦q	N	–p, –t
ullaaria¦rpoq	V	–nngilaq
ullaarorpallaanngilaq	V	(no generation)
ullaar¦orpoq	V	–unngilaq
ullaarortaanna¦rpoq	V	–nngilaq
ullaarsarnaanngu¦aq	N	–up, –it
ullaarsarne¦q	N	–rup, –rit
ullaarsarn¦erpoq	V	–inngilaq
ullaarsi¦orpoq	V	–unngilaq
ullaarsiut	N	–ip, –it
ullaassa¦q	N	–p, –t
ullaavallaa¦rpoq	V	–nngilaq
ullaa¦voq	V	–nngilaq
ullasaassu¦aq	N	–up, –it
ullasaat	N	–ip, –it
ulligalla¦rpoq	V	–nngilaq
ullisaat	N	–ip, –it
ullisa¦rpoq	V	–nngilaq
ullisi¦ppaa	V	–nngilaa
ulli¦voq	V	–nngilaq
ull¦oq	N	–up, –ut
ulloqeqqa¦rpoq	V	–nngilaq
ulloqeqqasi¦orpoq	V	–unngilaq
ulloqeqqasiutit	N, pl.	-
ulloriaasalia¦q	N	–p, –t
ulloriaasali¦orpoq	V	–unngilaq
ulloriaasanngu¦aq	N	–up, –it
ulloriaasa¦q	N	–p, –t
ulloriaa¦siorpoq	V	{–siunngilaq, –tiliunngilaq}
ulloriaa¦siorsinnaavoq	V	{–siorsinnaanngilaq, –tiliorsinnaanngilaq}
ullori¦aq	N	–ssap, –ssat
ulloriarsiorfi¦k	N	–up, –it
ulloriarsiorne¦q	N	–rup, –rit
ulloriarsi¦orpoq	V	–unngilaq
ulloriarsiort¦oq	N	–up, –ut
ulloriarsu¦aq	N	–up, –it
ullormusia¦q	N	–p, –t
ullormusiaqarsinnaatitaane¦q	N	–rup, –rit
ullormusiat	N, pl.	-
ullororluanngits¦oq	N	–up, –ut
ullororlua¦rpoq	V	–nngilaq
ullor¦orpoq	V	–unngilaq
ullorpaattoorti¦ppoq	V	–nngilaq
ull¦orpoq	V	–unngilaq
ullorsiorne¦q	N	–rup, –rit
ullorsi¦orpoq	V	–unngilaq
ullorsiutit	N, pl.	-
ullortunaa¦rpoq	V	–nngilaq
Ullortune¦q	N	–rup, –rit
ullortune¦q	N	–rup, –rit
ullortunersiorne¦q	N	–rup, –rit
ullortusi¦voq	V	–nngilaq
ulloruarsaa¦rpoq	V	–nngilaq
ullorullart¦oq	N	–up, –ut
ulloruttorpoq	V	(no generation)
ullualuinnannguit	N, pl.	-
ullualunnguit	N, pl.	-
ullu¦erpoq	V	–inngilaq
ulluertal¦erpoq	V	–inngilaq
ullugissaa¦rpoq	V	–nngilaq
ulluinna¦q	N	–ap, –at
ulluinnarsiutit	N, pl.	-
ulluissaa¦rpoq	V	–nngilaq
ullukilliart¦orpoq	V	–unngilaq
ullukillisaa¦rpoq	V	–nngilaq
ullukillisaarut	N	–ip, –it
ullukillisaat	N	–ip, –it
ullukilli¦voq	V	–nngilaq
ullukinaa¦rpoq	V	–nngilaq
ullukinaarsi¦voq	V	–nngilaq
ullukinaar¦sivoq	V	{–inngilaq, –sinngilaq}
ullukinne¦q	N	–rup, –rit
ullukinnersiorne¦q	N	–rup, –rit
ullukinnersiornerit	N, pl.	-
ulluki¦ppoq	V	–nngilaq
ullukkut	N, pl.	-
ullulaa¦q	N	–p, –t
ullulerillaqqi¦ppoq	V	–nngilaq
ullulerisuu¦voq	V	–nngilaq
ulluleri¦voq	V	–nngilaq
ullulerne¦q	N	–rup, –rit
ullulersuine¦q	N	–rup, –rit
ullulersuisarne¦q	N	–rup, –rit
ulluliorfi¦k	N	–up, –it
ulluli¦orpoq	V	–unngilaq
ullulleerne¦q	N	–rup, –rit
ullull¦eerpoq	V	–iinngilaq
ulluminngort¦oq	N	–up, –ut
ullussa¦rpoq	V	–nngilaq
ullut	N, pl.	-
ullutaakkat	N, pl.	-
ullutaat	N	–ip, –it
ullutaat	N, pl.	-
ulluta¦rpoq	V	–nngilaq
ullutarsinnaatitaa¦voq	V	–nngilaq
ullutarsinnaa¦voq	V	–nngilaq
ulluu¦voq	V	–nngilaq
uloqqas¦oorpoq	V	–uunngilaq
uloqqa¦voq	V	–nngilaq
uloriag¦aa	V	–inngilaa
uloriagiunnaa¦rpaa	V	–nngilaa
ulorianaqaaq	V	(no generation)
ulorianarluinnart¦oq	N	–up, –ut
uloriana¦rpoq	V	–nngilaq
ulorianarsigaluttuinnarpoq	V	(no generation)
ulorianart¦oq	N	–up, –ut
ulorianartoqanngits¦oq	N	–up, –ut
ulorianartorsiungaarne¦q	N	–rup, –rit
ulorianartul¦ik	N	{–iup, –lip, –lup}, –lit
ulorianassu¦seq	N	–tsip, –tsit
uloria¦rpoq	V	–nngilaq
uloriarsinnaanngilaq	V	(no generation)
uloriarti¦ppaa	V	–nngilaa
uloriasaa¦rpaa	V	–nngilaa
uloria¦saarpaa	V	{–saanngilaa, –taanngilaa}
uloriasu¦ppoq	V	–nngilaq
uloriatsaa¦ppaa	V	–tinngilaa
uloriatsaassi¦voq	V	–nngilaq
ulornaasa¦q	N	–p, –t
ulorna¦q	N	–p, –t
ul¦orpoq	V	–unngilaq
ulorsu¦aq	N	–up, –it
ulorti¦ppaa	V	–nngilaa
ulortoorne¦q	N	–rup, –rit
ulu	N	–p, –t
uluaarsi¦voq	V	–nngilaq
uluagulli¦k	N	–up, –it
ulu¦ak	N	–ssap, –ssat
uluaki¦ppoq	V	–nngilaq
uluakkaa¦q	N	–p, –t
uluammi¦ppaa	V	–nngilaa
uluaqqortu¦voq	V	–nngilaq
uluatt¦ooq	N	–uup, –uut
uluers¦erpoq	V	–inngilaq
ulu¦gaq	N	–kkap, –kkat
ulugu¦ppaa	V	–tinngilaa
ulugussaa¦voq	V	–nngilaq
ulugutiti¦ppoq	V	–nngilaq
ulugut¦itippoq	V	{–itinngilaq, –sinngilaq}
uluis¦orpoq	V	–unngilaq
ulu¦k	N	–up, –it
ulukia¦q	N	–p, –t
ulukuttaat	N	–ip, –it
ulukuttaatikasi¦k	N	–up, –it
ulumaa¦t	N	{–ap, –tip}, {–tit, –vit}
ulungasoorti¦ppaa	V	–nngilaa
ulungasoortitsi¦voq	V	–nngilaq
ulungatitsi¦voq	V	–nngilaq
ulunga¦voq	V	–nngilaq
ulunnaasal¦ik	N	{–iup, –lip, –lup}, –lit
ulunna¦q	N	–ap, –at
ulu¦ppaa	V	–nngilaa
ulu¦ppoq	V	–nngilaq
ulussaa¦q	N	–p, –t
ulussa¦aq	V	–nngilaq
ulussaarpalu¦ppoq	V	–nngilaq
ulussaa¦rpoq	V	–nngilaq
ulussaarsu¦aq	N	–up, –it
ulussaarsuarpoq	V	(no generation)
ulussa¦q	N	–p, –t
Ulussart¦ooq	N	–uup, –uut
Ulussart¦ooq	Prop	–uup
uluta¦q	N	–p, –t
ulutiti¦ppoq	V	–nngilaq
ulutsikkumanngilaa	V	(no generation)
ulutsi¦ppaa	V	–nngilaa
ulutsitsi¦voq	V	–nngilaq
ulutta¦gaq	N	–kkap, –kkat
ulutta¦rpaa	V	–nngilaa
ulutt¦orpaa	V	–unngilaa
ulu¦ttorpaa	V	–ssunngilaa
uluttullaqqi¦ppoq	V	–nngilaq
uluttuu¦ppaa	V	–tinngilaa
uluusiit	N, pl.	-
umeeri¦voq	V	–nngilaq
um¦eerpoq	V	–iinngilaq
umeers¦erpoq	V	–inngilaq
umeersiutig¦aa	V	–inngilaa
umeralaarlua¦rpaa	V	–nngilaa
umeralaa¦rpaa	V	–nngilaa
umeralaa¦rpoq	V	–nngilaq
umeralaartuarpaa	V	(no generation)
umeram¦ineq	N	{–ernup, –inerup}, {–ernit, –inerit}
umeraminersu¦aq	N	–up, –it
umerluanngilaa	V	(no generation)
umerlu¦k	N	–up, –it
umerlutt¦ooq	N	–uup, –uut
umerluusa¦q	N	–p, –t
umerluusat	N, pl.	-
umerorlua¦rpaa	V	–nngilaa
umer¦orpaa	V	–unngilaa
umer¦orpoq	V	–unngilaq
um¦erpaa	V	–inngilaa
um¦erpoq	V	–inngilaq
umertuarpaa	V	(no generation)
umerualaa¦rpaa	V	–nngilaa
umerumisaa¦rpaa	V	–nngilaa
umiaaja¦rpoq	V	–nngilaq
umiaaqqi¦orpoq	V	–unngilaq
umiaarali¦orpoq	V	–unngilaq
umiaa¦raq	N	–qqap, –qqat
umiaarartaa¦rpoq	V	–nngilaq
umiaa¦rpoq	V	–nngilaq
umiaart¦orpoq	V	–unngilaq
umiaaru¦ppoq	V	–tinngilaq
umiaarutingaja¦ppoq	V	–nngilaq
umiaasaa¦raq	N	–qqap, –qqat
umiaasa¦q	N	–p, –t
umial¦ik	N	{–iup, –lip, –lup}, –lit
umiamii¦ppoq	V	–nngilaq
umia¦q	N	–p, –t
umiaqa¦rpoq	V	–nngilaq
umiari¦aq	N	–ssap, –ssat
umiarlu¦k	N	–up, –it
umiarlu¦ppoq	V	–nngilaq
umiarluusi¦orpoq	V	–unngilaq
umiarluu¦siorpoq	V	{–siunngilaq, –tiliunngilaq}
umiarluut	N	–ip, –it
umiarpassuit	N, pl.	-
umiarsa¦rpoq	V	–nngilaq
umiarsuaa¦raq	N	–qqap, –qqat
umiarsuaarartaa¦rpoq	V	–nngilaq
umiarsuaa¦rpoq	V	–nngilaq
umiarsuaartorpalu¦ppoq	V	–nngilaq
umiarsuaart¦orpoq	V	–unngilaq
umiarsuaateqarfiit	N, pl.	-
umiarsuaatileqatigiiffi¦k	N	–up, –it
umiarsuaa¦tileqatigiiffik	N	{–tileqatigiiffiup, –seqatigiiffiup}, {–tileqatigiiffiit, –seqatigiiffiit}
umiarsu¦aatileqatigiiffik	N	{–aatileqatigiiffiup, –utileqatigiiffiup, –aaseqatigiiffiup}, {–aatileqatigiiffiit, –utileqatigiiffiit, –aaseqatigiiffiit}
umiarsuaatil¦ik	N	{–iup, –lip, –lup}, –lit
umiarsuakkoortita¦q	N	–p, –t
umiarsuakkoortitat	N, pl.	-
umiarsualia¦rpoq	V	–nngilaq
umiarsualiorfi¦k	N	–up, –it
umiarsualiorne¦q	N	–rup, –rit
umiarsualiortuune¦q	N	–rup, –rit
umiarsualiveqarfiit	N, pl.	-
umiarsualiveqarfi¦k	N	–up, –it
umiarsualiveqarne¦q	N	–rup, –rit
umiarsualivi¦k	N	–up, –it
umiarsu¦aq	N	–up, –it
umiarsuarmi¦oq	N	–up, –ut
umiarsua¦rpoq	V	–nngilaq
umiarsuarsi¦orpoq	V	–unngilaq
umiarsuarsu¦aq	N	–up, –it
umiarsuit	N, pl.	-
umiartorajuppoq	V	(no generation)
umiartorfiginninne¦q	N	–rup, –rit
umiar¦torfiginninneq	N	{–sorfiginninnerup, –torfiginninnerup}, {–sorfiginninnerit, –torfiginninnerit}
umiartorfi¦k	N	–up, –it
umiar¦torfik	N	{–sorfiup, –torfiup}, {–sorfiit, –torfiit}
umiartorne¦q	N	–rup, –rit
umiar¦torneq	N	{–sornerup, –tornerup}, {–sornerit, –tornerit}
umiart¦orpoq	V	–unngilaq
umiar¦torpoq	V	{–sunngilaq, –tunngilaq}
umiartort¦oq	N	–up, –ut
umiar¦tortoq	N	{–sortup, –tortup}, {–sortut, –tortut}
umiartortunngorniarne¦q	N	–rup, –rit
umiar¦tortunngorniarneq	N	{–sortunngorniarnerup, –tortunngorniarnerup}, {–sortunngorniarnerit, –tortunngorniarnerit}
umiartuaqattaa¦rpoq	V	–nngilaq
umiat	N, pl.	-
umiat¦ooq	N	–uup, –uut
umiatoorsu¦aq	N	–up, –it
umiatsiaa¦q	N	–p, –t
umiatsiaaqqat	N, pl.	-
umiatsiaa¦raq	N	–qqap, –qqat
umiatsiaarar¦sortoq	N	{–sortup, –tortup}, {–sortut, –tortut}
umiatsiaart¦orpoq	V	–unngilaq
umiatsiaar¦torpoq	V	{–sunngilaq, –tunngilaq}
umiatsiaarussi¦voq	V	–nngilaq
umiatsiaasa¦q	N	–p, –t
umiatsiaasartaanna¦rpoq	V	–nngilaq
umiatsiaasi¦orpoq	V	–unngilaq
umiatsiaa¦siorpoq	V	{–siunngilaq, –tiliunngilaq}
umiatsiaasiorsima¦voq	V	–nngilaq
umiatsiaa¦siorsimavoq	V	{–siorsimanngilaq, –tiliorsimanngilaq}
umiatsiaat	N	–ip, –it
umiatsiaat	N, pl.	-
umiatsialiorne¦q	N	–rup, –rit
umiatsialivi¦k	N	–up, –it
umiatsialivil¦ik	N	{–iup, –lip, –lup}, –lit
umiatsia¦q	N	–ap, –at
umiatsia¦q	N	–p, –t
umiatsiarfi¦k	N	–up, –it
umiatsia¦rpoq	V	–nngilaq
umiatsiarsu¦aq	N	–up, –it
umiatsiat	N, pl.	-
umiffi¦k	N	–up, –it
umigissa¦rpoq	V	–nngilaq
umigi¦ssarpoq	V	–ttanngilaq
umiiangaja¦ppoq	V	–nngilaq
umiiapassi¦ppoq	V	–nngilaq
umiiaqassi¦ppoq	V	–nngilaq
umiiarne¦q	N	–rup, –rit
umiiarniku	N	–p, –t
umiia¦rpaa	V	–nngilaa
umiia¦rpoq	V	–nngilaq
umiiarsima¦voq	V	–nngilaq
umiiffi¦k	N	–up, –it
umii¦orpoq	V	–unngilaq
umiit	N, pl.	-
umiits¦oq	N	–up, –ut
umiivi¦k	N	–up, –it
umii¦vik	N	{–ffiup, –viup}, {–ffiit, –viit}
umii¦voq	V	–nngilaq
umi¦k	N	–up, –it
umimmaa¦raq	N	–qqap, –qqat
umimma¦k	N	–ap, –at
umimmanni¦ppoq	V	–nngilaq
umimma¦ppoq	V	–nngilaq
umimmaqassu¦seq	N	–tsip, –tsit
umimmassu¦aq	N	–up, –it
umimmassunni	N	–p, –t
umimmattassat	N, pl.	-
umimmattassiissutit	N, pl.	-
Umimmatt¦ooq	N	–uup, –uut
Umimmatt¦ooq	Prop	–uup
umimmia¦rpoq	V	–nngilaq
uminaaqisitsi¦voq	V	–nngilaq
uminaaqititsi¦voq	V	–nngilaq
uminaaqi¦voq	V	–nngilaq
uminaa¦rpoq	V	–nngilaq
umingasut	N, pl.	-
uminngatsi¦voq	V	–nngilaq
umi¦ppaa	V	–nngilaa
umi¦ppoq	V	–nngilaq
umissarikkunnaa¦rpoq	V	–nngilaq
umissari¦ppoq	V	–nngilaq
umissarissi¦voq	V	–nngilaq
umita¦q	N	–p, –t
umitsikkaluttuinna¦rpoq	V	–nngilaq
umitsi¦ppoq	V	–nngilaq
umitt¦ooq	N	–uup, –uut
umittoormi¦oq	N	–up, –ut
umittoormiu	N	–p, –t
umittoormiut	N, pl.	-
umittoorsu¦aq	N	–up, –it
umittusi¦voq	V	–nngilaq
umiugaju¦ppoq	V	–nngilaq
umiullu¦innarneq	N	{–aannarnerup, –innarnerup}, {–aannarnerit, –innarnerit}
umiune¦q	N	–rup, –rit
umiungaja¦ppoq	V	–nngilaq
umiusa¦q	N	–p, –t
umiut	N	–ip, –it
umiu¦voq	V	–nngilaq
ummakinnersaa¦voq	V	–nngilaq
ummaki¦ppoq	V	–nngilaq
umma¦ppoq	V	–nngilaq
ummartu¦voq	V	–nngilaq
ummassari¦ppoq	V	–nngilaq
ummassarissi¦voq	V	–nngilaq
ummatt¦oorpoq	V	–uunngilaq
ummiaat	N	–ip, –it
ummiaataa¦voq	V	–nngilaq
ummiaatisi¦voq	V	–nngilaq
ummia¦rpaa	V	–nngilaa
ummia¦rpoq	V	–nngilaq
ummi¦orpoq	V	–unngilaq
ummis¦erpaa	V	–inngilaa
ummiu¦ppaa	V	–tinngilaa
ummiussa¦q	N	–p, –t
ummi¦voq	V	–nngilaq
u¦na	Pron	–uma, –ku
unaali¦orpoq	V	–unngilaq
unaa¦q	N	–p, –t
unaaria¦rpoq	V	–nngilaq
unaarsi¦ppaa	V	–nngilaa
unaarsi¦ppoq	V	–nngilaq
unaarsi¦voq	V	–nngilaq
unaa¦voq	V	–nngilaq
unagaju¦ppoq	V	–nngilaq
unakkuluk	Pron	(no generation)
unall¦erpaa	V	–inngilaa
unall¦erpoq	V	–inngilaq
unammeqataas¦oq	N	–up, –ut
unammeqqinne¦q	N	–rup, –rit
unammersuaarne¦q	N	–rup, –rit
unammersuarne¦q	N	–rup, –rit
unammersuarnerit	N, pl.	-
unammilleqatigiinne¦q	N	–rup, –rit
unammillerfig¦aa	V	–inngilaa
unammillerna¦rpoq	V	–nngilaq
unammillerne¦q	N	–rup, –rit
unammill¦erpoq	V	–inngilaq
unammillersinnaas¦oq	N	–up, –ut
unammillersinnaassu¦seq	N	–tsip, –tsit
unammillerumat¦ooq	N	–uup, –uut
unammilligassa¦q	N	–p, –t
unamminanngilaq	V	(no generation)
unamminaqaaq	V	(no generation)
unammina¦rpoq	V	–nngilaq
unamminart¦oq	N	–up, –ut
unammine¦q	N	–rup, –rit
unammisa¦q	N	–p, –t
unammisaqattaarne¦q	N	–rup, –rit
unammisart¦oq	N	–up, –ut
unammisitsine¦q	N	–rup, –rit
unammis¦oq	N	–up, –ut
unammiuaarne¦q	N	–rup, –rit
unammi¦vaa	V	–nngilaa
unammi¦voq	V	–nngilaq
unannguaq	Pron	(no generation)
unannguaraarsu¦k	N	–up, –it
unanni¦ppoq	V	–nngilaq
unaqut	N	–ip, –it
unarrerfi¦k	N	–up, –it
unarri¦orpoq	V	–unngilaq
unarsivi¦k	N	–up, –it
unasaanna¦rpoq	V	–nngilaq
unasaa¦rpaa	V	–nngilaa
unasa¦rpaa	V	–nngilaa
unasungiaa¦voq	V	–nngilaq
unasungial¦ik	N	{–iup, –lip, –lup}, –lit
unasungi¦aq	N	–ssap, –ssat
unataagaju¦ppoq	V	–nngilaq
unataajumanngilaq	V	(no generation)
unataane¦q	N	–rup, –rit
unataasi¦orpoq	V	–unngilaq
unataa¦siorpoq	V	{–siunngilaq, –tiliunngilaq}
unataasisa¦rpoq	V	–nngilaq
unataat	N	–ip, –it
unataavi¦k	N	–up, –it
unataa¦vik	N	{–ffiup, –viup}, {–ffiit, –viit}
unataa¦voq	V	–nngilaq
unatagaa¦voq	V	–nngilaq
unatarajuppaa	V	(no generation)
unatarne¦q	N	–rup, –rit
unata¦rpaa	V	–nngilaa
unatarti¦ppoq	V	–nngilaq
unat¦ooq	N	–uup, –uut
unatsiaannanng¦orpoq	V	–unngilaq
una¦vaa	V	–nngilaa
una¦voq	V	–nngilaq
uneq	N	ornup, ornit
uneria¦saarpoq	V	{–saanngilaq, –taanngilaq}
uneria¦saartoq	N	{–saartup, –taartup}, {–saartut, –taartut}
uneriffi¦k	N	–up, –it
uneri¦ppoq	V	–nngilaq
unerisimanngilaq	V	(no generation)
unerisimas¦oq	N	–up, –ut
uneris¦imasoq	N	{–imasup, –simasup}, {–imasut, –simasut}
uneris¦imavoq	V	{–imanngilaq, –simanngilaq}
uneris¦imavoq	V	–simanngilaq
unerlers¦oq	N	–up, –ut
unermi¦ppaa	V	–nngilaa
unermi¦ppoq	V	–nngilaq
unermiug¦aa	V	–inngilaa
unerra¦q	N	–p, –t
unerras¦erpaa	V	–inngilaa
unerras¦erpoq	V	–inngilaq
ungaanngu¦aq	N	–up, –it
ungaa¦q	N	–p, –t
ungaart¦orpoq	V	–unngilaq
ungaar¦torpoq	V	{–sunngilaq, –tunngilaq}
ungag¦aa	V	–inngilaa
ungaginninne¦q	N	–rup, –rit
ungagisaa¦voq	V	–nngilaq
ungagisa¦q	N	–p, –t
ungagivi¦ppaa	V	–nngilaa
ungakkiu¦ppaa	V	–tinngilaa
ungal¦eq	N	–ip, –it
ungaler¦aa	V	–inngilaa
ungalianii¦ppoq	V	–nngilaq
ungalisaaru¦ppoq	V	–tinngilaq
ungalisal¦erpaa	V	–inngilaa
ungalisalers¦orpaa	V	–unngilaa
ungalisal¦ik	N	{–iup, –lip, –lup}, –lit
ungali¦saq	N	–tsap, {–sat, –tsat}
ungalisassialers¦orpaa	V	–unngilaa
ungalisassia¦q	N	–p, –t
ungalits¦erpaa	V	–inngilaa
ungalitsers¦orpaa	V	–unngilaa
ungalitsersuine¦q	N	–rup, –rit
ungalitsersuisart¦oq	N	–up, –ut
ungalitsersui¦voq	V	–nngilaq
ungalitsiu¦ppaa	V	–tinngilaa
ungall¦eq	N	–iup, –iit
ungallermii¦ppoq	V	–nngilaq
ungallersaa¦voq	V	–nngilaq
ungalliu¦voq	V	–nngilaq
ungaloorlua¦rpaa	V	–nngilaa
ungal¦oorpaa	V	–uunngilaa
ungaloorsima¦vaa	V	–nngilaa
ungal¦oq	N	{–lup, –up}, {–lut, –ut}
ungaloqut	N	–ip, –it
ungalorsu¦aq	N	–up, –it
ungalu¦aa	V	–nngilaa
ungalul¦erpaa	V	–inngilaa
ungalulersuine¦q	N	–rup, –rit
ungalulersuis¦oq	N	–up, –ut
ungalulersui¦voq	V	–nngilaq
ungalulia¦q	N	–p, –t
ungalul¦ik	N	{–iup, –lip, –lup}, –lit
ungalusaa¦voq	V	–nngilaq
ungalusa¦q	N	–p, –t
ungal¦ut	N, pl.	{–lut, –ut}
ungaluugaaru¦ppoq	V	–tinngilaq
ungaluugaasa¦q	N	–p, –t
ungaluu¦gaq	N	–kkap, –kkat
ungaluus¦erpaa	V	–inngilaa
ungaluu¦serpaa	V	{–sinngilaa, –tilinngilaa}
ungaluut	N	–ip, –it
ungaluutaa¦rpaa	V	–nngilaa
ungana¦rpoq	V	–nngilaq
unganarsi¦voq	V	–nngilaq
unganart¦oq	N	–up, –ut
ungaqqukkiart¦orpaa	V	–unngilaa
ungaqqu¦ppaa	V	{–nngilaa, –tinngilaa}
ungaqqu¦tsivoq	V	{–ssinngilaq, –tsinngilaq}
Ungarnim¦eersoq	N	{–eersup, –eertup, –inngaanneersup, –inngaanneertup}, {–eersut, –eertut, –inngaanneersut, –inngaanneertut}
Ungarnimioq	N	(no generation)
Ungarn¦imiu	N	{–ermiup, –imiup}, {–ermiut, –imiut}
ungasiar¦aa	V	–inngilaa
ungasia¦rpoq	V	–nngilaq
ungasig¦aa	V	–inngilaa
ungasigitsiarpaa	V	(no generation)
ungasikkaluaqaa	V	(no generation)
ungasikkunnaa¦rpoq	V	–nngilaq
ungasilia¦rpoq	V	–nngilaq
ungasilliart¦orpoq	V	–unngilaq
ungasilliartuinnalersima¦voq	V	–nngilaq
ungasilli¦vaa	V	–nngilaa
ungasilli¦voq	V	–nngilaq
ungasinngitsukkut	N, pl.	-
ungasipajaakannerpoq	V	(no generation)
ungasipajaarallarpoq	V	(no generation)
ungasipajaaraluarpoq	V	(no generation)
ungasipajaarpoq	V	(no generation)
ungasipajaarunarpoq	V	(no generation)
ungasi¦ppaa	V	–nngilaa
ungasippallaaqaaq	V	(no generation)
ungasippallaarunnaarpoq	V	(no generation)
ungasi¦ppoq	V	–nngilaq
ungasissu¦seq	N	–tsip, –tsit
ungasivikkunnaarpoq	V	(no generation)
ungasorsu¦aq	N	–up, –it
ungataag¦oorpoq	V	–uunngilaq
ungat¦aagoorpoq	V	{–aaguunngilaq, –aatiguunngilaq, –iatiguunngilaq}
ungataanii¦ppoq	V	–nngilaq
ungataaniitt¦oq	N	–up, –ut
ungatang¦erpaa	V	–inngilaa
ungatangersima¦vaa	V	–nngilaa
ungatangers¦orpaa	V	–unngilaa
ungateqa¦rpoq	V	–nngilaq
ungatermioqa¦rpoq	V	–nngilaq
ungatermiu	N	–p, –t
ungat¦ooq	N	–uup, –uut
ungatt¦orpoq	V	–unngilaq
ungattuu¦ppaa	V	–tinngilaa
ungatuallaaqaaq	V	(no generation)
ungatunersaa¦voq	V	–nngilaq
ungatuunngilaq	V	(no generation)
ungatu¦voq	V	–nngilaq
ungavaria¦rpoq	V	–nngilaq
ungavariart¦orpoq	V	–unngilaq
ungavariartortitsine¦q	N	–rup, –rit
ungava¦rpoq	V	–nngilaq
ungavart¦erpoq	V	–inngilaq
ungavarteru¦ppaa	V	–tinngilaa
unga¦voq	V	–nngilaq
ungdomsklubbi	N	(no generation)
ungerfi¦k	N	–up, –it
ungerlaat	N	–ip, –it
ungerlaat	N, pl.	-
ungerla¦ppaa	V	–nngilaa
ungerlats¦erpaa	V	–inngilaa
ungerlatt¦orpaa	V	–unngilaa
ungerlattuia¦rpaa	V	–nngilaa
ungerlattu¦iarpaa	V	{–ajanngilaa, –ianngilaa}
ungerlattuus¦erpaa	V	–inngilaa
ungerlattuu¦serpaa	V	{–sinngilaa, –tilinngilaa}
ungerlattuut	N	–ip, –it
ungerne¦q	N	–rup, –rit
ung¦erpaa	V	–inngilaa
ung¦erpoq	V	–inngilaq
ungersimane¦q	N	–rup, –rit
ungersi¦ppaa	V	–nngilaa
ungerus¦erpoq	V	–inngilaq
ungeru¦serpoq	V	{–sinngilaq, –tilinngilaq}
ungerussaaja¦rpaa	V	–nngilaa
ungerussaa¦rpaa	V	–nngilaa
ungerut	N	–ip, –it
ungerutaa¦rpaa	V	–nngilaa
ungerutaa¦voq	V	–nngilaq
ungerutissia¦q	N	–p, –t
ungilaarsaa¦rpaa	V	–nngilaa
ungilaarsaa¦rpoq	V	–nngilaq
ungilanna¦rpoq	V	–nngilaq
ungila¦ppoq	V	–nngilaq
ungilaqaaq	V	(no generation)
ungilatsi¦ppaa	V	–nngilaa
ungillerine¦q	N	–rup, –rit
ungilleri¦voq	V	–nngilaq
ungill¦erpoq	V	–inngilaq
ungillersi¦ppaa	V	–nngilaa
ungoorisaanna¦rpoq	V	–nngilaq
ungoorisa¦rpoq	V	–nngilaq
ungooriua¦rpoq	V	–nngilaq
ungoori¦voq	V	–nngilaq
ungoorlua¦rpaa	V	–nngilaa
ung¦oorpaa	V	–uunngilaa
ungoorti¦ppaa	V	–nngilaa
ungu¦aa	V	–nngilaa
ungusaa¦voq	V	–nngilaq
ungusivi¦k	N	–up, –it
ungusi¦voq	V	–nngilaq
unguti¦ppaa	V	–nngilaa
unguugaa¦voq	V	–nngilaq
unguu¦gaq	N	–kkap, –kkat
unguukkat	N, pl.	-
unguukkiu¦ppaa	V	–tinngilaa
uniaalu¦k	N	–up, –it
uniaalunnia¦q	N	–p, –t
uniaa¦q	N	–p, –t
uniaar¦aa	V	–inngilaa
uniaat	N, pl.	-
uniagaaru¦ppoq	V	–tinngilaq
unia¦gaq	N	–kkap, –kkat
uniakalaa¦q	N	–p, –t
uniakalaa¦rpaa	V	–nngilaa
uniakalaa¦rpoq	V	–nngilaq
uniakatta¦rpaa	V	–nngilaa
uniaqattaa¦rpaa	V	–nngilaa
uniarfi¦k	N	–up, –it
unia¦rpaa	V	–nngilaa
unia¦rpoq	V	–nngilaq
uniartig¦aa	V	–inngilaa
uniffeeru¦ppoq	V	–tinngilaq
uniffeqanngits¦oq	N	–up, –ut
uniffig¦aa	V	–inngilaa
uniffi¦k	N	–up, –it
uniffissaaru¦ppoq	V	–tinngilaq
uniffissaasanngueru¦ppoq	V	–tinngilaq
uniffissaasua¦voq	V	–nngilaq
unigg¦oq	N	–up, –ut
uniinnaraluarpoq	V	(no generation)
unikaalla¦ppoq	V	–nngilaq
unikkaajus¦oq	N	–up, –ut
unikkaa¦ppaa	V	–tinngilaa
unikkaa¦q	N	–p, –t
unikkaar¦aa	V	–inngilaa
unikkaarfig¦aa	V	–inngilaa
unikkaarne¦q	N	–rup, –rit
unikkaa¦rpoq	V	–nngilaq
unikkaarsinnaassu¦seq	N	–tsip, –tsit
unikkaarsu¦aq	N	–up, –it
unikkaartaanna¦rpoq	V	–nngilaq
unikkaartuarpoq	V	(no generation)
unikkaarumat¦ooq	N	–uup, –uut
unikkaarut	N	–ip, –it
unikkaarutig¦aa	V	–inngilaa
unikkallarnaviarunanngilaq	V	(no generation)
unikkallassa¦aq	V	–nngilaq
unikk¦erpaa	V	–inngilaa
unikkumajunnaarpoq	V	(no generation)
unikkumajunnaarsinnaavoq	V	(no generation)
unillatsiarne¦q	N	–rup, –rit
uninne¦q	N	–rup, –rit
uninngaanna¦rpoq	V	–nngilaq
uninngaannart¦oq	N	–up, –ut
uninngaarfi¦k	N	–up, –it
uninngaa¦rpoq	V	–nngilaq
uninngaava¦rpoq	V	–nngilaq
uninngaffi¦k	N	–up, –it
uninngajuarpoq	V	(no generation)
uninngallu¦innartoq	N	{–aannartup, –innartup}, {–aannartut, –innartut}
uninngane¦q	N	–rup, –rit
uninnganngilaq	V	(no generation)
uninngaqqissaart¦oq	N	–up, –ut
uninngas¦oq	N	–up, –ut
uninngasuuteqarne¦q	N	–rup, –rit
uninngasuuteqartussaatitaane¦q	N	–rup, –rit
uninngati¦ppaa	V	–nngilaa
uninngatitaas¦oq	N	–up, –ut
uninngatitsigallarne¦q	N	–rup, –rit
uninngatitsine¦q	N	–rup, –rit
uninngatitsi¦voq	V	–nngilaq
uninngavig¦aa	V	–inngilaa
uninngavi¦k	N	–up, –it
uninngavi¦ppoq	V	–nngilaq
uninnga¦voq	V	–nngilaq
uninngilaq	V	(no generation)
unioqqu¦ppaa	V	–tinngilaa
unioqqu¦ppoq	V	–tinngilaq
unioqqutinneqartussaanngits¦oq	N	–up, –ut
unioqqut¦inneqartussaanngitsoq	N	{–inneqartussaanngitsup, –itinneqartussaanngitsup, –sinneqartussaanngitsup}, {–inneqartussaanngitsut, –itinneqartussaanngitsut, –sinneqartussaanngitsut}
unioqquti¦ppaa	V	–nngilaa
unioqqut¦ippaa	V	{–inngilaa, –itinngilaa, –sinngilaa}
unioqqutitassaanngits¦oq	N	–up, –ut
unioqqutitsine¦q	N	–rup, –rit
unioqqutitsis¦oq	N	–up, –ut
uni¦orpaa	V	–unngilaa
uni¦orpoq	V	–unngilaq
uniorsima¦voq	V	–nngilaq
uniortaannarpoq	V	(no generation)
uniorti¦ppaa	V	–nngilaa
uni¦ppoq	V	–nngilaq
unisaa¦rpoq	V	–nngilaq
unisaarutig¦aa	V	–inngilaa
unissa¦rpaa	V	–nngilaa
uniss¦erpoq	V	–inngilaq
unitsiarfi¦k	N	–up, –it
unitsiarne¦q	N	–rup, –rit
unitsikkallarneqa¦rpoq	V	–nngilaq
unitsikkalla¦rpaa	V	–nngilaa
unitsikkallarsimavaa	V	(no generation)
unitsikkallassavaa	V	(no generation)
unitsinneqaralla¦rpoq	V	–nngilaq, –nngilaq
unitsi¦ppaa	V	–nngilaa
unitsita¦q	N	–p, –t
unitsitsiarpaa	V	(no generation)
unitsitsigallarne¦q	N	–rup, –rit
unitsitsine¦q	N	–rup, –rit
unitsitsi¦voq	V	–nngilaq
unittaali¦vaa	V	–nngilaa
unittaat	N	–ip, –it
unittarfi¦k	N	–up, –it
unittariaqalersinnaa¦voq	V	–nngilaq
unittooqqa¦voq	V	–nngilaq
unittoorfiugajussinnaasa¦rpoq	V	–nngilaq
unittoorfiugajussinnaavoq	V	(no generation)
unitt¦oorpoq	V	–uunngilaq
uniuaaginna¦rpoq	V	–nngilaq
uniuaa¦vaa	V	–nngilaa
uniuaa¦voq	V	–nngilaq
uniu¦gaq	N	–kkap, –kkat
uniuine¦q	N	–rup, –rit
uniuinnginne¦q	N	–rup, –rit
uniui¦voq	V	–nngilaq
unius¦erpaa	V	–inngilaa
uniu¦serpaa	V	{–sinngilaa, –tilinngilaa}
unius¦erpoq	V	–inngilaq
uniu¦serpoq	V	{–sinngilaq, –tilinngilaq}
uniusunga¦rpaa	V	–nngilaa
uniut	N	–ip, –it
uniutaa¦voq	V	–nngilaq
uniut¦ooq	N	–uup, –uut
uniutoorsu¦aq	N	–up, –it
uniutuallaaqaaq	V	(no generation)
uniutunersaa¦voq	V	–nngilaq
uniutu¦voq	V	–nngilaq
uniuu¦ppaa	V	–tinngilaa
uniuu¦ppoq	V	–tinngilaq
uniuut	N	–ip, –it
uniuuttuaanna¦rpaa	V	–nngilaa
univiffissaaru¦ppoq	V	–tinngilaq
univiffissaqa¦rpoq	V	–nngilaq
univikkuma¦voq	V	–nngilaq
univikkusu¦ppoq	V	–nngilaq
univillarpoq	V	(no generation)
univi¦ppoq	V	–nngilaq
univissinnaanngilaq	V	(no generation)
univissinnaa¦voq	V	–nngilaq
unnaal¦eeraq	N	{–eeqqap, –iaqqap}, {–eeqqat, –iaqqat}
unnaal¦ik	N	{–iup, –lip, –lup}, –lit
unnaa¦q	N	–p, –t
unnaat	N, pl.	-
unnas¦erpaa	V	–inngilaa
unnas¦erpoq	V	–inngilaq
unne¦q	N	–rup, –rit
unneqqarinne¦q	N	–rup, –rit
unneqqari¦ppoq	V	–nngilaq
unneqqari¦ssoq	N	{–ssup, –ttup}, {–ssut, –ttut}
unneqqarissu¦seq	N	–tsip, –tsit
unneqqarlu¦ppoq	V	–nngilaq
unneqqaserlu¦ppoq	V	–nngilaq
unneqqi¦ppoq	V	–nngilaq
unneqqiserlu¦ppoq	V	–nngilaq
unneraarsuit	N, pl.	-
unneraarsu¦k	N	–up, –it
unneraarsuppalu¦k	N	–up, –it
unnerluffig¦aa	V	–inngilaa
unnerlukkajuppoq	V	(no generation)
unnerlu¦ppoq	V	–nngilaq
unnerlutt¦oq	N	–up, –ut
unnerluu¦ppaa	V	–tinngilaa
unnerluussa¦q	N	–p, –t
unnerluussine¦q	N	–rup, –rit
unnerluussisa¦rpoq	V	–nngilaq
unnerluussis¦oq	N	–up, –ut
unnerluussisussaatitaasut	N, pl.	-
unnerluussisussaatitat	N, pl.	-
unnerluussisuutitaas¦oq	N	–up, –ut
unnerluussisuutitaasut	N, pl.	-
unnerluussi¦voq	V	–nngilaq
unnerluussut	N	–ip, –it
unnerluut	N	–ip, –it
unnerluutaa¦voq	V	–nngilaq
unnerluuteqarne¦q	N	–rup, –rit
unnerluutig¦aa	V	–inngilaa
unnerluutigineqart¦oq	N	–up, –ut
unnerluutiginninne¦q	N	–rup, –rit
unnerluutiginnitt¦oq	N	–up, –ut
unnerluutigisa¦q	N	–p, –t
unnerluutigisassanngortitsine¦q	N	–rup, –rit
unn¦erpaa	V	–inngilaa
unn¦erpoq	V	–inngilaq
unnersiorfig¦aa	V	–inngilaa
unnersi¦orpoq	V	–unngilaq
unnersiortaanna¦rpoq	V	–nngilaq
unnersiut	N	–ip, –it
unnersiutig¦aa	V	–inngilaa
unnersiutigineqarne¦q	N	–rup, –rit
unnersi¦utigineqarneq	N	{–itigineqarnerup, –utigineqarnerup}, {–itigineqarnerit, –utigineqarnerit}
unnersi¦utigineqarneq	N	{–utigineqarnerup, –itigineqarnerup}, {–utigineqarnerit, –itigineqarnerit}
unnersiutiginninne¦q	N	–rup, –rit
unnersiutiginni¦ppoq	V	–nngilaq
unnersiutiginnissut	N	–ip, –it
unnersi¦voq	V	–nngilaq
unnersorfig¦aa	V	–inngilaa
unners¦orpaa	V	–unngilaa
unners¦orpoq	V	–unngilaq
unnersueqqi¦ppoq	V	–nngilaq
unnersuillua¦rpoq	V	–nngilaq
unnersuis¦oq	N	–up, –ut
unnersui¦voq	V	–nngilaq
unnersuullua¦rpaa	V	–nngilaa
unnersuu¦ppaa	V	–tinngilaa
unnersuussa¦q	N	–p, –t
unnersuussine¦q	N	–rup, –rit
unner¦suussineq	N	{–suussinerup, –tuussinerup}, {–suussinerit, –tuussinerit}
unnersuussi¦voq	V	–nngilaq
unner¦suussivoq	V	{–suussinngilaq, –tuussinngilaq}
unnersuussutig¦aa	V	–inngilaa
unnersu¦ussutigaa	V	{–aassutiginngilaa, –ussutiginngilaa}
unner¦suussutigaa	V	{–suussutiginngilaa, –tuussutiginngilaa}
unnersuussutissaanngits¦oq	N	–up, –ut
unnersu¦ussutissaanngitsoq	N	{–aassutissaanngitsup, –ussutissaanngitsup}, {–aassutissaanngitsut, –ussutissaanngitsut}
unner¦suussutissaanngitsoq	N	{–suussutissaanngitsup, –tuussutissaanngitsup}, {–suussutissaanngitsut, –tuussutissaanngitsut}
unnersuut	N	–ip, –it
unner¦suut	N	{–suutip, –tuutip}, {–suutit, –tuutit}
unnersuutaa¦voq	V	–nngilaq
unner¦suutaavoq	V	{–suutaanngilaq, –tuutaanngilaq}
unnersuutig¦aa	V	–inngilaa
unner¦suutigaa	V	{–suutiginngilaa, –tuutiginngilaa}
unnertaa¦rpoq	V	–nngilaq
unnerta¦q	N	–p, –t
unngersa¦q	N	–p, –t
unngersaqa¦rpoq	V	–nngilaq
unngersarsi¦voq	V	–nngilaq
unngiaallaqqi¦ppoq	V	–nngilaq
unngiaaru¦ppoq	V	–tinngilaq
unngiaasart¦oq	N	–up, –ut
unngiaas¦oq	N	–up, –ut
unngiaat	N	–ip, –it
unngiaataaru¦ppoq	V	–tinngilaq
unngiaatisi¦voq	V	–nngilaq
unngiaa¦voq	V	–nngilaq
unngial¦erpaa	V	–inngilaa
unngiali¦ppoq	V	–nngilaq
unngialissi¦voq	V	–nngilaq
unngia¦q	N	–p, –t
unngia¦rpaa	V	–nngilaa
unngia¦rpoq	V	–nngilaq
unngiartaanna¦rpoq	V	–nngilaq
unng¦oq	N	–up, –ut
unng¦orpoq	V	–unngilaq
unngorsu¦aq	N	–up, –it
unngortaa¦rpoq	V	–nngilaq
unngu¦erpaa	V	–inngilaa
unnguersi¦ppoq	V	–nngilaq
unngul¦ik	N	{–iup, –lip, –lup}, –lit
unngulissu¦aq	N	–up, –it
unngul¦issuaq	N	{–ersuup, –issuup}, {–ersuit, –issuit}
unngungasut	N, pl.	-
unnguni¦ppoq	V	–nngilaq
unngunissima¦voq	V	–nngilaq
unngusi¦orpoq	V	–unngilaq
unngu¦siorpoq	V	{–siunngilaq, –tiliunngilaq}
unngussaarne¦q	N	–rup, –rit
unngussaa¦rpoq	V	–nngilaq
unngut	N	–ip, –it
unngut	N, pl.	-
unnguusa¦q	N	–p, –t
unni	Interj	(no generation)
unnia	Interj	(no generation)
unniit	Interj	(no generation)
unnilia¦q	N	–p, –t
unnilisaanna¦rpoq	V	–nngilaq
unnili¦voq	V	–nngilaq
unnit	Interj	(no generation)
unnuaarukkiart¦orpoq	V	–unngilaq
unnuaaru¦ppoq	V	–tinngilaq
unnuaa¦voq	V	–nngilaq
unnuakkut	N, pl.	-
unnua¦q	N	–p, –t
unnuaqeqqa	N	–p, –t
unnuarianngu¦aq	N	–up, –it
unnuarorlua¦rpoq	V	–nngilaq
unnuar¦orpoq	V	–unngilaq
unnuarsiorne¦q	N	–rup, –rit
unnuarsi¦orpoq	V	–unngilaq
unnuarsiortut	N, pl.	-
unnuarsu¦aq	N	–up, –it
unnuaruu¦ppaa	V	–tinngilaa
unnuaruussaa¦voq	V	–nngilaq
unnuaruutivi¦ppaa	V	–nngilaa
unnugia¦q	N	–p, –t
unnugiarsu¦aq	N	–up, –it
unnuiart¦orpoq	V	–unngilaq
unnuiffig¦aa	V	–inngilaa
unnuisi¦ppaa	V	–nngilaa
unnui¦voq	V	–nngilaq
unnu¦k	N	–up, –it
unnukkorsioqatigisa¦q	N	–p, –t
unnukkorsiorne¦q	N	–rup, –rit
unnukkorsi¦orpoq	V	–unngilaq
unnukkorsiut	N	–ip, –it
unnukkorsiutit	N, pl.	-
unnukkumisaa¦q	N	–p, –t
unnukkut	N, pl.	-
unnukkuutaa¦q	N	–p, –t
unnullua¦rpoq	V	–nngilaq
unnu¦ppaa	V	–nngilaa
unnu¦ppoq	V	–nngilaq
unnusaart¦oq	N	–up, –ut
unnussaangajappoq	V	(no generation)
unnussaa¦rpoq	V	–nngilaq
unnussa¦q	N	–p, –t
unnuss¦erpaa	V	–inngilaa
unnuss¦erpoq	V	–inngilaq
unnussii¦vaa	V	–nngilaa
unnuss¦iorpoq	V	{–iunngilaq, –aliunngilaq}
unnussiuaa¦rpoq	V	–nngilaq
unnussiut	N	–ip, –it
unnussi¦voq	V	–nngilaq
unnuu¦ppaa	V	–tinngilaa
unnuuppallaa¦rpaa	V	–nngilaa
unnuuti¦ppaa	V	–nngilaa
unnuut¦ippaa	V	{–itinngilaa, –sinngilaa}
unnuuttoorti¦ppoq	V	–nngilaq
untritileria¦rpoq	V	–nngilaq
untritilik	N	(no generation)
upaa	Interj	(no generation)
upaa¦ppaa	V	–tinngilaa
upaa¦q	N	–p, –t
upaassi¦voq	V	–nngilaq
upaassui¦voq	V	–nngilaq
upaja¦vaa	V	–nngilaa
upaja¦voq	V	–nngilaq
upakatta¦rpoq	V	–nngilaq
upalert¦orpoq	V	–unngilaq
upal¦orpoq	V	–unngilaq
upalungaaqqut	N	–ip, –it
upalungaaqut	N	–ip, –it
upalungaa¦rpaa	V	–nngilaa
upalungaa¦rpoq	V	–nngilaq
upalungaarsaa¦ppaa	V	–tinngilaa
upalungaarsaa¦voq	V	–nngilaq
upalungaarsa¦rpaa	V	–nngilaa
upalungaarsa¦rpoq	V	–nngilaq
upalungaarsimaffi¦k	N	–up, –it
upalungaarsimane¦q	N	–rup, –rit
upalungaarsimasut	N, pl.	-
upalungaarsimasuutitat	N, pl.	-
upalunga¦voq	V	–nngilaq
upanni¦ppoq	V	–nngilaq
upanniut	N	–ip, –it
upanniutaa¦voq	V	–nngilaq
upa¦ppaa	V	–nngilaa
upa¦ppoq	V	–nngilaq
uparuaasinnaatitaane¦q	N	–rup, –rit
uparuaasinnaatitaas¦oq	N	–up, –ut
uparuaasinnaatitaasut	N, pl.	-
uparuannguarsinnarmig¦aa	V	–inngilaa
uparua¦rpaa	V	–nngilaa
uparua¦rpoq	V	–nngilaq
uparuartorniut	N	–ip, –it
uparuart¦orpaa	V	–unngilaa
uparuartuu¦ppaa	V	–tinngilaa
uparuu¦ppaa	V	–tinngilaa
uparuuss¦orpaa	V	–unngilaa
upassaa¦rpaa	V	–nngilaa
upassaa¦rpoq	V	–nngilaq
upassari¦ppoq	V	–nngilaq
upatsigaju¦ppoq	V	–nngilaq
upatsi¦voq	V	–nngilaq
upatt¦orpaa	V	–unngilaa
upatt¦orpoq	V	–unngilaq
upattut	N, pl.	-
upernaakkut	N, pl.	-
upernaanng¦orpoq	V	–unngilaq
upernaa¦ppaa	V	–tinngilaa
upernaa¦q	N	–p, –t
upernaarnisa¦q	N	–p, –t
upernaarni¦saq	N	–tsap, –tsat
upernaarsi¦orpoq	V	–unngilaq
upernaassa¦q	N	–p, –t
upernaatil¦erpaa	V	–inngilaa
upernaa¦voq	V	–nngilaq
upernajaa¦rpoq	V	–nngilaq
upernalaa¦q	N	–p, –t
upernaleqaaq	V	(no generation)
uperna¦rpoq	V	–nngilaq
upernassa¦q	N	–p, –t
Upernaviarsu¦k	N	–up, –it
Upernaviarsu¦k	Prop	–up, –it
Upernavi¦k	N	–up, –it
Upernavi¦k	Prop	–up
upernavi¦k	N	–up, –it
upernavimmi¦oq	N	–up, –ut
uperngaanng¦orpoq	V	–unngilaq
uperngaa¦ppaa	V	–tinngilaa
uperngaarsi¦orpoq	V	–unngilaq
uperngaatil¦erpaa	V	–inngilaa
uperngaa¦voq	V	–nngilaq
uperngajaa¦rpoq	V	–nngilaq
uperngaleqaaq	V	(no generation)
uperngalerne¦q	N	–rup, –rit
upernga¦rpoq	V	–nngilaq
uperngisarfi¦k	N	–up, –it
uperngivig¦aa	V	–inngilaa
uperngi¦voq	V	–nngilaq
uperngugi¦voq	V	–nngilaq
upernisarfi¦k	N	–up, –it
upernivig¦aa	V	–inngilaa
upernivi¦k	N	–up, –it
uperni¦voq	V	–nngilaq
upinne¦q	N	–rup, –rit
upinnersu¦aq	N	–up, –it
upi¦ppaa	V	–nngilaa
upi¦ppoq	V	–nngilaq
upissu¦ppaa	V	–tinngilaa
upissussaa¦voq	V	–nngilaq
upi¦ssussaavoq	V	{–ssussaanngilaq, –ttussaanngilaq}
upissussa¦q	N	–p, –t
upi¦ssussaq	N	{–ssussap, –ttussap}, {–ssussat, –ttussat}
upissussi¦voq	V	–nngilaq
upitt¦oq	N	–up, –ut
upi¦ttoq	N	{–ssup, –ttup}, {–ssut, –ttut}
uppanna¦ppoq	V	–nngilaq
uppassari¦ppoq	V	–nngilaq
uppat	N	–ip, –it
uppataarsissutig¦aa	V	–inngilaa
uppataarsi¦voq	V	–nngilaq
uppatilu¦ppoq	V	–nngilaq
uppatit	N, pl.	-
uppeqatigiit	N, pl.	-
upper¦aa	V	–inngilaa
upperfig¦aa	V	–inngilaa
upperilernavianngilaa	V	(no generation)
upperilersinnaal¦erpaa	V	–inngilaa
upperilersinnaanngilaa	V	(no generation)
upperilinngisaannarpaa	V	(no generation)
upperillu¦innarpaa	V	{–aannanngilaa, –innanngilaa}
upperinngilaa	V	(no generation)
upperinninnginne¦q	N	–rup, –rit
upperisaaru¦ppoq	V	–tinngilaq
upperisaa¦voq	V	–nngilaq
upperisalerine¦q	N	–rup, –rit
upperisapalaa¦q	N	–p, –t
upperisapilu¦k	N	–up, –it
upperisa¦q	N	–p, –t
upperisaqa¦rpoq	V	–nngilaq
upperisarsioqatigiit	N, pl.	-
upperisarsiorne¦q	N	–rup, –rit
upperisarsiortut	N, pl.	-
upperisars¦orpoq	V	–unngilaq
upperisar¦sorpoq	V	{–sunngilaq, –tunngilaq}
upperisassa¦q	N	–p, –t
upperiumaneqarneru¦voq	V	–nngilaq
upperiuminaatsissima¦vaa	V	–nngilaa
upperiunnaa¦rpaa	V	–nngilaa
upperivi¦ppaa	V	–nngilaa
upperluarne¦q	N	–rup, –rit
upperlua¦rpoq	V	–nngilaq
uppernaappoq	V	(no generation)
uppernanngilaq	V	(no generation)
uppernanngilluinnart¦oq	N	–up, –ut
uppernanngits¦oq	N	–up, –ut
uppernanngivippoq	V	(no generation)
uppernaqut	N	–ip, –it
uppernaqut	N, pl.	-
uppernaqutil¦ik	N	{–iup, –lip, –lup}, –lit
uppernaqut¦serpaa	V	{–italinngilaa, –sinngilaa}
uppernaqutsiine¦q	N	–rup, –rit
uppernaqut¦siineq	N	{–italiinerup, –siinerup}, {–italiinerit, –siinerit}
uppernaqutsiis¦oq	N	–up, –ut
uppernaqut¦siisoq	N	{–italiisup, –siisup}, {–italiisut, –siisut}
upperna¦rpoq	V	–nngilaq
uppernarsaane¦q	N	–rup, –rit
uppernarsaapilu¦ppoq	V	–nngilaq
uppernarsaarut	N	–ip, –it
uppernarsaa¦serpaa	V	{–sinngilaa, –tilinngilaa}
uppernarsaasiine¦q	N	–rup, –rit
uppernarsaa¦siineq	N	{–siinerup, –tiliinerup}, {–siinerit, –tiliinerit}
uppernarsaassut	N	–ip, –it
uppernarsaasussaane¦q	N	–rup, –rit
uppernarsaat	N	–ip, –it
uppernarsaataagallart¦oq	N	–up, –ut
uppernarsaataas¦oq	N	–up, –ut
uppernarsaataa¦voq	V	–nngilaq
uppernarsaatissaaru¦ppoq	V	–tinngilaq
uppernarsaatissa¦q	N	–p, –t
uppernarsaa¦voq	V	–nngilaq
uppernarsarneqanngits¦oq	N	–up, –ut
uppernarsa¦rpaa	V	–nngilaa
uppernarsarsinnaanngilaa	V	(no generation)
uppernarsisi¦ppaa	V	–nngilaa
uppernarsi¦sippaa	V	{–sinngilaa, –tinngilaa}
uppernarsi¦vaa	V	–nngilaa
uppernarsivikkaluarpaa	V	(no generation)
uppernart¦oq	N	–up, –ut
uppernassu¦seq	N	–tsip, –tsit
upperne¦q	N	–rup, –rit
uppernerlunne¦q	N	–rup, –rit
uppernerlu¦ppoq	V	–nngilaq
upperniaqatigiit	N, pl.	-
uppernikilli¦voq	V	–nngilaq
upperniki¦ppoq	V	–nngilaq
uppernikitsuu¦voq	V	–nngilaq
upperpallaanngilaq	V	(no generation)
upp¦erpoq	V	–inngilaq
uppersaa¦rpoq	V	–nngilaq
uppersaarut	N	–ip, –it
uppersu¦seq	N	–tsip, –tsit
upperti¦ppaa	V	–nngilaa
uppertitsi¦voq	V	–nngilaq
uppert¦oq	N	–up, –ut
uppertunng¦orpoq	V	–unngilaq
uppertuunngits¦oq	N	–up, –ut
upperusaa¦voq	V	–nngilaq
upperu¦seq	N	–tsip, –tsit
upperusersiortut	N, pl.	-
upperusertaa¦q	N	–p, –t
upperusertaa¦rpoq	V	–nngilaq
upperusili¦orpoq	V	–unngilaq
upperusiliortoqarta¦rpoq	V	–nngilaq
upperusiu¦voq	V	–nngilaq
uppiaalli¦voq	V	–nngilaq
uppiaa¦ppoq	V	–nngilaq
uppiajunnaarfi¦k	N	–up, –it
uppiaraasa¦q	N	–p, –t
upp¦iaraasaq	N	{–eeraasap, –iaraasap}, {–eeraasat, –iaraasat}
uppia¦raq	N	–qqap, –qqat
upp¦iaraq	N	{–eeqqap, –iaqqap}, {–eeqqat, –iaqqat}
uppiara¦rpoq	V	–nngilaq
uppias¦oq	N	–up, –ut
uppiasorsuu¦voq	V	–nngilaq
uppiasorsu¦uvoq	V	{–aanngilaq, –unngilaq}
uppiavallaaqaaq	V	(no generation)
uppia¦voq	V	–nngilaq
uppiffig¦aa	V	–inngilaa
uppiinna¦rpoq	V	–nngilaq
uppi¦k	N	–up, {–it, –ngit}
uppikaa¦ppoq	V	–tinngilaq
uppikaati¦ppaa	V	–nngilaa
uppikaat¦ippaa	V	{–inngilaa, –sinngilaa}
uppikaatt¦oorpoq	V	–uunngilaq
uppikaa¦voq	V	–nngilaq
uppikajanngilaq	V	(no generation)
uppika¦rpoq	V	–nngilaq
uppikart¦oorpoq	V	–uunngilaq
uppikkaluttuarpoq	V	(no generation)
uppikkiart¦orpoq	V	–unngilaq
uppikula¦voq	V	–nngilaq
uppillatuarpoq	V	(no generation)
uppingaa¦rpoq	V	–nngilaq
uppingasorujussuu¦voq	V	–nngilaq
uppingasorujussu¦uvoq	V	{–aanngilaq, –unngilaq}
uppingavi¦ppoq	V	–nngilaq
uppingavoq	V	(no generation)
uppinne¦q	N	–rup, –rit
uppinngersaarpoq	V	(no generation)
uppinnginne¦q	N	–rup, –rit
uppinngits¦oq	N	–up, –ut
uppinngitsuiu¦voq	V	–nngilaq
uppinngitsuu¦voq	V	–nngilaq
Uppinniarfi¦k	N	–up, –it
uppi¦ppoq	V	–nngilaq
uppissu¦aq	N	–up, –it
uppissu¦seq	N	–tsip, –tsit
uppiti¦ppaa	V	–nngilaa
uppi¦ttarneq	N	{–ssarnerup, –ttarnerup}, {–ssarnerit, –ttarnerit}
uppitt¦oorpoq	V	–uunngilaq
uppiui¦ppoq	V	–nngilaq
uppiusa¦q	N	–p, –t
uppus¦erpoq	V	–inngilaq
uppu¦serpoq	V	{–sinngilaq, –tilinngilaq}
uppusi¦orpoq	V	–unngilaq
uppu¦siorpoq	V	{–siunngilaq, –tiliunngilaq}
upput	N	–ip, –it
upputaa¦voq	V	–nngilaq
upputig¦aa	V	–inngilaa
Upputit	N, pl.	-
u¦seq	N	–tsip, –tsit
useqaqaaq	V	(no generation)
useqa¦rpoq	V	–nngilaq
usera¦rpaa	V	–nngilaa
usera¦rpoq	V	–nngilaq
userartaanna¦rpaa	V	–nngilaa
userartua¦voq	V	–nngilaq
us¦erpaa	V	–inngilaa
userpoq	V	(no generation)
userras¦erpoq	V	–inngilaq
usersar¦aa	V	–inngilaa
users¦orpoq	V	–unngilaq
user¦sorpoq	V	{–sunngilaq, –tunngilaq}
usi	N	–p, –t
usiallaqqi¦ppoq	V	–nngilaq
usia¦q	N	–p, –t
usiaqaqaaq	V	(no generation)
usiar¦aa	V	–inngilaa
usia¦rpaa	V	–nngilaa
usia¦rpoq	V	–nngilaq
usiartaanna¦rpoq	V	–nngilaq
usig¦aa	V	–inngilaa
usigiinna¦rpaa	V	–nngilaa
usigiua¦rpaa	V	–nngilaa
usiiffa	Interj	(no generation)
usiima	Interj	(no generation)
usiimma	Interj	(no generation)
usiinna	Interj	(no generation)
usiki¦ppoq	V	–nngilaq
usikka¦rpoq	V	–nngilaq
usikkavi¦ppoq	V	–nngilaq
usil¦erpoq	V	–inngilaq
usilers¦orpaa	V	–unngilaa
usil¦ersorpaa	V	{–ersunngilaa, –lersunngilaa}
usilers¦orpoq	V	–unngilaq
usilersortarfi¦k	N	–up, –it
usil¦ersortarfik	N	{–ersortarfiup, –lersortarfiup}, {–ersortarfiit, –lersortarfiit}
usilersuine¦q	N	–rup, –rit
usil¦ersuineq	N	{–ersuinerup, –lersuinerup}, {–ersuinerit, –lersuinerit}
usilersui¦voq	V	–nngilaq
usil¦ersuivoq	V	{–ersuinngilaq, –lersuinngilaq}
usilersuu¦ppaa	V	–tinngilaa
usiliu¦ppaa	V	–tinngilaa
usill¦erpoq	V	–inngilaq
usil¦lersorpaa	V	{–ersunngilaa, –lersunngilaa}
usillers¦orpoq	V	–unngilaq
usimaanna	Interj	(no generation)
usinga¦voq	V	–nngilaq
using¦erpoq	V	–inngilaq
usingersima¦voq	V	–nngilaq
usingiaane¦q	N	–rup, –rit
usingiaassu¦aq	N	–up, –it
usingiaat	N	–ip, –it
usingiaavi¦k	N	–up, –it
usingiaa¦vik	N	{–ffiup, –viup}, {–ffiit, –viit}
usingiaa¦voq	V	–nngilaq
usingia¦rpaa	V	–nngilaa
usingia¦rpoq	V	–nngilaq
usingiarti¦ppaa	V	–nngilaa
usisaat	N	–ip, –it
usisarfi¦k	N	–up, –it
usisinnaassu¦seq	N	–tsip, –tsit
usiss¦erpaa	V	–inngilaa
usisserpoq	V	(no generation)
usissers¦orpoq	V	–unngilaq
usissersui¦voq	V	–nngilaq
usissiu¦ppaa	V	–tinngilaa
usit	N, pl.	-
usit¦ooq	N	–uup, –uut
usitoorsu¦aq	N	–up, –it
usitussu¦seq	N	–tsip, –tsit
usi¦tussuseq	N	{–tussutsip, –sussutsip}, {–tussutsit, –sussutsit}
usitussuseqart¦oq	N	–up, –ut
usi¦tussuseqartoq	N	{–tussuseqartup, –sussuseqartup}, {–tussuseqartut, –sussuseqartut}
usitu¦voq	V	–nngilaq
usiuffa	Interj	(no generation)
usiusaal¦ik	N	{–iup, –lip, –lup}, –lit
usiusaa¦q	N	–p, –t
usivallaanngilaq	V	(no generation)
usivallaaqaaq	V	(no generation)
usi¦voq	V	–nngilaq
usor¦aa	V	–inngilaa
usoreqqut¦ooq	N	–uup, –uut
usoripajaartaraluarpaa	V	(no generation)
usoripajaartarpaa	V	(no generation)
usorisaa¦voq	V	–nngilaq
usorivi¦ppaa	V	–nngilaa
usornaa¦ppoq	V	–nngilaq
usornaat	N	–ip, –it
usornaataa¦voq	V	–nngilaq
usornaatig¦aa	V	–inngilaa
usornaqaaq	V	(no generation)
usorna¦rpoq	V	–nngilaq
usornarsi¦voq	V	–nngilaq
usornarsu¦seq	N	–tsip, –tsit
usoroornaqaaq	V	(no generation)
usor¦oorpoq	V	–uunngilaq
usoroortitsi¦voq	V	–nngilaq
usorsinna¦rpoq	V	–nngilaq
usorsi¦ppaa	V	–nngilaa
usorsi¦ppoq	V	–nngilaq
usorsisimaa¦rpoq	V	–nngilaq
usorsisimassutig¦aa	V	–inngilaa
usorsis¦imassutigaa	V	{–imassutiginngilaa, –simassutiginngilaa}
usorsisi¦ppaa	V	–nngilaa
usorsitsaa¦rpaa	V	–nngilaa
usorsitsaa¦rpoq	V	–nngilaq
usorsitsaarut	N	–ip, –it
usorsitsaarutig¦aa	V	–inngilaa
usorsitsaat	N	–ip, –it
usorsitsaatig¦aa	V	–inngilaa
usorui¦ppoq	V	–nngilaq
usorukku¦ppaa	V	–tinngilaa
usorukku¦ppoq	V	–nngilaq
usorukkussi¦voq	V	–nngilaq
usoru¦ppoq	V	–nngilaq
usorussuataart¦oq	N	–up, –ut
usorutt¦oq	N	–up, –ut
usoruut	N	–ip, –it
usoruutig¦aa	V	–inngilaa
ussanne¦q	N	–rup, –rit
ussa¦ppaa	V	–nngilaa
ussa¦ppoq	V	–nngilaq
ussarne¦q	N	–rup, –rit
ussarnerpallaaqaaq	V	(no generation)
ussarn¦erpoq	V	–inngilaq
ussarnersorsuu¦voq	V	–nngilaq
ussarnersorsu¦uvoq	V	{–aanngilaq, –unngilaq}
ussarner¦sorsuuvoq	V	{–sorsuaanngilaq, –sorsuunngilaq, –torsuaanngilaq, –torsuunngilaq}
ussarnersu¦aq	N	–up, –it
ussassaari¦voq	V	–nngilaq
ussassaa¦rpaa	V	–nngilaa
ussassaarut	N	–ip, –it
ussassaaruteqarne¦q	N	–rup, –rit
ussassaarutig¦aa	V	–inngilaa
ussassi¦voq	V	–nngilaq
ussat	N	–ip, –it
ussataallua¦rpoq	V	–nngilaq
ussataasima¦voq	V	–nngilaq
ussataa¦voq	V	–nngilaq
ussaters¦orpoq	V	–unngilaq
ussatig¦aa	V	–inngilaa
ussatinnaaju¦voq	V	–nngilaq
ussatinnaa¦q	N	–p, –t
ussatinnaar¦aa	V	–inngilaa
Ussatit	N, pl.	-
ussatt¦oq	N	–up, –ut
ussee¦raq	N	–qqap, –qqat
uss¦eeraq	N	{–eeqqap, –iaqqap}, {–eeqqat, –iaqqat}
usseeraqa¦rpoq	V	–nngilaq
uss¦eeraqarpoq	V	{–eeraqanngilaq, –iaraqanngilaq}
usser¦aaq	V	–inngilaq
usseraa¦voq	V	–nngilaq
usserarfig¦aa	V	–inngilaa
ussera¦rpaa	V	–nngilaa
usserisaa¦voq	V	–nngilaq
usserisa¦q	N	–p, –t
usserisa¦rpoq	V	–nngilaq
usserittaa¦ppoq	V	–nngilaq
usseritta¦rpoq	V	–nngilaq
usserittart¦oq	N	–up, –ut
usseri¦voq	V	–nngilaq
usserna¦rpoq	V	–nngilaq
ussernart¦oq	N	–up, –ut
ussernartorsi¦orpoq	V	–unngilaq
ussernassu¦seq	N	–tsip, –tsit
usserneqarne¦q	N	–rup, –rit
usserneqa¦rpoq	V	–nngilaq
ussernia¦rpaa	V	–nngilaa
uss¦erpaa	V	–inngilaa
uss¦erpoq	V	–inngilaq
ussersaat	N	–ip, –it
usser¦saat	N	{–saatip, –taatip}, {–saatit, –taatit}
ussersaateqa¦rpoq	V	–nngilaq
usser¦saateqarpoq	V	{–saateqanngilaq, –taateqanngilaq}
ussersaa¦vigaa	V	{–ffiginngilaa, –viginngilaa}
ussersaa¦voq	V	–nngilaq
ussersa¦rpaa	V	–nngilaa
ussersorfig¦aa	V	–inngilaa
ussersorne¦q	N	–rup, –rit
ussers¦orpaa	V	–unngilaa
ussers¦orpoq	V	–unngilaq
ussersortuus¦oq	N	–up, –ut
ussersortuu¦voq	V	–nngilaq
ussersuataarne¦q	N	–rup, –rit
ussersuataa¦rpoq	V	–nngilaq
ussersuu¦ppaa	V	–tinngilaa
usser¦suut	N	{–suutip, –tuutip}, {–suutit, –tuutit}
usser¦suutit	N, pl.	{–suutit, –tuutit}
ussertuarpaa	V	(no generation)
usserut	N	–ip, –it
usserutaasa¦q	N	–p, –t
usserutaa¦voq	V	–nngilaq
usserutig¦aa	V	–inngilaa
ussiallaanna¦rpaa	V	–nngilaa
ussiallaanna¦rpoq	V	–nngilaq
ussiara¦q	N	–p, –t
uss¦iaraq	N	{–eeqqap, –iaqqap}, {–eeqqat, –iaqqat}
ussiataari¦voq	V	–nngilaq
ussiataa¦rpaa	V	–nngilaa
ussiataartuarpaa	V	(no generation)
ussigaane¦q	N	–rup, –rit
ussigaasaanna¦rpoq	V	–nngilaq
ussigaasa¦rpoq	V	–nngilaq
ussigaa¦voq	V	–nngilaq
ussiigajuppoq	V	(no generation)
ussiikkunnaa¦rpoq	V	–nngilaq
ussiillaqqi¦ppoq	V	–nngilaq
ussiilli¦voq	V	–nngilaq
ussiine¦q	N	–rup, –rit
ussiiniut	N	–ip, –it
ussii¦ppoq	V	–nngilaq
ussiis¦oq	N	–up, –ut
ussiisorsu¦aq	N	–up, –it
ussii¦voq	V	–nngilaq
ussi¦k	N	–up, –it
ussikkaallua¦rpoq	V	–nngilaq
ussikkaa¦voq	V	–nngilaq
ussikka¦k	N	–p, –t
ussikkassu¦aq	N	–up, –it
ussilluinnanngilaq	V	(no generation)
ussilluinna¦rpoq	V	–nngilaq
ussippaarsu¦aq	N	–up, –it
ussi¦ppoq	V	–nngilaq
ussissaas¦erpaa	V	–inngilaa
ussissaa¦serpaa	V	{–sinngilaa, –tilinngilaa}
ussi¦ssaaserpaa	V	{–ssaasinngilaa, –ssaatilinngilaa, –ttaasinngilaa, –ttaatilinngilaa}
ussissaat	N	–ip, –it
ussi¦ssaat	N	{–ssaatip, –ttaatip}, {–ssaatit, –ttaatit}
ussissaa¦voq	V	–nngilaq
ussissa¦rpaa	V	–nngilaa
ussissi¦voq	V	–nngilaq
ussiu¦ppaa	V	–tinngilaa
ussiut	N	–ip, –it
ussiutaa¦voq	V	–nngilaq
ussua¦raq	N	–qqap, –qqat
ussuara¦rpoq	V	–nngilaq
ussuarne¦q	N	–rup, –rit
ussu¦k	N	–up, –it
ussukul¦ooq	N	–uup, –uut
ussukul¦oorpoq	V	–uunngilaq
ussu¦ppoq	V	–nngilaq
ussussu¦aq	N	–up, –it
ussuttaanna¦rpoq	V	–nngilaq
ussuuserarpoq	V	(no generation)
ussuusi¦orpoq	V	–unngilaq
ussuu¦siorpoq	V	{–siunngilaq, –tiliunngilaq}
usu¦k	N	–up, –it
usuki¦ppoq	V	–nngilaq
usukkaa¦q	N	–p, –t
usunngusa¦q	N	–p, –t
usunngusarta¦rpoq	V	–nngilaq
usutta¦q	N	–p, –t
usutt¦ooq	N	–uup, –uut
usuusaki¦ppoq	V	–nngilaq
usuusa¦q	N	–p, –t
usuusartu¦voq	V	–nngilaq
utaqqerusaa¦rpaa	V	–nngilaa
utaqqerusaa¦rpoq	V	–nngilaq
utaqqikatappoq	V	(no generation)
utaqqikkumanngilaa	V	(no generation)
utaqqil¦oorpaa	V	–uunngilaa
utaqqimaa¦rpaa	V	–nngilaa
utaqqimaa¦rpoq	V	–nngilaq
utaqqina¦rpoq	V	–nngilaq
utaqqine¦q	N	–rup, –rit
utaqqi¦ppaa	V	–nngilaa
utaqqisaannaagallart¦oq	N	–up, –ut
utaqqisaas¦oq	N	–up, –ut
utaqqisaa¦voq	V	–nngilaq
utaqqisa¦q	N	–p, –t
utaqqisarfi¦k	N	–up, –it
utaqqisig¦aa	V	–inngilaa
utaqqi¦sigaa	V	–tiginngilaa
utaqqisinnaassu¦seq	N	–tsip, –tsit
utaqqisinnaa¦voq	V	–nngilaq
utaqqisi¦ppaa	V	–nngilaa
utaqqisitsi¦voq	V	–nngilaq
utaqqis¦oq	N	–up, –ut
utaqqissa¦q	N	–p, –t
utaqqisut	N, pl.	-
utaqqit	N	–ip, –it
utaqqittuarpaa	V	(no generation)
utaqqi¦vaa	V	–nngilaa
utaqqi¦voq	V	–nngilaq
uteqattaariinna¦rpoq	V	–nngilaq
uteqattaari¦voq	V	–nngilaq
uteqattaa¦rpaa	V	–nngilaa
uteqattaa¦rpoq	V	–nngilaq
uteqattaarta¦gaq	N	–kkap, –kkat
uteqattaart¦oq	N	–up, –ut
uteqqia¦ppoq	V	–nngilaq
uteqqiine¦q	N	–rup, –rit
uteqqii¦voq	V	–nngilaq
uteqqinne¦q	N	–rup, –rit
uteqqi¦ppaa	V	–nngilaa
uteqqitt¦oq	N	–up, –ut
uteqqi¦ttoq	N	{–ssup, –ttup}, {–ssut, –ttut}
uteqqu¦aa	V	–nngilaa
utera¦rpoq	V	–nngilaq
uterfig¦aa	V	–inngilaa
uteriarne¦q	N	–rup, –rit
ut¦eriarneq	N	{–eriarnerup, –iperiarnerup}, {–eriarnerit, –iperiarnerit}
uteria¦rpoq	V	–nngilaq
uteriartorne¦q	N	–rup, –rit
uteriart¦orpoq	V	–unngilaq
uteriarumanngilaq	V	(no generation)
uteriilli¦voq	V	–nngilaq
uterii¦ppoq	V	–nngilaq
uteriisaa¦rpoq	V	–nngilaq
uteriis¦erpoq	V	–inngilaq
uteriissu¦seq	N	–tsip, –tsit
uteriits¦oq	N	–up, –ut
uteriitsuu¦voq	V	–nngilaq
uteriittuaanna¦rpoq	V	–nngilaq
uterne¦q	N	–rup, –rit
ut¦erpaa	V	–inngilaa
ut¦erpoq	V	–inngilaq
utersaajallannaqaaq	V	(no generation)
utersaajallannaqis¦oq	N	–up, –ut
utersaa¦rpoq	V	–nngilaq
utersaa¦voq	V	–nngilaq
utersariat	N, pl.	-
utersa¦rpaa	V	–nngilaa
utersa¦rpoq	V	–nngilaq
utersig¦aa	V	–inngilaa
utersiginngilaa	V	(no generation)
utersigisaqanngilaq	V	(no generation)
utersinanngilaq	V	(no generation)
utersina¦rpoq	V	–nngilaq
utertakajaa¦rpaa	V	–nngilaa
utertakajaa¦rpoq	V	–nngilaq
utertakattajaa¦rpoq	V	–nngilaq
utertaqattaa¦rpoq	V	–nngilaq
utertari¦aq	N	{–ssap, –ap}, {–ssat, –at}
utertari¦aq	N	–ssap, –ssat
utertarne¦q	N	–rup, –rit
uterta¦rpaa	V	–nngilaa
uterta¦rpoq	V	–nngilaq
utertinneqaatissa¦q	N	–p, –t
uterti¦ppaa	V	–nngilaa
utertita¦q	N	–p, –t
utertitseqqussut	N	–ip, –it
utertitsine¦q	N	–rup, –rit
utertitsisussaatitaane¦q	N	–rup, –rit
utertitsi¦vigineqarneq	N	{–ffigineqarnerup, –vigineqarnerup}, {–ffigineqarnerit, –vigineqarnerit}
utertitsi¦vigineqarsinnaaneq	N	{–ffigineqarsinnaanerup, –vigineqarsinnaanerup}, {–ffigineqarsinnaanerit, –vigineqarsinnaanerit}
utertitta¦gaq	N	–kkap, –kkat
utertittakkat	N, pl.	-
utertoorut	N	–ip, –it
utert¦oq	N	–up, –ut
utertuarpaa	V	(no generation)
utertua¦rpoq	V	–nngilaq
ut¦ertuartoq	N	{–ertuartup, –ituartup}, {–ertuartut, –ituartut}
utertut	N, pl.	-
utikaffigina¦rpoq	V	–nngilaq
utika¦ppoq	V	–nngilaq
utikatta¦rpoq	V	–nngilaq
utikkajuttart¦oq	N	–up, –ut
ut¦ikkajuttartoq	N	{–erajuttartup, –ikkajuttartup}, {–erajuttartut, –ikkajuttartut}
utimut	Interj	(no generation)
utine¦q	N	–rup, –rit
utinersa¦q	N	–p, –t
utinnikuusaasa¦q	N	–p, –t
utinnikuusa¦q	N	–p, –t
utinnikuusarsi¦voq	V	–nngilaq
uti¦ppaa	V	–nngilaa
utisi¦vaa	V	–nngilaa
utis¦oorpoq	V	–uunngilaq
utiti¦ppaa	V	–nngilaa
utit¦ippaa	V	–sinngilaa
utits¦erpaa	V	–inngilaa
utitsiaa¦voq	V	–nngilaq
utitsia¦q	N	–p, –t
utitsiaqa¦rpoq	V	–nngilaq
utivinngisaannarpoq	V	(no generation)
uti¦voq	V	–nngilaq
utoqqaanerta¦q	N	–p, –t
utoqqaassu¦seq	N	–tsip, –tsit
utoqqaat	N	–ip, –it
utoqqaavallaal¦erpoq	V	–inngilaq
utoqqaavallaanngilaq	V	(no generation)
utoqqaa¦voq	V	–nngilaq
utoqqaliaatsuu¦voq	V	–nngilaq
utoqqaliallassimavoq	V	(no generation)
utoqqaliarsaa¦rpoq	V	–nngilaq
utoqqalinersiaqarne¦q	N	–rup, –rit
utoqqalinersiat	N, pl.	-
utoqqalinersiutil¦ik	N	{–iup, –lip, –lup}, –lit
utoqqalinersiutit	N, pl.	-
utoqqalisima¦voq	V	–nngilaq
utoqqalisi¦ppaa	V	–nngilaa
utoqqalis¦oq	N	–up, –ut
utoqqalivi¦ppoq	V	–nngilaq
utoqqali¦voq	V	–nngilaq
utoqqalla¦k	N	–ap, –at
utoqqangatsi¦ppoq	V	–nngilaq
utoqqangavallaanngilaq	V	(no generation)
utoqqanga¦voq	V	–nngilaq
utoqqa¦q	N	–ap, –at
utoqqaqanngilaq	V	(no generation)
utoqqarluugaju¦ppoq	V	–nngilaq
utoqqarluu¦voq	V	–nngilaq
utoqqarpalla¦ppoq	V	–nngilaq
utoqqarpasi¦ppoq	V	–nngilaq
utoqqarsuanngort¦oq	N	–up, –ut
utoqqarsu¦aq	N	–up, –it
utoqqarta¦q	N	–p, –t
utoqqasaanngu¦aq	N	–up, –it
utoqqasaa¦q	N	–p, –t
utoqqasaa¦rpoq	V	–nngilaq
utoqqasaarsu¦aq	N	–up, –it
utoqqassa¦q	N	–p, –t
utoqqatserajuppoq	V	(no generation)
utoqqatserne¦q	N	–rup, –rit
utoqqats¦erpoq	V	–inngilaq
utoqqatsia¦q	N	–ap, –at
utoqqatsinaqaaq	V	(no generation)
utoqqatsissut	N	–ip, –it
utoqqatsissuteqarne¦q	N	–rup, –rit
utoqqatsissutig¦aa	V	–inngilaa
utoqqatsivig¦aa	V	–inngilaa
utoqqatsi¦voq	V	–nngilaq
utoqqinga¦voq	V	–nngilaq
utsera¦rpaa	V	–nngilaa
utsera¦rpoq	V	–nngilaq
utserarti¦ppoq	V	–nngilaq
utsers¦ooq	N	–uup, –uut
utsersoorsu¦aq	N	–up, –it
utsersorfig¦aa	V	–inngilaa
utsersorne¦q	N	–rup, –rit
utsers¦orpoq	V	–unngilaq
utsersorti¦ppaa	V	–nngilaa
utsersortua¦rpoq	V	–nngilaq
utsersuu¦ppaa	V	–tinngilaa
utsersu¦voq	V	–nngilaq
utsikilli¦orpoq	V	–unngilaq
utsiki¦ppoq	V	–nngilaq
utsi¦ppaa	V	–nngilaa
utsissiuma¦voq	V	–nngilaq
utsissi¦voq	V	–nngilaq
utsiu¦ppaa	V	–tinngilaa
utsiveeru¦ppoq	V	–tinngilaq
utsiveerutingaja¦ppoq	V	–nngilaq
utsiviivi¦ppoq	V	–nngilaq
utsivi¦k	N	–up, –it
utsiviki¦ppoq	V	–nngilaq
utsoqulaa¦q	N	–p, –t
utsuit	N, pl.	-
utsu¦k	N	–up, –it
utsuppalu¦aq	N	–ssap, –ssat
utsuppalu¦gaq	N	–kkap, –kkat
utsuut	N	–ip, –it
uttoqi¦ppoq	V	–nngilaq
utugga	N	–p, –t
uua¦q	N	–p, –t
uuara¦rpoq	V	–nngilaq
uuararti¦ppaa	V	–nngilaa
uuarnia¦rpoq	V	–nngilaq
uuarsiut	N	–ip, –it
uuart¦orpoq	V	–unngilaq
uuar¦torpoq	V	{–sunngilaq, –tunngilaq}
uu¦eq	N	–ip, –it
uuers¦ooq	N	–uup, –uut
uuersu¦voq	V	–nngilaq
uu¦gaq	N	–kkap, –kkat
uugarnia¦rpoq	V	–nngilaq
uugarsiut	N	–ip, –it
uugart¦orpoq	V	–unngilaq
uugar¦torpoq	V	{–sunngilaq, –tunngilaq}
uug¦eq	N	–ip, –it
uug¦ooq	N	–uup, –uut
uui	N	–p, –t
uuig¦aa	V	–inngilaa
uuila¦q	N	–p, –t
uuilart¦orpaa	V	–unngilaa
uuilart¦orpoq	V	–unngilaq
uuilar¦torpoq	V	{–sunngilaq, –tunngilaq}
uuinna¦gaq	N	–kkap, –kkat
uu¦innagaq	N	{–ginnakkap, –innakkap}, {–ginnakkat, –innakkat}
uuj	Interj	(no generation)
uujasut	N, pl.	-
uuja¦voq	V	–nngilaq
uu¦javoq	V	{–janngilaq, –tianngilaq}
uujornu¦voq	V	–nngilaq
uujungujoort¦orpoq	V	–unngilaq
uukapaati¦ppaa	V	–nngilaa
uukapaatitsigajutt¦oq	N	–up, –ut
uukapaatitsine¦q	N	–rup, –rit
uukapaatitsis¦oq	N	–up, –ut
uukapaatitsi¦voq	V	–nngilaq
uukapa¦k	N	–ap, –at
uukassa¦ppoq	V	–nngilaq
uukkaakkiart¦orpoq	V	–unngilaq
uukkaa¦ppaa	V	–tinngilaa
uukkaa¦ppoq	V	–tinngilaq
uukkaass¦orpoq	V	–unngilaq
uukkaasuinnaa¦voq	V	–nngilaq
uukkaa¦suinnaavoq	V	{–jusuinnaanngilaq, –suinnaanngilaq}
uukkaasutoqaa¦voq	V	–nngilaq
uukkaa¦sutoqaavoq	V	{–jusutoqaanngilaq, –sutoqaanngilaq}
uukkaati¦ppaa	V	–nngilaa
uukkaat¦ippaa	V	{–inngilaa, –sinngilaa, –itinngilaa}
uukkaa¦tippaa	V	{–jutinngilaa, –tinngilaa}
uukkaatt¦oorpoq	V	–uunngilaq
uukkaa¦voq	V	{–junngilaq, –nngilaq}
uukkaa¦voq	V	–nngilaq
uukkarne¦q	N	–rup, –rit
uukka¦rpaa	V	–nngilaa
uukkarpalla¦ppoq	V	–nngilaq
uukka¦rpallappoq	V	{–pallanngilaq, –rpallanngilaq}
uukka¦rpoq	V	–nngilaq
uukkart¦oorpoq	V	–uunngilaq
uukkartua¦rpoq	V	–nngilaq
uukki¦orpoq	V	–unngilaq
uukkumaarnert¦ooq	N	–uup, –uut
uulaartitsi¦voq	V	–nngilaq
uul¦erpoq	V	–inngilaq
uu¦lerpoq	V	{–linngilaq, –tilinngilaq}
uulia	N	–p, –t
uuliaarluerne¦q	N	–rup, –rit
uuliaasivi¦k	N	–up, –it
uuliakoorfi¦k	N	–up, –it
uuliakoorne¦q	N	–rup, –rit
uuliakoorut	N	–ip, –it
uuliak¦oq	N	–up, –ut
uuliaqut	N	–ip, –it
uuliasioqatigiiffi¦k	N	–up, –it
uuliasioqatigiit	N, pl.	-
uuliasiorfi¦k	N	–up, –it
uuliasiorne¦q	N	–rup, –rit
uuliasi¦orpoq	V	–unngilaq
uuliasiortit¦seqatigiit	N, pl.	{–seqatigiit, –eqatigiit}
uuliasi¦voq	V	–nngilaq
uuliat¦erpaa	V	–inngilaa
uuliaterut	N	–ip, –it
uulikulaa¦rpoq	V	–nngilaq
uulikulaartuinnaa¦voq	V	–nngilaq
uulikullaa¦ppaa	V	–tinngilaa
uulikullaativi¦ppaa	V	–nngilaa
uulikulla¦ppoq	V	–nngilaq
uulikullatsi¦ppaa	V	–nngilaa
uulikullatta¦rpoq	V	–nngilaq
uulikussuu¦ppaa	V	–tinngilaa
uulikussuussi¦voq	V	–nngilaq
uulinerne¦q	N	–rup, –rit
uulin¦erpaa	V	–inngilaa
uulin¦erpoq	V	–inngilaq
uulinersimas¦oq	N	–up, –ut
uulinersima¦voq	V	–nngilaq
uulinersi¦ppaa	V	–nngilaa
uuliner¦sippaa	V	{–sinngilaa, –tinngilaa}
uulinerti¦ppaa	V	–nngilaa
uuliner¦tippaa	V	{–tinngilaa, –sinngilaa}
uulinert¦oq	N	–up, –ut
uuliner¦toq	N	{–sup, –tup}, {–sut, –tut}
uulinil¦erpaa	V	–inngilaa
uulinne¦q	N	–rup, –rit
uuli¦ppoq	V	–nngilaq
uulissut	N	–ip, –it
uuli¦ssut	N, pl.	{–ssut, –ttut}
uulissutig¦aa	V	–inngilaa
uulittorujussuu¦voq	V	–nngilaq
uulittorujussu¦uvoq	V	{–aanngilaq, –unngilaq}
uuli¦ttorujussuuvoq	V	{–ssorujussuaanngilaq, –ssorujussuunngilaq, –ttorujussuaanngilaq, –ttorujussuunngilaq}
uull¦erpaa	V	–inngilaa
uullers¦orpaa	V	–unngilaa
uullersui¦voq	V	–nngilaq
uulliaaru¦ppoq	V	–tinngilaq
uulli¦aq	N	–ssap, –ssat
uulliaqa¦rpoq	V	–nngilaq
uulliarsu¦aq	N	–up, –it
uullillaqqi¦ppoq	V	–nngilaq
uullissiu¦ppaa	V	–tinngilaa
uullissu¦ppaa	V	–tinngilaa
uullisuu¦voq	V	–nngilaq
uulliu¦ppaa	V	–tinngilaa
uulli¦vaa	V	–nngilaa
uulli¦voq	V	–nngilaq
uullua¦rpaa	V	–nngilaa
uulluarsimanngilaq	V	(no generation)
uulluarsima¦vaa	V	–nngilaa
uulluarsima¦voq	V	–nngilaq
uullus¦erpoq	V	–inngilaq
uullu¦serpoq	V	{–sinngilaq, –tilinngilaq}
uullut	N	–ip, –it
uullutig¦aa	V	–inngilaa
uullutissaanngilaq	V	(no generation)
uumaaluttaa¦rpoq	V	–nngilaq
uumaannarniarfi¦k	N	–up, –it
uumaats¦oq	N	–up, –ut
uumaatsulerine¦q	N	–rup, –rit
uumanart¦oq	N	–up, –ut
uumanertu¦voq	V	–nngilaq
uumanikits¦oq	N	–up, –ut
uumaqqi¦ppoq	V	–nngilaq
uumariilli¦voq	V	–nngilaq
uumarii¦ppoq	V	–nngilaq
uumariits¦oq	N	–up, –ut
uumariitsunng¦orpoq	V	–unngilaq
uumarisaa¦rpoq	V	–nngilaq
uumari¦sooq	N	{–suup, –tuup}, {–suut, –tuut}
uumarivi¦ppoq	V	–nngilaq
uumari¦voq	V	–nngilaq
uumas¦oorpaa	V	–uunngilaa
uumas¦oq	N	–up, –ut
uumasoqarfi¦k	N	–up, –it
uumasoqassu¦seq	N	–tsip, –tsit
uumasorsi¦ooq	N	–uup, –uut
uumasorsi¦orpoq	V	–unngilaq
uumasorsu¦aq	N	–up, –it
uumasoruju¦k	N	–up, –it
uumassu¦seq	N	–tsip, –tsit
uumassuseqartulerine¦q	N	–rup, –rit
uumassuseqartuleris¦oq	N	–up, –ut
uumassusilerine¦q	N	–rup, –rit
uumassusilerit¦ooq	N	–uup, –uut
uumassusilinn¦eersoq	N	{–eersup, –eertup, –inngaanneersup, –inngaanneertup}, {–eersut, –eertut, –inngaanneersut, –inngaanneertut}
uumassut	N	–ip, –it
uumassutaa¦voq	V	–nngilaq
uumassutig¦aa	V	–inngilaa
uumasuaqqat	N, pl.	-
uumasua¦raq	N	–qqap, –qqat
uumasuarsu¦k	N	–up, –it
uumasun¦eersoq	N	{–eersup, –eertup, –inngaanneersup, –inngaanneertup}, {–eersut, –eertut, –inngaanneersut, –inngaanneertut}
uumasuni¦ppoq	V	–nngilaq
uumasupilu¦k	N	–up, –it
uumasupilussu¦aq	N	–up, –it
uumasut	N, pl.	-
uumasuusivi¦k	N	–up, –it
uumasuusivissu¦aq	N	–up, –it
uumasuut	N	–ip, –it
uumasuuteqarne¦q	N	–rup, –rit
uumasuuteqa¦rpoq	V	–nngilaq
uumasuutil¦ik	N	{–iup, –lip, –lup}, –lit
uumasuutit	N, pl.	-
uumati¦ppaa	V	–nngilaa
uuma¦voq	V	–nngilaq
uumig¦aa	V	–inngilaa
uumigisa¦q	N	–p, –t
uumilaa¦rpoq	V	–nngilaq
uumilaasa¦rpoq	V	–nngilaq
uumilakulu¦ppoq	V	–nngilaq
uumilana¦rpoq	V	–nngilaq
uumila¦voq	V	–nngilaq
uumilla¦ppoq	V	–nngilaq
uumillassimaannal¦erpoq	V	–inngilaq
uumill¦erpoq	V	–inngilaq
uumillersorujussuu¦voq	V	–nngilaq
uumillersorujussu¦uvoq	V	{–aanngilaq, –unngilaq}
uumiller¦sorujussuuvoq	V	{–sorujussuaanngilaq, –sorujussuunngilaq, –torujussuaanngilaq, –torujussuunngilaq}
uumilliu¦ppaa	V	–tinngilaa
uuminakasi¦k	N	–up, –it
uuminaqaaq	V	(no generation)
uumina¦rpoq	V	–nngilaq
uuminarsi¦voq	V	–nngilaq
uuminart¦oq	N	–up, –ut
uuminartuliorne¦q	N	–rup, –rit
uuminassu¦seq	N	–tsip, –tsit
uuminavi¦ppoq	V	–nngilaq
uumisaarfig¦aa	V	–inngilaa
uu¦misaarfigaa	V	{–misaarfiginngilaa, –timisaarfiginngilaa}
uumisaarine¦q	N	–rup, –rit
uumisaari¦voq	V	–nngilaq
uumisaa¦rpaa	V	–nngilaa
uumisaa¦rpoq	V	–nngilaq
uumiss¦orpaa	V	–unngilaa
uumissuine¦q	N	–rup, –rit
uumissuis¦oq	N	–up, –ut
uumissui¦voq	V	–nngilaq
uumisu¦ppoq	V	–nngilaq
uumisutt¦oq	N	–up, –ut
uumitsaa¦ppaa	V	–tinngilaa
uumitsangaarne¦q	N	–rup, –rit
uumitsannart¦oq	N	–up, –ut
uumitsanne¦q	N	–rup, –rit
uumitsa¦ppoq	V	–nngilaq
uumitsassima¦voq	V	–nngilaq
uumitsatsi¦ppaa	V	–nngilaa
uumitsatsitsine¦q	N	–rup, –rit
uumitsatt¦oq	N	–up, –ut
uummaallaatigaa	V	(no generation)
uummaallappoq	V	(no generation)
uummaallatsi¦ppaa	V	–nngilaa
uummaallua¦rpoq	V	–nngilaq
uummaari¦ppoq	V	–nngilaq
uummaariss¦oq	N	–up, –ut
uummaari¦ssoq	N	{–ssup, –ttup}, {–ssut, –ttut}
uummaas¦oq	N	–up, –ut
uummaa¦voq	V	–nngilaq
uummalli¦orpoq	V	–unngilaq
uummallunne¦q	N	–rup, –rit
uummammioqa¦rpoq	V	–nngilaq
uummammiu	N	–p, –t
uummammiug¦aa	V	–inngilaa
uummammiuginngilaa	V	(no generation)
uummammiugisa¦q	N	–p, –t
uummammiuliu¦ppaa	V	–tinngilaa
uummammiussarsi¦voq	V	–nngilaq
uummammiuts¦erpoq	V	–inngilaq
uummannaarsu¦k	N	–up, –it
uummannaarsussu¦aq	N	–up, –it
uummannaasa¦q	N	–p, –t
uummannanga¦voq	V	–nngilaq
Uummanna¦q	N	–p, –t
Uummanna¦q	Prop	–p
uummanna¦q	N	–p, –t
uummannarmiu	N	–p, –t
Uummannarsu¦aq	N	–up, –it
Uummannarsu¦aq	Prop	–up, –it
uummannart¦ooq	N	–uup, –uut
uummannatsia¦q	N	–ap, –at
uummannatsiarmiu	N	–p, –t
uumma¦q	N	–ap, –at
uummaqqissa¦rpaa	V	–nngilaa
uummaqqi¦ssippaa	V	{–ssinngilaa, –tsinngilaa}
uummarillua¦rpoq	V	–nngilaq
uummarippallaaqaaq	V	(no generation)
uummari¦ppoq	V	–nngilaq
uummarissaa¦rpoq	V	–nngilaq
uummarissi¦voq	V	–nngilaq
uummarivi¦ppoq	V	–nngilaq
uummarlu¦ppoq	V	–nngilaq
uummarna¦rpoq	V	–nngilaq
uumma¦rpoq	V	–nngilaq
uummarsaane¦q	N	–rup, –rit
uummarsaa¦voq	V	–nngilaq
uummarsa¦rpaa	V	–nngilaa
uummarti¦ppaa	V	–nngilaa
uummartitsi¦voq	V	–nngilaq
uummart¦ooq	N	–uup, –uut
uummartoorsu¦aq	N	–up, –it
uummartu¦voq	V	–nngilaq
uummaserine¦q	N	–rup, –rit
uumma¦serineq	N	{–serinerup, –tilerinerup}, {–serinerit, –tilerinerit}
uummaserisaanna¦rpoq	V	–nngilaq
uumma¦serisaannarpoq	V	{–serisaannanngilaq, –tilerisaannanngilaq}
uummaseritsia¦rpoq	V	–nngilaq
uummaseri¦voq	V	–nngilaq
uumma¦serivoq	V	{–serinngilaq, –tilerinngilaq}
uummat	N	–ip, –it
uummataasaaqqat	N, pl.	-
uummataasalia¦q	N	–p, –t
uummataasali¦orpoq	V	–unngilaq
uummataasa¦q	N	–p, –t
uummataasarsu¦aq	N	–up, –it
uummataasi¦orpoq	V	–unngilaq
uummataa¦siorpoq	V	{–siunngilaq, –tiliunngilaq}
uummataasiorsinnaa¦voq	V	–nngilaq
uummataa¦siorsinnaavoq	V	{–siorsinnaanngilaq, –tiliorsinnaanngilaq}
uummateqanngits¦oq	N	–up, –ut
uummatigi¦ppoq	V	–nngilaq
uummatigi¦ssaat	N	{–ssaatip, –ttaatip}, {–ssaatit, –ttaatit}
uummatigissuunngilaq	V	(no generation)
uummatilukkajuppoq	V	(no generation)
uummatilu¦ppoq	V	–nngilaq
uummatiluttaanna¦rpoq	V	–nngilaq
uunaannaa¦voq	V	–nngilaq
uunaannavippoq	V	(no generation)
uunaannavi¦ssoq	N	{–ssup, –ttup}, {–ssut, –ttut}
uunaannaviu¦voq	V	–nngilaq
uunalaarpoq	V	(no generation)
uunaqaaq	V	(no generation)
uuna¦rpoq	V	–nngilaq
uunarsi¦voq	V	–nngilaq
Uunart¦eq	Prop	–ip
Uunart¦oq	N	–up, –ut
Uunart¦oq	Prop	–up
uunart¦oq	N	–up, –ut
uunartorsu¦uvoq	V	{–aanngilaq, –unngilaq}
uunartorujussu¦aq	N	–up, –it
uunartuli¦voq	V	–nngilaq
uune¦q	N	–rup, –rit
uuneqanngilaq	V	(no generation)
uuneqa¦rpoq	V	–nngilaq
uunersiut	N	–ip, –it
uunersu¦aq	N	–up, –it
uungaanna¦q	N	–ap, –at
uungaanna¦q	N	–p, –t
uu¦ngaannaq	N	{–ngaannap, –tingaannap}, {–ngaannat, –tingaannat}
uungatsia¦rpoq	V	–nngilaq
uunnaari¦ppoq	V	–nngilaq
uunnaasartuu¦voq	V	–nngilaq
uunnaavee¦raq	N	–qqap, –qqat
uunnaav¦eeraq	N	{–eeqqap, –iaqqap}, {–eeqqat, –iaqqat}
uunnaaveerarsi¦voq	V	–nngilaq
uunnaav¦eerarsivoq	V	{–eerarsinngilaq, –iararsinngilaq}
uunnaavi¦k	N	–up, –it
uunnaavissi¦voq	V	–nngilaq
uunnaavissu¦aq	N	–up, –it
uunnaavittaa¦rpoq	V	–nngilaq
uunnaa¦voq	V	–nngilaq
uunnagaa¦voq	V	–nngilaq
uunna¦gaq	N	–kkap, –kkat
uunna¦ppaa	V	–nngilaa
uunna¦ppoq	V	–nngilaq
uunnaqqi¦gaq	N	–kkap, –kkat
uunnaqqii¦voq	V	–nngilaq
uunnassaa¦rpoq	V	–nngilaq
uunnassaasi¦orpoq	V	–unngilaq
uunnassaa¦siorpoq	V	{–siunngilaq, –tiliunngilaq}
uunnassaat	N	–ip, –it
uunnassaatissa¦q	N	–p, –t
uunnassa¦rpoq	V	–nngilaq
uunnass¦erpoq	V	–inngilaq
uunnassinnaanngilaq	V	(no generation)
uunneqanngits¦oq	N	–up, –ut
uunneqarne¦q	N	–rup, –rit
uunneqa¦rpoq	V	–nngilaq
uunneqarsinnaas¦oq	N	–up, –ut
uu¦ppaa	V	–nngilaa
uu¦ppoq	V	{–nngilaq, –tinngilaq}
uusaqqaatig¦aa	V	–inngilaa
uusaqqaatiginngilaa	V	(no generation)
uusaqqanna¦rpoq	V	–nngilaq
uusaqqa¦ppoq	V	–nngilaq
uusaqqarpoq	V	(no generation)
uusima¦voq	V	–nngilaq
uus¦oq	N	–up, –ut
uusort¦orpoq	V	–unngilaq
uusor¦torpoq	V	{–sunngilaq, –tunngilaq}
uussutig¦aa	V	–inngilaa
uussutigisinnaa¦vaa	V	–nngilaa
uusulia¦q	N	–p, –t
uusuli¦orpoq	V	–unngilaq
uusuliortaanna¦rpoq	V	–nngilaq
uutaliorajuppoq	V	(no generation)
uutali¦orpoq	V	–unngilaq
uuta¦q	N	–p, –t
uuta¦rpaa	V	–nngilaa
uutart¦orpoq	V	–unngilaq
uutar¦torpoq	V	{–sunngilaq, –tunngilaq}
uutassarsi¦voq	V	–nngilaq
uutassat	N, pl.	-
uuterine¦q	N	–rup, –rit
uuteris¦oq	N	–up, –ut
uuterivi¦k	N	–up, –it
uuteri¦voq	V	–nngilaq
uut¦erpaa	V	–inngilaa
uuti¦gaq	N	–kkap, –kkat
uut¦igaq	N	{–ikkap, –sikkap}, {–ikkat, –sikkat}
uutikkiorfi¦k	N	–up, –it
uutikki¦orpoq	V	–unngilaq
uutinnaveersaarpaa	V	(no generation)
uuti¦ppaa	V	–nngilaa
uut¦ippaa	V	{–inngilaa, –sinngilaa}
uut¦ippoq	V	–sinngilaq
uutitsi¦voq	V	–nngilaq
uut¦itsivoq	V	{–itsinngilaq, –sitsinngilaq}
uutseriilli¦orpoq	V	–unngilaq
uutserii¦ppoq	V	–nngilaq
uutsers¦ooq	N	–uup, –uut
uutsiia¦q	N	–p, –t
uutsiiaqa¦rpoq	V	–nngilaq
uutsiiarfig¦aa	V	–inngilaa
uutsi¦iarfigaa	V	{–ajarfiginngilaa, –iarfiginngilaa}
uutsiia¦rpoq	V	–nngilaq
uutsiiarumatoqaaq	V	(no generation)
uutsisaanna¦rpoq	V	–nngilaq
uutsiuaanna¦rpoq	V	–nngilaq
uutsivi¦k	N	–up, –it
uutsi¦vik	N	{–ffiup, –viup}, {–ffiit, –viit}
uutsi¦voq	V	–nngilaq
uuttaavi¦k	N	–up, –it
uuttaa¦voq	V	–nngilaq
uutt¦oq	N	–up, –ut
uuttorfig¦aa	V	–inngilaa
uuttorneqa¦rpoq	V	–nngilaq
uuttornia¦q	N	–p, –t
uuttornia¦rpoq	V	–nngilaq
uutt¦orpaa	V	–unngilaa
uuttortaane¦q	N	–rup, –rit
uuttortaariaa¦seq	N	–tsip, –tsit
uuttortaasarfi¦k	N	–up, –it
uuttortaas¦oq	N	–up, –ut
uuttortaat	N	–ip, –it
uuttortaat	N, pl.	-
uuttortaa¦voq	V	–nngilaq
uuttorta¦rpaa	V	–nngilaa
uuttualaa¦rpaa	V	–nngilaa
uuttualaarsar¦aa	V	–inngilaa
uuttugaa¦voq	V	–nngilaq
uuttu¦gaq	N	–kkap, –kkat
uuttugassa¦q	N	–p, –t
uuttuiffig¦aa	V	–inngilaa
uu¦ttuiffigaa	V	{–juiffiginngilaa, –ttuiffiginngilaa}
uuttuillua¦rpoq	V	–nngilaq
uuttuine¦q	N	–rup, –rit
uuttuisartuu¦voq	V	–nngilaq
uuttui¦voq	V	–nngilaq
uuttuu¦ppaa	V	–tinngilaa
uuttuussaa¦voq	V	–nngilaq
uuttuussi¦voq	V	–nngilaq
uuttuut	N	–ip, –it
uuttuutaa¦voq	V	–nngilaq
uuttuutig¦aa	V	–inngilaa
uuttuutit	N, pl.	-
uutu¦erpoq	V	–inngilaq
uutueru¦ppoq	V	–tinngilaq
uutuerutivi¦ppoq	V	–nngilaq
uutuia¦rpaa	V	–nngilaa
uutu¦k	N	–up, –it
uutuni¦ppoq	V	–nngilaq
uu¦voq	V	–nngilaq
