Lexeme	WC	Flexion
qaa	Interj	(no generation)
qaagippoq	V	(no generation)
qaagissuuvoq	V	(no generation)
qaajanngujuippoq	V	(no generation)
qaajanngunaqaaq	V	(no generation)
qaajannguvoq	V	(no generation)
qaajarsaarpalutt¦oq	N	–up, –ut
qaajarsaavoq	V	(no generation)
qaajas¦oq	N	–up, –ut
qaajavoq	V	(no generation)
qaajoraa	V	(no generation)
qaajornaqaaq	V	(no generation)
qaajornarpoq	V	(no generation)
qaajorpoq	V	(no generation)
qaajujuippoq	V	(no generation)
qaajumaamivoq	V	(no generation)
qaajut¦ooq	N	–uup, –uut
qaajutoorsu¦aq	N	–up, –it
qaajutoqaa¦q	N	–p, –t
qaajuttorpoq	V	(no generation)
qaajutuvoq	V	(no generation)
qaa¦k	N	–ap, –vit
qaakippoq	V	(no generation)
qaakisaarpoq	V	(no generation)
qaalerne¦q	N	–rup, –rit
qaalerpoq	V	(no generation)
qaalersorpaa	V	(no generation)
qaalersu¦gaq	N	–kkap, –kkat
qaalersuivoq	V	(no generation)
qaalertagaa	V	(no generation)
qaalertanarpoq	V	(no generation)
qaalertavoq	V	(no generation)
qaaliuppaa	V	(no generation)
qaalivippoq	V	(no generation)
qaalligaarpoq	V	(no generation)
qaallippoq	V	(no generation)
qaalloorpaa	V	(no generation)
qaalloortippoq	V	(no generation)
qaalloqquserpaa	V	(no generation)
qaalloqqusersorpaa	V	(no generation)
qaalloqqut	N	–ip, –it
qaallori¦k	N	–up, –it
qaallorilluinnarpoq	V	(no generation)
qaallorippoq	V	(no generation)
qaallorissivoq	V	(no generation)
qaallorissu¦seq	N	–tsip, –tsit
qaallorivi¦k	N	–up, –it
qaallorpoq	V	(no generation)
qaallorsarpoq	V	(no generation)
qaallualaa¦q	N	–p, –t
qaallualaarpoq	V	(no generation)
qaalluarpalu¦k	N	–up, –it
qaalluarpaluppoq	V	(no generation)
qaalluarpalussu¦aq	N	–up, –it
qaalluarpaluttuinnaavoq	V	(no generation)
qaalluitsinaqaaq	V	(no generation)
qaalluitsinarpoq	V	(no generation)
qaalluitsivoq	V	(no generation)
qaaluppoq	V	(no generation)
qaamaalingiagaa	V	(no generation)
qaamaalingiappoq	V	(no generation)
qaamaavappoq	V	(no generation)
qaamaavatsi¦ppoq	V	–nngilaq
qaamaavattuinnaavoq	V	(no generation)
qaamajuarpoq	V	(no generation)
qaamalia¦q	N	–p, –t
qaamalluarpoq	V	(no generation)
qaamaneeruppoq	V	(no generation)
qaamane¦q	N	–rup, –rit
qaama¦neq	N	–rnup, –rnit
qaamanerpaa¦q	N	–p, –t
qaamanersa¦q	N	–p, –t
qaamaner¦saq	N	{–sap, –tap}, {–sat, –tat}
Qaamanersu¦aq	N	–up, –it
qaamanersu¦aq	N	–up, –it
qaamanertusivoq	V	(no generation)
qaamanikillivoq	V	(no generation)
qaamanikippoq	V	(no generation)
qaamarujunne¦q	N	–rup, –rit
qaamas¦oq	N	–up, –ut
qaamasormiu	N	–p, –t
qaamasorsu¦aq	N	–up, –it
qaamasorta¦q	N	–p, –t
qaamassu¦seq	N	–tsip, –tsit
qaamavoq	V	(no generation)
qaammaallak	Interj	(no generation)
qaammaallanne¦q	N	–rup, –rit
qaammaallappoq	V	(no generation)
qaammaallattaat	N	–ip, –it
qaammaallattarpoq	V	(no generation)
qaammaallattart¦oq	N	–up, –ut
qaammaalluarpaa	V	(no generation)
qaammaappaa	V	(no generation)
qaammaarippoq	V	(no generation)
qaammaarpaluppoq	V	(no generation)
qaammaasa¦q	N	–p, –t
qaammaasaqanngilaq	V	(no generation)
qaammaasaqanngits¦oq	N	–up, –ut
qaammaasaqassu¦seq	N	–tsip, –tsit
qaammaavaa	V	(no generation)
qaammalerne¦q	N	–rup, –rit
qaammanniffi¦k	N	–up, –it
qaammannigiarfi¦k	N	–up, –it
qaammannigiarpoq	V	(no generation)
qaammannippoq	V	(no generation)
qaammaqquserpaa	V	(no generation)
qaammaqquserpoq	V	(no generation)
qaammaqqussu¦aq	N	–up, –it
qaammaqqut	N	–ip, –it
qaammaqqutaavoq	V	(no generation)
qaammaqqutigaa	V	(no generation)
qaammaqqutilliorpoq	V	(no generation)
qaammarippoq	V	(no generation)
qaammarissaarpoq	V	(no generation)
qaammarissivoq	V	(no generation)
qaammarpoq	V	(no generation)
qaammarsaane¦q	N	–rup, –rit
qaammarsaaserpaa	V	(no generation)
qaammarsaat	N	–ip, –it
qaammarsaavoq	V	(no generation)
qaammarsarpaa	V	(no generation)
qaammarsiisigaa	V	(no generation)
qaammartaalerpoq	V	(no generation)
qaammartaarpoq	V	(no generation)
qaammartart¦oq	N	–up, –ut
qaammartippaa	V	(no generation)
qaammartitsivigaa	V	(no generation)
qaammaruppaa	V	(no generation)
qaammarussaavoq	V	(no generation)
qaammassaarpoq	V	(no generation)
qaammassaaruttort¦oq	N	–up, –ut
qaammassu¦aq	N	–up, –it
qaammat	N	–ip, –it
qaammataarukkiartorpoq	V	(no generation)
qaammataaruppoq	V	(no generation)
qaammataasa¦q	N	–p, –t
qaammataasia¦q	N	–p, –t
qaammataavoq	V	(no generation)
qaammat¦ialuinnaat	N, pl.	{–aaluinnaat, –ialuinnaat}
qaammat¦ialuinnannguit	N, pl.	{–aaluinnannguit, –ialuinnannguit}
qaammatigippoq	V	(no generation)
qaammatigissivoq	V	(no generation)
qaammatigissorsuuvoq	V	(no generation)
qaammatigissu¦aq	N	–up, –it
qaammatisiutit	N, pl.	-
qaammatisiutitaarpoq	V	(no generation)
qaammisaanngilaq	V	(no generation)
qaammisaarnaqaaq	V	(no generation)
qaammisaarpoq	V	(no generation)
Qaanaa¦q	Prop	–p
qaane¦q	N	–rup, –rit
qaa¦neq	N	{–nerup, –rnup}, {–nerit, –rnit}
qaanermii¦ppoq	V	–nngilaq
qaanermiu	N	–p, –t
qaangallappoq	V	(no generation)
qaangerarpaa	V	(no generation)
qaangerluarpaa	V	(no generation)
qaangerniagassa¦q	N	–p, –t
qaangerpaa	V	(no generation)
qaangersimavaa	V	(no generation)
qaangersoorpaa	V	(no generation)
qaangiiffi¦k	N	–up, –it
qaangiilluarpoq	V	(no generation)
qaangiinnaavoq	V	(no generation)
qaangiinnagaane¦q	N	–rup, –rit
qaangiinnarpaa	V	(no generation)
qaangiisuuvoq	V	(no generation)
qaangiivoq	V	(no generation)
qaangiukkiartorpoq	V	(no generation)
qaangiulluarpoq	V	(no generation)
qaangiuppoq	V	(no generation)
qaangiussiivaa	V	(no generation)
qaangiussivaa	V	(no generation)
qaangiut¦ereersoq	N	{–ereersup, –ereertup, –sereersup, –sereertup}, {–ereersut, –ereertut, –sereersut, –sereertut}
qaangiutiinnarpoq	V	(no generation)
qaangiuttoorne¦q	N	–rup, –rit
qaangiuttoorpoq	V	(no generation)
qaangiutt¦oq	N	–up, –ut
qaaniikkaluanngilaq	V	(no generation)
qaa¦niippoq	V	{–niinngilaq, –vaniinngilaq}
qaannameerniarpoq	V	(no generation)
qa¦annat	N, pl.	{–annat, –jat}
qaanne¦q	N	–rup, –rit
qaanneraaq	V	(no generation)
qaanngilaq	V	(no generation)
qaanngisimaarpoq	V	(no generation)
qaanngisimaarsimavoq	V	(no generation)
qaanngitsoorpoq	V	(no generation)
qaanng¦oq	N	–up, –ut
qaanngorsiorne¦q	N	–rup, –rit
qaanngueruppoq	V	(no generation)
qaanngunippoq	V	(no generation)
qaannguuppaa	V	(no generation)
qaannguusal¦ik	N	{–iup, –lip, –lup}, –lit
qaannguusa¦q	N	–p, –t
qaannguuserpoq	V	(no generation)
qaannguusisaarpoq	V	(no generation)
qaannguussaavoq	V	(no generation)
qaannguussa¦q	N	–p, –t
qaanniorpoq	V	(no generation)
qaannippoq	V	(no generation)
qaannisaatigaa	V	(no generation)
qaannisarfi¦k	N	–up, –it
qaannisarpoq	V	(no generation)
qaannisartaannarpoq	V	(no generation)
qaanniullaqqippoq	V	(no generation)
qaanniuuppaa	V	(no generation)
qaanniuut	N	–ip, –it
qaannivigippoq	V	(no generation)
qaannivi¦k	N	–up, –it
qaannivissa¦q	N	–p, –t
qaannivissippaa	V	(no generation)
qaannivissi¦ppoq	V	–nngilaq
qaannivoq	V	(no generation)
qaapiaannarpaa	V	(no generation)
qaapiaavoq	V	(no generation)
qaapiarpaa	V	(no generation)
qaapiarpoq	V	(no generation)
qaappaa	V	(no generation)
qaappoq	V	(no generation)
qaa¦q	N	–p, –t
qaaqaa	Interj	(no generation)
qaaqaa	V	(no generation)
qaaqaartorpoq	V	(no generation)
qaaqanngits¦oq	N	–up, –ut
qaaqqippaa	V	(no generation)
qaaqqort¦ooq	N	–uup, –uut
qaaqquaa	V	(no generation)
qaaqquarfi¦k	N	–up, –it
qaaqquarpaa	V	(no generation)
qaaqquneqarne¦q	N	–rup, –rit
qaaqquppoq	V	(no generation)
qaaqqusaas¦oq	N	–up, –ut
qaaqqusaavoq	V	(no generation)
qaaqqusalerpaa	V	(no generation)
qaaqqusa¦q	N	–p, –t
qaaqqusine¦q	N	–rup, –rit
qaaqqusissut	N	–ip, –it
qaaqqusivoq	V	(no generation)
qaaqqussarpaa	V	(no generation)
qaaqqussut	N	–ip, –it
qaaqqutippaa	V	(no generation)
qaaqqutivippoq	V	(no generation)
qaaraa	V	(no generation)
qaaraasarpoq	V	(no generation)
qaaraasuuvoq	V	(no generation)
qaaraavoq	V	(no generation)
qaarajuaarpoq	V	(no generation)
qaarajuallaannarpoq	V	(no generation)
qaarajunne¦q	N	–rup, –rit
qaarajuppoq	V	(no generation)
qaarajussaat	N	–ip, –it
qaarajussarpaa	V	(no generation)
qaarajutt¦oq	N	–up, –ut
qaarajuttukasi¦k	N	–up, –it
qaaralaarpoq	V	(no generation)
qaaralasuinnaavoq	V	(no generation)
qaaralavoq	V	(no generation)
qaari¦aq	N	–ssap, –ssat
qaariarsu¦aq	N	–up, –it
qaarippoq	V	(no generation)
qaarisaavoq	V	(no generation)
qaarisarpaa	V	(no generation)
qaarisivoq	V	(no generation)
qaarlisaarfi¦k	N	–up, –it
qaarlisaarpoq	V	(no generation)
qaarlisaartippaa	V	(no generation)
qaarlisaart¦oq	N	–up, –ut
qaarlumisuppoq	V	(no generation)
qaarlumisuutigaa	V	(no generation)
qaarnaniitippaa	V	(no generation)
qaarne¦q	N	–rup, –rit
qaarnerna¦q	N	–p, –t
qaarnersu¦aq	N	–up, –it
qaarnert¦ooq	N	–uup, –uut
qaarnganiitippaa	V	(no generation)
qaarngernga¦q	N	–p, –t
qaarpaa	V	(no generation)
qaarparpoq	V	(no generation)
qaarparterpoq	V	(no generation)
qaarpiaanii¦ppoq	V	–nngilaq
qaarpia¦q	N	–p, –t
qaarpiarpaa	V	(no generation)
qaarpoq	V	(no generation)
qaarsaaserpaa	V	(no generation)
qaarsaat	N	–ip, –it
qaarsaavoq	V	(no generation)
qaarsaraa	V	(no generation)
qaarsilaarnersu¦aq	N	–up, –it
qaarsilaarpoq	V	(no generation)
qaarsilaartuarpoq	V	(no generation)
qaarsilassu¦seq	N	–tsip, –tsit
qaarsilavallaaqaaq	V	(no generation)
qaarsilavoq	V	(no generation)
qaarsillaat	N	–ip, –it
qaarsillaatigaa	V	(no generation)
qaarsillaatissa¦q	N	–p, –t
qaarsillajuippoq	V	(no generation)
qaarsillarnarpoq	V	(no generation)
qaarsillarne¦q	N	–rup, –rit
qaarsillarpoq	V	(no generation)
qaarsillartippaa	V	(no generation)
qaarsinnaas¦oq	N	–up, –ut
qaarsivoq	V	(no generation)
qaars¦oq	N	–up, –ut
qaarsoqarfi¦k	N	–up, –it
qaarsoqqi¦k	N	–up, –it
qaarsoqqippoq	V	(no generation)
qaarsorasaarpoq	V	(no generation)
qaarsorsu¦aq	N	–up, –it
qaarsui¦k	N	–up, –it
qaarsuinnaavoq	V	(no generation)
qaarsunni¦ppoq	V	–nngilaq
Qaarsut	N, pl.	-
Qaarsut	Prop, pl.	-
qaartarne¦q	N	–rup, –rit
qaartarpoq	V	(no generation)
qaartart¦oq	N	–up, –ut
qaartartorsu¦aq	N	–up, –it
qaartartuinnarpoq	V	(no generation)
qaartartulersuivoq	V	(no generation)
qaartartumeerine¦q	N	–rup, –rit
qaartinne¦q	N	–rup, –rit
qaartippaa	V	(no generation)
qaartippoq	V	(no generation)
qaartiterine¦q	N	–rup, –rit
qaartiterut	N	–ip, –it
qaartitsine¦q	N	–rup, –rit
qaartittaarpoq	V	(no generation)
qaart¦ooq	N	–uup, –uut
qaartoorne¦q	N	–rup, –rit
qaartoorpoq	V	(no generation)
qaart¦oq	N	–up, –ut
qaartoqaaq	V	(no generation)
qaartorpoq	V	(no generation)
qaartorsuuvoq	V	(no generation)
qaartussia¦q	N	–p, –t
qaartuujas¦oq	N	–up, –ut
qaaruallaannarpoq	V	(no generation)
qaaruallappallappoq	V	(no generation)
qaaruallappoq	V	(no generation)
qaaruarpaluppoq	V	(no generation)
qaaruarpaluttuinnaavoq	V	(no generation)
qaaruillisarpaa	V	(no generation)
qaaruippoq	V	(no generation)
qaarulerpoq	V	(no generation)
qaaruppaa	V	(no generation)
qaaruppoq	V	(no generation)
qaaruserpoq	V	(no generation)
qaarusiuppaa	V	(no generation)
qaarusuisappoq	V	(no generation)
qaarusu¦k	N	–up, –it
qaarusulia¦q	N	–p, –t
qaarusummiu	N	–p, –t
qaarusunippoq	V	(no generation)
qaarusussiorpoq	V	(no generation)
qaarusussu¦aq	N	–up, –it
qaarut	N	–ip, –it
qaarutaasat	N, pl.	-
qaarutserpoq	V	(no generation)
qaarutsersimavoq	V	(no generation)
qaasaavoq	V	(no generation)
qaasarpaa	V	(no generation)
qaasartippoq	V	(no generation)
qaaserarluppoq	V	(no generation)
qaaserluinnarsimas¦oq	N	–up, –ut
qaasernarpoq	V	(no generation)
qaaserpallaaqaaq	V	(no generation)
qaaserpoq	V	(no generation)
qaasersarpaa	V	(no generation)
qaasersimas¦oq	N	–up, –ut
qaa¦sersimasoq	N	{–sersimasup, –tilersimasup}, {–sersimasut, –tilersimasut}
qaasersoorpoq	V	(no generation)
qaasers¦oq	N	–up, –ut
qaaser¦soq	N	{–sup, –tup}, {–sut, –tut}
qaa¦sersoq	N	{–sersup, –sertup, –tilersup, –tilertup}, {–sersut, –sertut, –tilersut, –tilertut}
qaasiinaqaaq	V	(no generation)
qaasiinart¦oq	N	–up, –ut
qaasiisaannarpoq	V	(no generation)
qaasiisarpoq	V	(no generation)
qaasiivoq	V	(no generation)
Qaasiut	N	–ip, –it
qaasiutaavoq	V	(no generation)
qaassa¦q	N	–p, –t
qaassia¦q	N	–p, –t
qaassippaa	V	(no generation)
qaassunneqarpoq	V	(no generation)
qaassunnikkunnaarpoq	V	(no generation)
qaassunnilaarpoq	V	(no generation)
qaassunni¦ppoq	V	–nngilaq
qaassuppaa	V	(no generation)
qaassussaavoq	V	(no generation)
qaassussa¦q	N	–p, –t
qaasuerpaa	V	(no generation)
qaasuillivoq	V	(no generation)
qaasuippoq	V	(no generation)
Qaasuits¦oq	N	–up, –ut
Qaasuits¦oq	Prop	–up
qaasuits¦oq	N	–up, –ut
qaasuitsoqarfi¦k	N	–up, –it
qaasuitsormiu	N	–p, –t
qaasunne¦q	N	–rup, –rit
qaasuppoq	V	(no generation)
qaasussivoq	V	(no generation)
qaasutt¦oq	N	–up, –ut
qaasuttorsu¦aq	N	–up, –it
qaat	N, pl.	-
qaat¦eq	N	–ip, –it
qaatermippaa	V	(no generation)
qaatersuarpoq	V	(no generation)
qaatig¦ooq	N	–uup, –uut
qaatigooqarpoq	V	(no generation)
qaatigoorsu¦aq	N	–up, –it
qaatigoortaarpoq	V	(no generation)
qaatiguuliorne¦q	N	–rup, –rit
qaatiguuliorpaa	V	(no generation)
qaat¦ippoq	V	{–itinngilaq, –sinngilaq}
qaatserpaa	V	(no generation)
qaatsiarpaa	V	(no generation)
qaatsiarpoq	V	(no generation)
qaatsiinaqaaq	V	(no generation)
qaatsiivaa	V	(no generation)
qaatsiivoq	V	(no generation)
qaat¦sinneq	N	{–innerup, –sinnerup, –itinnerup}, {–innerit, –sinnerit, –itinnerit}
qaatsiorpoq	V	(no generation)
qaatsiukkiartorpoq	V	(no generation)
qaatsiuppoq	V	(no generation)
qaatsivoq	V	(no generation)
qaattaavoq	V	(no generation)
qaatta¦q	N	–p, –t
qaattarpaa	V	(no generation)
qaattarpoq	V	(no generation)
qaattoorpoq	V	(no generation)
qaattorne¦q	N	–rup, –rit
qaattorpoq	V	(no generation)
qaattortarfi¦k	N	–up, –it
qaattu¦gaq	N	–kkap, –kkat
qaatulluarpoq	V	(no generation)
qaatuppaa	V	(no generation)
qaatuppoq	V	(no generation)
qaatusimasaqanngilaq	V	(no generation)
qaatutsinniarpaa	V	(no generation)
qaavanii¦ppoq	V	–nngilaq
qaa¦vaniippoq	V	{–niinngilaq, –vaniinngilaq}
qaaverpoq	V	(no generation)
qaavoq	V	(no generation)
qaffa	Interj	(no generation)
qaffaallappoq	V	(no generation)
qaffaamisaarpoq	V	(no generation)
qaffaamivoq	V	(no generation)
qaffaane¦q	N	–rup, –rit
qaffaaniut	N	–ip, –it
qaffaaserpaa	V	(no generation)
qaffaassu¦aq	N	–up, –it
qaffaat	N	–ip, –it
qaffakkaluttuinnarpoq	V	(no generation)
qaffakkiartorne¦q	N	–rup, –rit
qaffakkiartorpoq	V	(no generation)
qaffannerpaa¦ffissaq	N	{–ffissap, –juffissap}, {–ffissat, –juffissat}
qaffappaa	V	(no generation)
qaffappoq	V	(no generation)
qaffariarpoq	V	(no generation)
qaffariartorne¦q	N	–rup, –rit
qaffariartorunnaarsitsine¦q	N	–rup, –rit
qaffariasaarpoq	V	(no generation)
qaffarpaa	V	(no generation)
qaffarpoq	V	(no generation)
qaffarsaat	N	–ip, –it
qaffarsarpaa	V	(no generation)
qaffartippaa	V	(no generation)
qaffasinnerpaa¦q	N	–p, –t
qaffasinnerus¦oq	N	–up, –ut
qaffasi¦ssorujussuaq	N	{–ssorujussuup, –ttorujussuup}, {–ssorujussuit, –ttorujussuit}
qaffasissu¦seq	N	–tsip, –tsit
qaffassaane¦q	N	–rup, –rit
qaffassarpaa	V	(no generation)
qaffassimas¦oq	N	–up, –ut
qaffat¦sinneqarneq	N	{–sinneqarnerup, –inneqarnerup}, {–sinneqarnerit, –inneqarnerit}
qaffatsippaa	V	(no generation)
qaffatsitaane¦q	N	–rup, –rit
qaffat¦sitaaneq	N	{–sitaanerup, –itaanerup}, {–sitaanerit, –itaanerit}
qaffatsitaavoq	V	(no generation)
qafferpaa	V	(no generation)
qafferpoq	V	(no generation)
qaffialaarpoq	V	(no generation)
qaffiane¦q	N	–rup, –rit
qaffia¦neq	N	{–nerup, –rnup}, {–nerit, –rnit}
qaffia¦q	N	–ap, –at
qaffiasorsuuvoq	V	(no generation)
qaffiavoq	V	(no generation)
qaffiisaannarpoq	V	(no generation)
qaffiivoq	V	(no generation)
qaffiumisaarne¦q	N	–rup, –rit
qaffiumisaarpoq	V	(no generation)
qajaajarpoq	V	(no generation)
qajaala¦q	N	–p, –t
qajaalarsiorpoq	V	(no generation)
qajaangajappoq	V	(no generation)
qajaa¦raq	N	–qqap, –qqat
qajaarpoq	V	(no generation)
qajaarserpoq	V	(no generation)
qajaarsiuippoq	V	(no generation)
qajaartorpoq	V	(no generation)
qajaaruppoq	V	(no generation)
qajaarutivippoq	V	(no generation)
qajaasaal¦ik	N	{–iup, –lip, –lup}, –lit
qajaasaa¦q	N	–p, –t
qajaasaa¦raq	N	–qqap, –qqat
qajaasaarfi¦k	N	–up, –it
qajaasaarpoq	V	(no generation)
qajaasaliorpoq	V	(no generation)
qajaasa¦q	N	–p, –t
qajaasarpoq	V	(no generation)
qajaasia¦q	N	–p, –t
qajaasoqarajoqaaq	V	(no generation)
qajaats¦oq	N	–up, –ut
qajaavoq	V	(no generation)
qajagaa	V	(no generation)
qajagaaq	V	(no generation)
qajakkuppaa	V	(no generation)
qajal¦ik	N	{–iup, –lip, –lup}, –lit
qajalisarpoq	V	(no generation)
qajalluersart¦oq	N	–up, –ut
qajalukaa¦raq	N	–qqap, –qqat
qajaluka¦q	N	–p, –t
qajaniaarpoq	V	(no generation)
qajaninnilersaarpoq	V	(no generation)
qajanippoq	V	(no generation)
qajannaallisaane¦q	N	–rup, –rit
qajannaallisarneqarpoq	V	(no generation)
qajannaallisarpaa	V	(no generation)
qajannaallivoq	V	(no generation)
qajannaappoq	V	(no generation)
qajannaaqqut	N	–ip, –it
qajannaarpaa	V	(no generation)
qajannaarsaane¦q	N	–rup, –rit
qajannaarsorpaa	V	(no generation)
qajannaarsuine¦q	N	–rup, –rit
qajannaarsuivoq	V	(no generation)
qajannaassu¦seq	N	–tsip, –tsit
qajannaats¦oq	N	–up, –ut
qajannaatsorsu¦aq	N	–up, –it
qajannangaart¦oq	N	–up, –ut
qajannaqaaq	V	(no generation)
qajannarne¦q	N	–rup, –rit
qajannarpoq	V	(no generation)
qajannarsine¦q	N	–rup, –rit
qajannarsisippaa	V	(no generation)
qajannarsisitsine¦q	N	–rup, –rit
qajannarsivoq	V	(no generation)
qajannart¦oq	N	–up, –ut
qajannartuaannarpoq	V	(no generation)
qajannarunnaarpoq	V	(no generation)
qajannassu¦seq	N	–tsip, –tsit
qajapalaavoq	V	(no generation)
qa¦jaq	N	{–annap, –jap}, {–annat, –jat}
qajaqasersorpaa	V	(no generation)
qajaqat	N	–ip, –it
qajaqqinnersaavoq	V	(no generation)
qajaqqippoq	V	(no generation)
qajaqqissorujussuuvoq	V	(no generation)
qajaralappoq	V	(no generation)
qajaralattaannarpoq	V	(no generation)
qajari¦aq	N	–ssap, –ssat
qajariarsiorpoq	V	(no generation)
qajarmi¦oq	N	–up, –ut
qajarmiu	N	–p, –t
qajarsiorpoq	V	(no generation)
qajartaarpoq	V	(no generation)
qajartaavoq	V	(no generation)
qajarta¦q	N	–ap, –at
qajarta¦q	N	–p, –t
qajartassarsivoq	V	(no generation)
qajartorne¦q	N	–rup, –rit
qajar¦torneq	N	{–sornerup, –tornerup}, {–sornerit, –tornerit}
qajartorpoq	V	(no generation)
qajartua¦q	N	–p, –t
qajartuarajuppoq	V	(no generation)
qajartuarpoq	V	(no generation)
qajartullaqqippoq	V	(no generation)
qajartunnguarpoq	V	(no generation)
qajartuuppaa	V	(no generation)
qajartuu¦seq	N	–tsip, –tsit
qajar¦tuuseq	N	{–tuutsip, –suutsip}, {–tuutsit, –suutsit}
qajartuusertaarpoq	V	(no generation)
qajarujoorpoq	V	(no generation)
qajassia¦q	N	–p, –t
qajassuaappoq	V	(no generation)
qajassuaats¦oq	N	–up, –ut
qajassuarne¦q	N	–rup, –rit
qajassuarpoq	V	(no generation)
qajassuart¦oq	N	–up, –ut
qajassuppaa	V	(no generation)
qajassuppoq	V	(no generation)
qajassussine¦q	N	–rup, –rit
qajassuuppaa	V	(no generation)
qajassuussine¦q	N	–rup, –rit
qajassuussis¦oq	N	–up, –ut
qajassuussivoq	V	(no generation)
qajavi¦k	N	–up, –it
qajavissu¦aq	N	–up, –it
qa¦joq	N	–tsup, –tsut
qajoqarluarpoq	V	(no generation)
qajoqarpoq	V	(no generation)
qajoqqortoqaaq	V	(no generation)
qajoqqortuvoq	V	(no generation)
qajorippoq	V	(no generation)
qajorissaarpoq	V	(no generation)
qajorla¦k	N	–ap, –at
qajortorpoq	V	(no generation)
qajuerneqanngilaq	V	(no generation)
qajuerpaa	V	(no generation)
qajuerunnavianngilaq	V	(no generation)
qajueruppoq	V	(no generation)
qajueruttoorpoq	V	(no generation)
qajukilliorpoq	V	(no generation)
qajukinaarpaa	V	(no generation)
qajukippoq	V	(no generation)
qajulaal¦ik	N	{–iup, –lip, –lup}, –lit
qajulaa¦q	N	–p, –t
qajunngerpoq	V	(no generation)
qajunngersuiuvoq	V	(no generation)
qajunnguvoq	V	(no generation)
qajuuppaasa¦q	N	–p, –t
qajuuppaavoq	V	(no generation)
qajuuppa¦q	N	–p, –t
qajuuppartaarpoq	V	(no generation)
qajuusaarluerpoq	V	(no generation)
qajuusaasat	N, pl.	-
qajuusaa¦siaq	N	{–siap, –tiliap}, {–siat, –tiliat}
qajuusaa¦siorfik	N	{–siorfiup, –tiliorfiup}, {–siorfiit, –tiliorfiit}
qajuusat	N, pl.	-
qajuusiassal¦ik	N	{–iup, –lip, –lup}, –lit
qajuusiassat	N, pl.	-
qajuuttaa¦raq	N	–qqap, –qqat
qajuuttaasa¦q	N	–p, –t
qajuutta¦q	N	–p, –t
qakku	Pron, pl.	–a
qalaalerfi¦k	N	–up, –it
qalaappaa	V	(no generation)
qalaarne¦q	N	–rup, –rit
qalaarpalunne¦q	N	–rup, –rit
qalaarpaluppoq	V	(no generation)
qalaarpoq	V	(no generation)
qalaassine¦q	N	–rup, –rit
qalaassivoq	V	(no generation)
qalagasuaasarpoq	V	(no generation)
qalagasuaavoq	V	(no generation)
qalagasuarpaa	V	(no generation)
qala¦k	N	–ap, –at
qalakkallanngilaq	V	(no generation)
qalaliane¦q	N	–rup, –rit
qalalia¦neq	N	{–nerup, –rnup}, {–nerit, –rnit}
qalaliavoq	V	(no generation)
qalalluarpoq	V	(no generation)
qala¦neq	N	{–nerup, –rnup}, {–nerit, –rnit}
qalanerasaarpoq	V	(no generation)
qalangavallaaqaaq	V	(no generation)
qalangavoq	V	(no generation)
qalappaa	V	(no generation)
qalappallaaqaaq	V	(no generation)
qala¦ppoq	V	–nngilaq
qala¦q	N	–p, –t
qalaqqajarpoq	V	(no generation)
qalarlaa¦q	N	–p, –t
qalarsu¦aq	N	–up, –it
qalaruluppoq	V	(no generation)
qala¦seq	N	–tsip, –tsit
qalasersualiartart¦oq	N	–up, –ut
Qalasersu¦aq	N	–up, –it
Qalasersu¦aq	Prop	–up, –it
qalasiluppoq	V	(no generation)
qalasiusaa¦q	N	–p, –t
qalassi¦ppoq	V	–nngilaq
qalasunni	N	–p, –t
qalasunnialaarpoq	V	(no generation)
qalatippaa	V	(no generation)
qalatippallaaqaa	V	(no generation)
qalatita¦q	N	–p, –t
qalat¦itaq	N	{–itap, –sitap}, {–itat, –sitat}
qalatitsine¦q	N	–rup, –rit
qalat¦itsineq	N	{–itsinerup, –sitsinerup}, {–itsinerit, –sitsinerit}
qalatitsivoq	V	(no generation)
qalatsiivoq	V	(no generation)
qalatsine¦q	N	–rup, –rit
qalatsippaa	V	(no generation)
qalatsivoq	V	(no generation)
qalatsorpallaanngilaq	V	(no generation)
qalatsorpoq	V	(no generation)
qalatsuippoq	V	(no generation)
qal¦eq	N	–ip, –it
qalequt	N	–ip, –it
qalequtaaruppoq	V	(no generation)
qalequt¦aq	N	{–ap, –tap}, {–at, –tat}
qalequtassia¦q	N	–p, –t
qalequtissia¦q	N	–p, –t
qalequtserpaa	V	(no generation)
qalequtsiuppaa	V	(no generation)
qaleraleqarfi¦k	N	–up, –it
qaleral¦ik	N	{–iup, –lip, –lup}, –lit
qaleralinniarne¦q	N	–rup, –rit
qaleralinniarpoq	V	(no generation)
qaleralinniut	N	–ip, –it
qaleralittassiissutit	N, pl.	-
qaleralit¦tassiissutit	N, pl.	{–assiissutit, –tassiissutit}
qaleralliarpoq	V	(no generation)
qaleranngutitsivoq	V	(no generation)
qalerannguuvoq	V	(no generation)
qalerannguvoq	V	(no generation)
qale¦raq	N	–qqap, –qqat
qaleriiaat	N, pl.	-
qaleriissaane¦q	N	–rup, –rit
qaleriissat	N, pl.	-
qaleriit	N, pl.	-
qalersa¦q	N	–p, –t
qalersarsu¦aq	N	–up, –it
qalersassia¦q	N	–p, –t
qalerual¦ik	N	{–iup, –lip, –lup}, –lit
qaleruanippoq	V	(no generation)
qaleru¦aq	N	–ssap, –ssat
qaliaasa¦q	N	–p, –t
qalianii¦ppoq	V	–nngilaq
qalia¦q	N	–p, –t
qaliaqarpoq	V	(no generation)
qaliaqqortuvoq	V	(no generation)
qaliarmiu	N	–p, –t
qalipaagajuppoq	V	(no generation)
qalipaajaavoq	V	(no generation)
qalipaajarpaa	V	(no generation)
qalipaakatannerarpoq	V	(no generation)
qalipaallaqqippoq	V	(no generation)
qalipaane¦q	N	–rup, –rit
qalipaa¦q	N	–p, –t
qalipaarpaa	V	(no generation)
qalipaarpoq	V	(no generation)
qalipaarsimavoq	V	(no generation)
qalipaasarpoq	V	(no generation)
qalipaaserpaa	V	(no generation)
qalipaasersorpaa	V	(no generation)
qalipaa¦sersuineq	N	{–sersuinerup, –tilersuinerup}, {–sersuinerit, –tilersuinerit}
qalipaa¦sersuisarfik	N	{–sersuisarfiup, –tilersuisarfiup}, {–sersuisarfiit, –tilersuisarfiit}
qalipaa¦siineq	N	{–siinerup, –tiliinerup}, {–siinerit, –tiliinerit}
qalipaasit	N	–ip, –it
qalipaasiut	N	–ip, –it
qalipaasiutaarserpoq	V	(no generation)
qalipaas¦oq	N	–up, –ut
qalipaat	N	–ip, –it
qalipaat	N, pl.	-
qalipaataajarpaa	V	(no generation)
qalipaataannanngorpoq	V	(no generation)
qalipaataarluerpoq	V	(no generation)
qalipaatigippoq	V	(no generation)
qalipaatigissaarpoq	V	(no generation)
qalipaatigiss¦oq	N	–up, –ut
qalipaatigi¦ssoq	N	{–ssup, –ttup}, {–ssut, –ttut}
qalipaatil¦ik	N	{–iup, –lip, –lup}, –lit
qalipaatissa¦q	N	–p, –t
qalipaatissia¦q	N	–p, –t
qalipaavoq	V	(no generation)
qalipagaarniarpoq	V	(no generation)
qalipa¦gaq	N	–kkap, –kkat
qalipagarsu¦aq	N	–up, –it
qalipa¦k	N	–ap, –at
qalipakkat	N, pl.	-
qalipak¦oq	N	–up, –ut
qalipalluarpaa	V	(no generation)
qalipanne¦q	N	–rup, –rit
qalipappaa	V	(no generation)
qalipappoq	V	(no generation)
qalipassimas¦oq	N	–up, –ut
qalipassimavoq	V	(no generation)
qalipattarpoq	V	(no generation)
qalipatt¦ooq	N	–uup, –uut
qalipperpoq	V	(no generation)
qalippersoorpoq	V	(no generation)
qalippiarpoq	V	(no generation)
qalippiuppoq	V	(no generation)
qalissarsivoq	V	(no generation)
qalissia¦q	N	–p, –t
qallaats¦oq	N	–up, –ut
qallaatsortorpoq	V	(no generation)
qallajaappoq	V	(no generation)
qallajavoq	V	(no generation)
qallangaappoq	V	(no generation)
qallangavoq	V	(no generation)
qallaserpoq	V	(no generation)
qallasersorsuuvoq	V	(no generation)
qall¦eq	N	{–erup, –iup}, {–erit, –iit}
qalleqqippaa	V	(no generation)
qalleqqissarpaa	V	(no generation)
qalleraavoq	V	(no generation)
qallerarpaa	V	(no generation)
qallerneqanngits¦oq	N	–up, –ut
qallerpaa	V	(no generation)
qallerpaa¦q	N	–p, –t
qallerpoq	V	(no generation)
qallersaat	N	–ip, –it
qaller¦saat	N	{–saatip, –taatip}, {–saatit, –taatit}
qallersimavaa	V	(no generation)
qallersiorpoq	V	(no generation)
qallersu¦gaq	N	–kkap, –kkat
qallersugartorpoq	V	(no generation)
qallersuine¦q	N	–rup, –rit
qallersuut	N	–ip, –it
qaller¦suut	N	{–suutip, –tuutip}, {–suutit, –tuutit}
qallersuutaarniarfi¦k	N	–up, –it
qaller¦suutaarniarfik	N	{–suutaarniarfiup, –tuutaarniarfiup}, {–suutaarniarfiit, –tuutaarniarfiit}
qallersuutissa¦q	N	–p, –t
qaller¦suutissaq	N	{–suutissap, –tuutissap}, {–suutissat, –tuutissat}
qallersuutiterpaa	V	(no generation)
qalliallappoq	V	(no generation)
qalliartorpoq	V	(no generation)
qalliartort¦oq	N	–up, –ut
qalli¦gaq	N	–kkap, –kkat
qalliine¦q	N	–rup, –rit
qallilerpaa	V	(no generation)
qallilerut	N	–ip, –it
qalliliuuppoq	V	(no generation)
qalline¦q	N	–rup, –rit
qallingerpaa	V	(no generation)
qallingerpoq	V	(no generation)
qallinikippoq	V	(no generation)
qallinippoq	V	(no generation)
qallinissimavoq	V	(no generation)
qallinngortippaa	V	(no generation)
qallinniuppaa	V	(no generation)
qallipiaajarpaa	V	(no generation)
qallipia¦k	N	–ap, –at
qalli¦t	N	–sip, –sit
qalliuniarne¦q	N	–rup, –rit
qall¦iuniarneq	N	{–eruniarnerup, –iuniarnerup}, {–eruniarnerit, –iuniarnerit}
qalliuniarpoq	V	(no generation)
qalliuppaa	V	(no generation)
qalliut	N	–ip, –it
qalliuvoq	V	(no generation)
qallivaa	V	(no generation)
qallivoq	V	(no generation)
qalloqqort¦ooq	N	–uup, –uut
qallorne¦q	N	–rup, –rit
qallorpaa	V	(no generation)
qallorpoq	V	(no generation)
qallortuarpoq	V	(no generation)
qallu	N	–p, –t
qallueruppoq	V	(no generation)
qalluigaa	V	(no generation)
qallui¦k	N	–up, –it
qalluine¦q	N	–rup, –rit
qalluivoq	V	(no generation)
qallukippoq	V	(no generation)
qallunaam¦ineq	N	{–ernup, –inerup}, {–ernit, –inerit}
qallunaam¦ineq	N	–ernup, –ernit
qallunaangaja¦k	N	–ap, –at
qallunaangavoq	V	(no generation)
qallunaa¦q	N	–p, –t
qallunaaqarfi¦k	N	–up, –it
qallunaarmiu	N	–p, –t
qallunaarpasippoq	V	(no generation)
qallunaarpoq	V	(no generation)
qallunaarsu¦aq	N	–up, –it
qallunaartaat	N	–ip, –it
qallunaartaat	N, pl.	-
qallu¦naartaat	N	{–naartaatip, –tinaartaatip}, {–naartaatit, –tinaartaatit}
qallunaarta¦q	N	–p, –t
qallunaartat	N, pl.	-
qallunaartippoq	V	(no generation)
qallunaatoorne¦q	N	–rup, –rit
qallunaatoorpoq	V	(no generation)
qallunaatoorsinnaassu¦seq	N	–tsip, –tsit
qallunaatsiaat	N	–ip, –it
qallunaatsiaat	N, pl.	-
qallunaatsia¦q	N	–ap, –at
qallunarni	N	–p, –t
qallunarnippoq	V	(no generation)
qallunassivoq	V	(no generation)
qallunnerisaannarpoq	V	(no generation)
qallunnerit¦ooq	N	–uup, –uut
qallunnerivoq	V	(no generation)
qallunniaavoq	V	(no generation)
qallunnia¦q	N	–p, –t
qallunniarajuppoq	V	(no generation)
qallunniarne¦q	N	–rup, –rit
qallunniarpoq	V	(no generation)
qallunniartaannarpoq	V	(no generation)
qallupia¦k	N	–ap, –at
qallupia¦q	N	–rup, –rit
qalluppaa	V	(no generation)
qalluppoq	V	(no generation)
qallussarpoq	V	(no generation)
qallussivoq	V	(no generation)
qallussu¦aq	N	–up, –it
qallusu¦k	N	–up, –it
qallut	N	–ip, –it
qallut	N, pl.	-
qallutaarserpoq	V	(no generation)
qallutigaa	V	(no generation)
qallutitaarpoq	V	(no generation)
qallutoornaqaaq	V	(no generation)
qallutoornarsivoq	V	(no generation)
qallutoorpoq	V	(no generation)
qalluttaarpoq	V	(no generation)
qalooraasuuvoq	V	(no generation)
qalooraavoq	V	(no generation)
qaloorfigaa	V	(no generation)
qaloorpoq	V	(no generation)
qaloqqasaaqaaq	V	(no generation)
qaloqqasa¦q	N	–p, –t
qaloqqavaa	V	(no generation)
qalorsa¦q	N	–p, –t
qalorsuit	N, pl.	-
qaluaa	V	(no generation)
qalugi¦aq	N	–ssap, –ssat
qalugiarpaa	V	(no generation)
qalugiartal¦ik	N	{–iup, –lip, –lup}, –lit
qalugisserpoq	V	(no generation)
qalugiusa¦q	N	–p, –t
qalujuaannarpoq	V	(no generation)
qaluliorpoq	V	(no generation)
qalumane¦q	N	–rup, –rit
qaluma¦neq	N	{–nerup, –rnup}, {–nerit, –rnit}
qalumavoq	V	(no generation)
qalumii	N	–p, –t
qalummarippoq	V	(no generation)
qalune¦q	N	–rup, –rit
qal¦uneq	N	{–ornup, –unerup}, {–ornit, –unerit}
qalunerasappoq	V	(no generation)
qalunerpaa	V	(no generation)
qalunersivoq	V	(no generation)
qaluniusa¦q	N	–p, –t
qalunnisorsuuvoq	V	(no generation)
qalunnivoq	V	(no generation)
qalupippaa	V	(no generation)
qalupippoq	V	(no generation)
qaluserarpoq	V	(no generation)
qalusiuarpoq	V	(no generation)
qalusivoq	V	(no generation)
qalutaarpoq	V	(no generation)
qalutaasiorpoq	V	(no generation)
qalutaassu¦aq	N	–up, –it
qalutaassuit	N, pl.	-
qalutaat	N	–ip, –it
qalutaatee¦raq	N	–qqap, –qqat
qaluu¦gaq	N	–kkap, –kkat
qaluvoq	V	(no generation)
qamaa¦q	N	–p, –t
qamaaraa	V	(no generation)
qamaassarsivoq	V	(no generation)
qamagajuppoq	V	(no generation)
qamagallarniarpaa	V	(no generation)
qamagallarniarpoq	V	(no generation)
qamagaluallarpoq	V	(no generation)
qamagaluarniarpaa	V	(no generation)
qamane¦q	N	–rup, –rit
qamaniinngilaq	V	(no generation)
qamanii¦ppoq	V	–nngilaq
qamaniissimavoq	V	(no generation)
qamari¦aq	N	–ssap, –ssat
qamasa¦q	N	–p, –t
qamas¦oq	N	–up, –ut
qamasoqanngilaq	V	(no generation)
qamavaa	V	(no generation)
qamavoq	V	(no generation)
qamikkiartorpoq	V	(no generation)
qaminngaarne¦q	N	–rup, –rit
qaminngaarpoq	V	(no generation)
qaminngasaannarpoq	V	(no generation)
qaminngasoorpoq	V	(no generation)
qaminngas¦oq	N	–up, –ut
qaminngavoq	V	(no generation)
qamippaa	V	(no generation)
qami¦ppoq	V	–nngilaq
qamisaaniarne¦q	N	–rup, –rit
qamisarpaa	V	(no generation)
qamissimavoq	V	(no generation)
qamitak¦oq	N	–up, –ut
qamiterivoq	V	(no generation)
qa¦miterpaa	V	–tsinngilaa
qamitippaa	V	(no generation)
qamitsisissa¦q	N	–p, –t
qamitsi¦t	N	–sip, –sit
qamitsivoq	V	(no generation)
qamittaat	N	–ip, –it
qamittoorpoq	V	(no generation)
qamiuippoq	V	(no generation)
qamiuitsuunngilaq	V	(no generation)
qamivissanngilaq	V	(no generation)
qamivissinnaanngilaq	V	(no generation)
qammarpaa	V	(no generation)
qammavi¦k	N	–up, –it
qammavinnaa¦q	N	–p, –t
qammavissiorpoq	V	(no generation)
qammerit¦ooq	N	–uup, –uut
qammerivoq	V	(no generation)
qammippaa	V	(no generation)
qammi¦ppoq	V	–nngilaq
qammorpoq	V	(no generation)
qammuinnarpoq	V	(no generation)
qammukarpoq	V	(no generation)
qammungavoq	V	(no generation)
qammuppoq	V	(no generation)
qammutsippaa	V	(no generation)
qamunnaappaa	V	(no generation)
qamunnaassivoq	V	(no generation)
qamunnarpoq	V	(no generation)
qamuserigajuppoq	V	(no generation)
qamuserivoq	V	(no generation)
qamuserpoq	V	(no generation)
qamusiorpoq	V	(no generation)
qamusisarpoq	V	(no generation)
qamussuit	N, pl.	-
qamut	N	–ip, –it
qamutaasiorpoq	V	(no generation)
qamutaasiorsimavoq	V	(no generation)
qamuterpoq	V	(no generation)
qamutersorpoq	V	(no generation)
qamutileriarpoq	V	(no generation)
qamutil¦ik	N	{–iup, –lip, –lup}, –lit
qamutilinne¦q	N	–rup, –rit
qamutilippoq	V	(no generation)
qamutilissu¦aq	N	–up, –it
qamutil¦issuaq	N	{–ersuup, –issuup}, {–ersuit, –issuit}
qamutilittaatigaa	V	(no generation)
qamutili¦ttarneq	N	{–ssarnerup, –ttarnerup}, {–ssarnerit, –ttarnerit}
qamutit	N, pl.	-
qamutita¦q	N	–p, –t
qamuunaqquppoq	V	(no generation)
qanagu¦aq	N	–ssap, –ssat
qanaguarpaa	V	(no generation)
qanagusserpaa	V	(no generation)
qana¦k	N	–ap, –at
qanalla¦k	N	–ap, –at
qanallassu¦aq	N	–up, –it
qanappaa	V	(no generation)
qanassiat	N, pl.	-
qanatta¦q	N	–p, –t
qanattorpaa	V	(no generation)
qa¦neq	N	{–nerup, –nip, –rnup}, {–nerit, –nit, –rnit}
qaneqaqaaq	V	(no generation)
qanerissaat	N	–ip, –it
qaneri¦ssaat	N	{–ssaatip, –ttaatip}, {–ssaatit, –ttaatit}
qanerissarpaa	V	(no generation)
qanerissarpoq	V	(no generation)
qaneriti¦ppoq	V	–nngilaq
qanerlunne¦q	N	–rup, –rit
qan¦erlunneq	N	{–erlunnerup, –ilunnerup}, {–erlunnerit, –ilunnerit}
qanerluppoq	V	(no generation)
qanermissari¦aq	N	–ssap, –ssat
qanermissarissat	N, pl.	-
qanermiugaa	V	(no generation)
qanermiugiinnarpaa	V	(no generation)
qanersori¦aq	N	–ssap, –ssat
qanersorpaa	V	(no generation)
qanersorpoq	V	(no generation)
qanersu¦aq	N	–up, –it
qangaguuppoq	V	(no generation)
qangani¦saq	N	–tsap, –tsat
qanganngorpoq	V	(no generation)
qanganngort¦oq	N	–up, –ut
qangannguuppaa	V	(no generation)
qangaqaqq¦oq	N	–up, –ut
qangataarpaluppoq	V	(no generation)
qangatalertorpoq	V	(no generation)
qangatane¦q	N	–rup, –rit
qangata¦neq	N	{–nerup, –rnup}, {–nerit, –rnit}
qangatarpaluppoq	V	(no generation)
qangatavoq	V	(no generation)
qangatserpoq	V	(no generation)
qangatsersimane¦q	N	–rup, –rit
qangatsiffi¦k	N	–up, –it
qangatsi¦ppoq	V	–nngilaq
qangattaappaa	V	(no generation)
qangattaa¦raq	N	–qqap, –qqat
qangattaarpoq	V	(no generation)
qangattaassivoq	V	(no generation)
qangattaat	N	–ip, –it
qangatta¦gaq	N	–kkap, –kkat
qangattamii¦ppoq	V	–nngilaq
qangattangajannarpoq	V	(no generation)
qangatta¦q	N	–p, –t
qangattariarne¦q	N	–rup, –rit
qangattarpaa	V	(no generation)
qangattarpoq	V	(no generation)
qangattarsarpoq	V	(no generation)
qangattarsu¦aq	N	–up, –it
qangattavillarpoq	V	(no generation)
qangi¦aq	N	–ssap, –ssat
qanialaannguarpoq	V	(no generation)
qanialaarpoq	V	(no generation)
qanigaa	V	(no generation)
qanigisa¦q	N	–p, –t
qanigisoorpaa	V	(no generation)
qani¦k	N	–up, –it
qanikilla¦k	N	–ap, –at
qanikippoq	V	(no generation)
qanikits¦oq	N	–up, –ut
qanikkaa¦q	N	–p, –t
qanikkoort¦oq	N	–up, –ut
qanilaajuippoq	V	(no generation)
qanilaalersitsine¦q	N	–rup, –rit
qanilaaler¦sitsineq	N	{–sitsinerup, –titsinerup}, {–sitsinerit, –titsinerit}
qanilaarfigaa	V	(no generation)
qanilaarpoq	V	(no generation)
qanilaartippaa	V	(no generation)
qanilaavippoq	V	(no generation)
qanillattorpaa	V	(no generation)
qanillattuikannerne¦q	N	–rup, –rit
qanillattuivoq	V	(no generation)
qanillattuuppaa	V	(no generation)
qanillattuut	N	–ip, –it
qanilleqqusinnginne¦q	N	–rup, –rit
qanilleriataarpaa	V	(no generation)
qanilliallassimavoq	V	(no generation)
qanilliartoqqinniarpoq	V	(no generation)
qanilliartoqqippoq	V	(no generation)
qanilliartoqqissimagaluarpoq	V	(no generation)
qanilliartoqquaa	V	(no generation)
qanilliartorne¦q	N	–rup, –rit
qanilliartorpaa	V	(no generation)
qanilliartorpoq	V	(no generation)
qanilliartorsimagaluarpoq	V	(no generation)
qanilliartorsimavoq	V	(no generation)
qanilliartorsinnaassavaa	V	(no generation)
qanilliartort¦oq	N	–up, –ut
qanilliartorusaaginnarpoq	V	(no generation)
qanilliartorusaarpoq	V	(no generation)
qanilliartulersimavoq	V	(no generation)
qanilliartunngilaq	V	(no generation)
qanilliartupiloorpoq	V	(no generation)
qanilliartupiloorsimavoq	V	(no generation)
qanilliartussaaq	V	(no generation)
qanilliartussanerpaa	V	(no generation)
qanilliartussanngilaq	V	(no generation)
qanilliartussannginnerpaa	V	(no generation)
qanilliuminart¦oq	N	–up, –ut
qanillivaa	V	(no generation)
qanillivoq	V	(no generation)
qanilummaavoq	V	(no generation)
qanilunnarpoq	V	(no generation)
qaniluppoq	V	(no generation)
qaniluttaannarpoq	V	(no generation)
qanimaappoq	V	(no generation)
qanimaavippoq	V	(no generation)
qanimajunnaarne¦q	N	–rup, –rit
qanimanart¦oq	N	–up, –ut
qanimanartoqarpoq	V	(no generation)
qanimanartorsiorne¦q	N	–rup, –rit
qanimatuvoq	V	(no generation)
qanimavoq	V	(no generation)
qanimorpaa	V	(no generation)
qaninaaqquppaa	V	(no generation)
qaninaarpaa	V	(no generation)
qaninaarpoq	V	(no generation)
qaninaaruppaa	V	(no generation)
qaninaavippaa	V	(no generation)
qaninnerpaa¦ffik	N	{–ffiup, –juffiup}, {–ffiit, –juffiit}
qaninnerpaa¦ffissaq	N	{–ffissap, –juffissap}, {–ffissat, –juffissat}
qaninnerpaa¦saq	N	{–jusap, –sap}, {–jusat, –sat}
qaninngaarsuppoq	V	(no generation)
qaninngaavoq	V	(no generation)
qaninngarpaa	V	(no generation)
qaninngoorpaa	V	(no generation)
qaninngoorpallaaqaaq	V	(no generation)
qaninngoorpoq	V	(no generation)
qaninniakujuppoq	V	(no generation)
qaninniaqatigeerujoorne¦q	N	–rup, –rit
qaninniarne¦q	N	–rup, –rit
qaninniarneqart¦oq	N	–up, –ut
qaninniarpaa	V	(no generation)
qaninniarpoq	V	(no generation)
qaninniartaraluaqaa	V	(no generation)
qaninniartaraluaqaaq	V	(no generation)
qaniorpaa	V	(no generation)
qanipalu¦k	N	–up, –it
qanipaluuvoq	V	(no generation)
qanippaa	V	(no generation)
qanippallappoq	V	(no generation)
qanippoq	V	(no generation)
qanisaaserpaa	V	(no generation)
qanisaat	N	–ip, –it
qanisa¦q	N	–p, –t
qanisaraa	V	(no generation)
qanisarpaa	V	(no generation)
Qanisartuut	N	–ip, –it
Qanisartuut	N, pl.	-
qanisivoq	V	(no generation)
qanissu¦seq	N	–tsip, –tsit
qanita¦q	N	–p, –t
qanitaraa	V	(no generation)
qanitat	N, pl.	-
qanitilluarpaa	V	(no generation)
qanitippaa	V	(no generation)
qanittuararsu¦aq	N	–up, –it
qanittukkut	N, pl.	-
qanittunngu¦aq	N	–up, –it
qaniuarpoq	V	(no generation)
qaniuart¦oq	N	–up, –ut
qani¦uartoq	N	{–tuartup, –uartup}, {–tuartut, –uartut}
qanivaa	V	(no generation)
qa¦nna	Pron	–ssuma, {–kku, –kkua}
qannerisaannarpoq	V	(no generation)
qannerivoq	V	(no generation)
qannerpoq	V	(no generation)
qanners¦oq	N	–up, –ut
qanner¦soq	N	{–sup, –tup}, {–sut, –tut}
qannersorsuuvoq	V	(no generation)
qanng¦oq	N	–up, –ut
qanngorne¦q	N	–rup, –rit
qanngorpalla¦k	N	–ap, –at
qanngorpallanne¦q	N	–rup, –rit
qanng¦orpallanneq	N	{–orpallannerup, –upallannerup}, {–orpallannerit, –upallannerit}
qanngorpallatt¦oq	N	–up, –ut
qanng¦orpallattoq	N	{–orpallattup, –upallattup}, {–orpallattut, –upallattut}
qanngorpoq	V	(no generation)
qanngorsaraaq	V	(no generation)
qanngort¦oq	N	–up, –ut
qanngortorsuuvoq	V	(no generation)
qannguilaarpoq	V	(no generation)
qannguine¦q	N	–rup, –rit
qannguisorsuuvoq	V	(no generation)
qannguivoq	V	(no generation)
qanngullarippoq	V	(no generation)
qanngullarivippoq	V	(no generation)
qanngulunnguarsi	Interj	(no generation)
qannguluppaluppoq	V	(no generation)
qannguluppoq	V	(no generation)
qanngulutt¦oq	N	–up, –ut
qanngusa¦q	N	–p, –t
qanniarfi¦k	N	–up, –it
qanniarpoq	V	(no generation)
qannilaarpoq	V	(no generation)
qannileqqajaavoq	V	(no generation)
qannilerpoq	V	(no generation)
qanniliuppaa	V	(no generation)
qanniliussaavoq	V	(no generation)
qanninnguatsiarpoq	V	(no generation)
qannippaa	V	(no generation)
qannippoq	V	(no generation)
qanoq	Interj	(no generation)
qanoq-iliorne¦q	N	–rup, –rit
qanoq-iliuuseqart¦oq	N	–up, –ut
qanoq-issu¦seq	N	–tsip, –tsit
qanorooq	Interj	(no generation)
qapa¦k	N	–ap, –at
qapangeqqavoq	V	(no generation)
qapangiinnarpoq	V	(no generation)
qapangi¦ppoq	V	–nngilaq
qapappoq	V	(no generation)
qapasaavoq	V	(no generation)
qapasaffigaa	V	(no generation)
qapasa¦gaq	N	–kkap, –kkat
qapasagaraa	V	(no generation)
qapasa¦k	N	–ap, –at
qapasappoq	V	(no generation)
qapasattaraa	V	(no generation)
qapatsissimavoq	V	(no generation)
qaperangavoq	V	(no generation)
qaperappoq	V	(no generation)
qaperassimaarpoq	V	(no generation)
qaperattaarpoq	V	(no generation)
qaperfeerpoq	V	(no generation)
qaperpaa	V	(no generation)
qaperpaavoq	V	(no generation)
qaperpoq	V	(no generation)
qaperraats¦oq	N	–up, –ut
qaperra¦q	N	–ap, –at
qaperrarippoq	V	(no generation)
qapertippoq	V	(no generation)
qapiaavoq	V	(no generation)
qapialittarpaa	V	(no generation)
qapiangasoorpaa	V	(no generation)
qapiarfi¦k	N	–up, –it
Qapiarfiusaa¦q	N	–p, –t
qapiarluarpaa	V	(no generation)
qapiarne¦q	N	–rup, –rit
qapiarpaa	V	(no generation)
qapiarpoq	V	(no generation)
qapinnguppoq	V	(no generation)
qapinnguvoq	V	(no generation)
qapippaa	V	(no generation)
qapippoq	V	(no generation)
qapisivaa	V	(no generation)
qapitippaa	V	(no generation)
qapittaarpoq	V	(no generation)
qapittarpoq	V	(no generation)
qapiusiorpoq	V	(no generation)
qapiussu¦aq	N	–up, –it
qapiut	N	–ip, –it
qapiutee¦raq	N	–qqap, –qqat
qapivaa	V	(no generation)
qappa¦k	N	–ap, –at
qappangas¦oq	N	–up, –ut
qappangassu¦seq	N	–tsip, –tsit
qappangasuuvoq	V	(no generation)
qappangavallaaqaaq	V	(no generation)
qappangavoq	V	(no generation)
qappappoq	V	(no generation)
qappassimaarpoq	V	(no generation)
qappattoorpoq	V	(no generation)
qapperpaa	V	(no generation)
qapperpoq	V	(no generation)
qappersippaa	V	(no generation)
qappi¦k	N	–up, –it
qappioraatitsivoq	V	(no generation)
qappiorpoq	V	(no generation)
qappiortippaa	V	(no generation)
qappiortita¦q	N	–p, –t
qappiortorsuuvoq	V	(no generation)
qappiorunnaarpoq	V	(no generation)
qappisaarpoq	V	(no generation)
qappisippaa	V	(no generation)
qappitippaa	V	(no generation)
qappititsine¦q	N	–rup, –rit
qappititsivoq	V	(no generation)
qappivoq	V	(no generation)
qappuppaa	V	(no generation)
qapput	N	–ip, –it
qapputaavoq	V	(no generation)
qapputigaa	V	(no generation)
qapualavoq	V	(no generation)
qapuinna¦q	N	–ap, –at
qapu¦k	N	–up, –it
qapuppoq	V	(no generation)
qapussu¦aq	N	–up, –it
qaputtuinnaavoq	V	(no generation)
qapuusaa¦raq	N	–qqap, –qqat
qapuusa¦q	N	–p, –t
qaqajarlernart¦oq	N	–up, –ut
qaqajarlerne¦q	N	–rup, –rit
qaqajarlerpoq	V	(no generation)
qaqajarlers¦oq	N	–up, –ut
qaqajarler¦soq	N	{–sup, –tup}, {–sut, –tut}
qaqavoq	V	(no generation)
qaq¦eq	N	–ip, –it
qaqeqqaqaalaarpoq	V	(no generation)
qaqeqqaqaarpoq	V	(no generation)
qaqerluerpaa	V	(no generation)
qaqerluersivoq	V	(no generation)
qaqerlu¦k	N	–up, –it
qaqerluluppoq	V	(no generation)
qaqerluut	N	–ip, –it
qaqernilaarpoq	V	(no generation)
qaqernippoq	V	(no generation)
qaqersaat	N	–ip, –it
qaqersarpaa	V	(no generation)
qaqersarpoq	V	(no generation)
qaqersart¦oq	N	–up, –ut
qaqersivoq	V	(no generation)
Qaqiffi¦k	N	–up, –it
Qaqiffi¦k	Prop	–up, –it
qaqiffilia¦q	N	–p, –t
qaqileqqippaa	V	(no generation)
qaqilerpaa	V	(no generation)
qaqilerpoq	V	(no generation)
qaqilerut	N	–ip, –it
qaqilerut	N, pl.	-
qaqinia¦q	N	–p, –t
qaqinniaraluarniarpaa	V	(no generation)
qaqippaa	V	(no generation)
qaqisarfi¦k	N	–up, –it
qaqisine¦q	N	–rup, –rit
qaqisinngilaq	V	(no generation)
qaqi¦sinngitsoorneq	N	{–sinngitsoornerup, –tinngitsoornerup}, {–sinngitsoornerit, –tinngitsoornerit}
qaqisivoq	V	(no generation)
qaqis¦oq	N	–up, –ut
qaqissaanngilaq	V	(no generation)
qaqissut	N	–ip, –it
qaqitaajarpoq	V	(no generation)
qaqitaaruppoq	V	(no generation)
qaqitaavoq	V	(no generation)
qaqita¦q	N	–p, –t
qaqitartaarpoq	V	(no generation)
qaqitassaavoq	V	(no generation)
qaqitsiffi¦k	N	–up, –it
qaqit¦siffik	N	{–siffiup, –iffiup}, {–siffiit, –iffiit}
qaqitsisaannarpoq	V	(no generation)
qaqitsivoq	V	(no generation)
qaqivaa	V	(no generation)
qaqivoq	V	(no generation)
qaqoriarpaa	V	(no generation)
qaqorna¦k	N	–ap, –at
qaqornappoq	V	(no generation)
qaqornassimavoq	V	(no generation)
qaqornikuuvoq	V	(no generation)
qaqorpoq	V	(no generation)
qaqorsaat	N	–ip, –it
qaqorsaavoq	V	(no generation)
qaqorsarpaa	V	(no generation)
qaqorsiuppoq	V	(no generation)
qaqorsiut	N	–ip, –it
qaqorsivoq	V	(no generation)
qaqorsoqqut	N	–ip, –it
qaqorta¦q	N	–p, –t
qaqortippoq	V	(no generation)
qaqortitaarpoq	V	(no generation)
Qaqort¦oq	N	–up, –ut
Qaqort¦oq	Prop	–up
qaqort¦oq	N	–up, –ut
qaqortualu¦k	N	–up, –it
qaqortua¦raq	N	–qqap, –qqat
qaqortuinnaavoq	V	(no generation)
Qaqortukul¦ooq	N	–uup, –uut
Qaqortukul¦ooq	Prop	–uup
qaqortukul¦ooq	N	–uup, –uut
qaqortulia¦q	N	–p, –t
qaqortulisaarpoq	V	(no generation)
qaqortumaarpoq	V	(no generation)
qaqqaari¦k	N	–up, –it
qaqqaarissu¦aq	N	–up, –it
qaqqajunna¦k	N	–ap, –at
qaqqajunna¦q	N	–ap, –at
qaqqajunnassu¦aq	N	–up, –it
qaqqakinaarpaa	V	(no generation)
qaqqalaarpoq	V	(no generation)
qaqqalia¦q	N	–p, –t
qaqqaliarpoq	V	(no generation)
qaqqanngu¦aq	N	–up, –it
qaqqa¦q	N	–p, –t
qaqqaqarfi¦k	N	–up, –it
qaqqaqqalaarpoq	V	(no generation)
qaqqaqqalaaruppaa	V	(no generation)
qaqqarpasippoq	V	(no generation)
qaqqarsu¦aq	N	–up, –it
qaqqart¦ooq	N	–uup, –uut
qaqqartuvoq	V	(no generation)
qaqqaruuserpaa	V	(no generation)
qaqqaruuserpoq	V	(no generation)
qaqqasiortart¦oq	N	–up, –ut
qaqqasiort¦oq	N	–up, –ut
qaqqasippoq	V	(no generation)
qaqqassarippoq	V	(no generation)
qaqqasunna¦k	N	–ap, –at
qaqqasunnanngu¦aq	N	–up, –it
qaqqasunna¦q	N	–p, –t
qaqqat	N, pl.	-
qaqqiffi¦k	N	–up, –it
qaqqippaa	V	(no generation)
qaqqippoq	V	(no generation)
qaqqisaarpoq	V	(no generation)
qaqqittarfi¦k	N	–up, –it
qaqqi¦ttarfik	N	{–ssarfiup, –ttarfiup}, {–ssarfiit, –ttarfiit}
qaqqivigaa	V	(no generation)
qaqqivi¦k	N	–up, –it
qaqqivissaaruppoq	V	(no generation)
qaqqivissarsiorpoq	V	(no generation)
qaqqoriffaari¦k	N	–up, –it
qaqqorippoq	V	(no generation)
qaqqorissunngu¦aq	N	–up, –it
qaqqori¦ssunnguaq	N	{–ssunnguup, –ttunnguup}, {–ssunnguit, –ttunnguit}
qaqqorpaa	V	(no generation)
qaqqortari¦aq	N	{–ssap, –ap}, {–ssat, –at}
qaqqortari¦aq	N	–ssap, –ssat
qaqquaasa¦q	N	–p, –t
qaqqua¦q	N	–p, –t
qaqquarpaa	V	(no generation)
qaqquarpoq	V	(no generation)
qaqqulaa¦gaq	N	–kkap, –kkat
qaqqulaarpaa	V	(no generation)
qaqqulaarpoq	V	(no generation)
qaqquluppaa	V	(no generation)
qaqquluppoq	V	(no generation)
qaqquppaa	V	(no generation)
qaqqut	N	–ip, –it
qaqqutigaa	V	(no generation)
qaqu	N	–p, –t
qaquaa	V	(no generation)
qaquaarpoq	V	(no generation)
qaqualaarpoq	V	(no generation)
qaqualuttuinnaavoq	V	(no generation)
qaqua¦q	N	–p, –t
qaquarpoq	V	(no generation)
qaqugorsu¦aq	N	–up, –it
qaquisaarserpoq	V	(no generation)
qaquisaasa¦q	N	–p, –t
qaquis¦eq	N	–ip, –it
qaquit	N, pl.	-
qaqui¦t	N	–sip, –sit
qaquju¦k	N	–up, –it
qaqukuluppoq	V	(no generation)
qaqullu¦k	N	–up, –it
qaqullukulu¦k	N	–up, –it
qaqullunna¦q	N	–ap, –at
qaqunna¦k	N	–ap, –at
qaqunnappoq	V	(no generation)
qaqussoqqut	N	–ip, –it
qaqutigoorpoq	V	(no generation)
qaqutigoort¦oq	N	–up, –ut
qaqutippoq	V	(no generation)
qaquummappoq	V	(no generation)
qaraalaarpoq	V	(no generation)
qaraalavoq	V	(no generation)
qaraarne¦q	N	–rup, –rit
qaraarpalunne¦q	N	–rup, –rit
qaraarpaluppoq	V	(no generation)
qaraarpoq	V	(no generation)
qaraartorsuuvoq	V	(no generation)
qarajalla¦k	N	–ap, –at
qarajalliine¦q	N	–rup, –rit
qarajalline¦q	N	–rup, –rit
qarajallisa¦q	N	–p, –t
qarajallivaa	V	(no generation)
qarajall¦oq	N	–up, –ut
qarajallu¦k	N	–up, –it
qarajallussu¦aq	N	–up, –it
qarajanippoq	V	(no generation)
qara¦jaq	N	–ssap, –ssat
qarajarl¦eq	N	{–erup, –iup}, {–erit, –iit}
qarasaa¦raq	N	–qqap, –qqat
qarasaasialerine¦q	N	–rup, –rit
qarasaasia¦q	N	–p, –t
qarasaasiaqarfi¦k	N	–up, –it
qarasaasiar¦sorneq	N	{–sornerup, –tornerup}, {–sornerit, –tornerit}
qarasaasiat	N, pl.	-
qarasagippoq	V	(no generation)
qarasakippoq	V	(no generation)
qara¦saq	N	–tsap, –tsat
qarasarippoq	V	(no generation)
qarasarsorne¦q	N	–rup, –rit
qarasar¦sorneq	N	{–sornerup, –tornerup}, {–sornerit, –tornerit}
qarasarsorpoq	V	(no generation)
qarasserpoq	V	(no generation)
qarassivaa	V	(no generation)
qaratserfi¦k	N	–up, –it
qaratserfiss¦ooq	N	–uup, –uut
qarleqarpoq	V	(no generation)
qarliingajuippoq	V	(no generation)
qarliingasaannarpoq	V	(no generation)
qarliingavoq	V	(no generation)
qarliit	N, pl.	-
qarlilerpaa	V	(no generation)
qarlilerpoq	V	(no generation)
qarlingerpaa	V	(no generation)
qarlingerpoq	V	(no generation)
qarlingersimavoq	V	(no generation)
qarlippaa	V	(no generation)
qarlippaartaarpoq	V	(no generation)
qarlippaat	N, pl.	-
qarlippoq	V	(no generation)
qarlisarpoq	V	(no generation)
qarlissaarpoq	V	(no generation)
qarlissaartippaa	V	(no generation)
qarli¦ssaat	N	{–ssaatip, –ttaatip}, {–ssaatit, –ttaatit}
qarlissiaaruppoq	V	(no generation)
qarlissia¦q	N	–p, –t
qarliss¦ooq	N	–uup, –uut
qarlissorpaa	V	(no generation)
qarlissorpoq	V	(no generation)
qarlisuuvoq	V	(no generation)
qarlittaarpoq	V	(no generation)
qarlivaa	V	(no generation)
qarlivoq	V	(no generation)
qarl¦oq	N	–up, –ut
qarloqqort¦ooq	N	–uup, –uut
qarlormiu	N	–p, –t
qarlorne¦q	N	–rup, –rit
qarlorpoq	V	(no generation)
qarlortaasiorpoq	V	(no generation)
qarlortaassu¦aq	N	–up, –it
qarlortaat	N	–ip, –it
qarlortaat	N, pl.	-
qarlortaataasa¦q	N	–p, –t
qarlortaataavoq	V	(no generation)
qarlortaatee¦raq	N	–qqap, –qqat
qarlortallaqqippoq	V	(no generation)
qarlortarpoq	V	(no generation)
qarlortarsinnaavoq	V	(no generation)
qarlorujoorpoq	V	(no generation)
qarlorujuppoq	V	(no generation)
qarluaasa¦q	N	–p, –t
qarluallanngilaq	V	(no generation)
qarlualuppoq	V	(no generation)
qarlua¦q	N	–p, –t
qarluisaarpaa	V	(no generation)
qarluisaarpoq	V	(no generation)
qarluiusal¦ik	N	{–iup, –lip, –lup}, –lit
qarlulavoq	V	(no generation)
qarlumaats¦oq	N	–up, –ut
qarluu¦seq	N	–tsip, –tsit
qarluut	N	–ip, –it
qarluutitoorna¦q	N	–p, –t
qarluutitoorsu¦aq	N	–up, –it
qarmaappaa	V	(no generation)
qarmaas¦oq	N	–up, –ut
qarmaavoq	V	(no generation)
qarmagaavoq	V	(no generation)
qarma¦gaq	N	–kkap, –kkat
qarmagassa¦q	N	–p, –t
qarmanippoq	V	(no generation)
qarma¦q	N	–p, –t
qarmarpaa	V	(no generation)
qarmarpoq	V	(no generation)
qarmasi¦k	N	–up, –it
qarmasissialiorpoq	V	(no generation)
qarmasissia¦q	N	–p, –t
qarmasissiorpoq	V	(no generation)
qarmassa¦q	N	–p, –t
qarmassia¦q	N	–p, –t
qarmat	N, pl.	-
qarnaniitippaa	V	(no generation)
qarnaniitippoq	V	(no generation)
qarnganiitippaa	V	(no generation)
qarnganiitippoq	V	(no generation)
qarnginnarpoq	V	(no generation)
qarngusa¦q	N	–p, –t
qarninnarpoq	V	(no generation)
qarrak¦oq	N	–up, –ut
qarra¦q	N	–p, –t
qarrarippoq	V	(no generation)
qarruppaa	V	(no generation)
qarrussaavoq	V	(no generation)
qarrussa¦q	N	–p, –t
qarrussarpaa	V	(no generation)
qarrussartorpoq	V	(no generation)
qarrutaarpoq	V	(no generation)
qarrutinngilaa	V	(no generation)
qarrutinngitsoorpaa	V	(no generation)
qarrutitippaa	V	(no generation)
qarrut¦itippoq	V	{–itinngilaq, –sinngilaq}
qarsaa¦q	N	–p, –t
qarsaarpaluppoq	V	(no generation)
qarsivoq	V	(no generation)
qars¦oq	N	–up, –ut
qarsorne¦q	N	–rup, –rit
qarsornerits¦oq	N	–up, –ut
qarsornil¦ik	N	{–iup, –lip, –lup}, –lit
qarsorpaa	V	(no generation)
qarsorpoq	V	(no generation)
qarsorsaarpaa	V	(no generation)
qarsorsaasa¦q	N	–p, –t
qarsorsaat	N	–ip, –it
qarsorsa¦q	N	–p, –t
qarsorsarfi¦k	N	–up, –it
qarsorsarpaa	V	(no generation)
qarsorsart¦oq	N	–up, –ut
qarsorserpaa	V	(no generation)
qarsorsiorpoq	V	(no generation)
qarsuasorsuuvoq	V	(no generation)
qarsuatippaa	V	(no generation)
qarsuavaa	V	(no generation)
qarsuavoq	V	(no generation)
qarsuliorpoq	V	(no generation)
qarsulivi¦k	N	–up, –it
qarsullerpaa	V	(no generation)
qarsungalluinnarpoq	V	(no generation)
qarsungallu¦innartoq	N	{–aannartup, –innartup}, {–aannartut, –innartut}
qarsungas¦oq	N	–up, –ut
qarsungassutigaa	V	(no generation)
qarsungavallaarpoq	V	(no generation)
qarsungavoq	V	(no generation)
qarsunne¦q	N	–rup, –rit
qarsupippoq	V	(no generation)
qarsupitt¦oq	N	–up, –ut
qarsupi¦ttoq	N	{–ssup, –ttup}, {–ssut, –ttut}
qarsuppaa	V	(no generation)
qarsusungarpaa	V	(no generation)
qarsu¦tsineq	N	{–ssinerup, –tsinerup}, {–ssinerit, –tsinerit}
qarsu¦tsineqarneq	N	{–ssineqarnerup, –tsineqarnerup}, {–ssineqarnerit, –tsineqarnerit}
qarsutsivoq	V	(no generation)
qarsuuppaa	V	(no generation)
qarsuusa¦q	N	–p, –t
qarsuusivi¦k	N	–up, –it
qartoraappoq	V	(no generation)
qartorarpoq	V	(no generation)
qasaarlaa¦q	N	–p, –t
qasaarlaat	N	–ip, –it
qasaarlaat	N, pl.	-
qasaarla¦q	N	–p, –t
qasaarpoq	V	(no generation)
qasagaa	V	(no generation)
qasalla¦k	N	–ap, –at
qasal¦oq	N	–lup, –lut
qasalorterpaa	V	(no generation)
qasariarsarpoq	V	(no generation)
qasaru¦aq	N	–ssap, –ssat
qasaruartorpoq	V	(no generation)
qasassaavoq	V	(no generation)
qas¦eq	N	–ip, –it
qaserne¦q	N	–rup, –rit
qaserpoq	V	(no generation)
qasersarpaa	V	(no generation)
qasersarpoq	V	(no generation)
qasertippaa	V	(no generation)
qasertippoq	V	(no generation)
qasert¦oq	N	–up, –ut
qaser¦toq	N	{–sup, –tup}, {–sut, –tut}
qasertuinnaavoq	V	(no generation)
qaserujutt¦oq	N	–up, –ut
qasia¦q	N	–p, –t
qasiarneruvoq	V	(no generation)
qasiarpoq	V	(no generation)
qasiart¦oq	N	–up, –ut
qasigiaa¦raq	N	–qqap, –qqat
qasigi¦aq	N	–ssap, –ssat
qasigia¦raq	N	–qqap, –qqat
qasigiarniarpoq	V	(no generation)
qasigiarpoq	V	(no generation)
qasigiarsu¦aq	N	–up, –it
qasigiatsia¦q	N	–ap, –at
qasigiinna¦q	N	–ap, –at
qasigiusa¦q	N	–p, –t
qasiiarpaa	V	(no generation)
qasiiarpoq	V	(no generation)
qasiiaruminaappoq	V	(no generation)
qasil¦eeq	N	–iip, –iit
qasilippallaanngilaq	V	(no generation)
qasilippoq	V	(no generation)
qasilits¦oq	N	–up, –ut
qasilitsorsunni	N	–p, –t
qasilitsulivi¦k	N	–up, –it
qasiliunnaarpoq	V	(no generation)
qasilivoq	V	(no generation)
qasillerpoq	V	(no generation)
qasillersippaa	V	(no generation)
qasillersoorpoq	V	(no generation)
qasilliarpaluppoq	V	(no generation)
qasinngorpoq	V	(no generation)
qasooriartorpoq	V	(no generation)
qasoorpoq	V	(no generation)
qasoorsimavoq	V	(no generation)
qasoortippaa	V	(no generation)
qasoqqaannarpoq	V	(no generation)
qasoqqajunnaarpoq	V	(no generation)
qasoqqarpasinne¦q	N	–rup, –rit
qasoqqavoq	V	(no generation)
qasorilluarpoq	V	(no generation)
qasorippoq	V	(no generation)
qasorpasippoq	V	(no generation)
qassaakkumavaa	V	(no generation)
qassaappaa	V	(no generation)
qassalippaa	V	(no generation)
qassannerits¦oq	N	–up, –ut
qassappaa	V	(no generation)
qassappoq	V	(no generation)
qassarippoq	V	(no generation)
qassarissivoq	V	(no generation)
qassariss¦oq	N	–up, –ut
qassari¦ssoq	N	{–ssup, –ttup}, {–ssut, –ttut}
qassarivippoq	V	(no generation)
qassarpoq	V	(no generation)
qasseeraarpoq	V	(no generation)
qasseeraartaannarpoq	V	(no generation)
qasseeraliorpoq	V	(no generation)
qasseeriarajuppoq	V	(no generation)
qasseeriarpaa	V	(no generation)
qasseeriarpoq	V	(no generation)
qasseersiut	N	–ip, –it
qasseersuit	N, pl.	-
qasseriaraluarnerpoq	V	(no generation)
qasserpaa	V	(no generation)
qassersu¦aq	N	–up, –it
qassi	N	–p, –t
Qassiarsu¦k	N	–up, –it
Qassiarsu¦k	Prop	–up, –it
qassiiarpaa	V	(no generation)
qassiiliuutigaa	V	(no generation)
qassiit	N, pl.	-
qassimaannarpoq	V	(no generation)
qassimagajuppoq	V	(no generation)
qassimas¦oq	N	–up, –ut
qassimasorsiorpoq	V	(no generation)
qassimavoq	V	(no generation)
qassimiuaarfi¦k	N	–up, –it
qassimiuaarne¦q	N	–rup, –rit
qassimiuaartitsivoq	V	(no generation)
qassiuppaa	V	(no generation)
qassiussu¦seq	N	–tsip, –tsit
qassiussu¦seq	N	–tsit
qassiussusersiut	N	–ip, –it
qassiussusersiut	N	–it
qassivaa	V	(no generation)
qassivoq	V	(no generation)
qassoraavoq	V	(no generation)
qassorpoq	V	(no generation)
qassuaat	N	–ip, –it
qassuarfi¦k	N	–up, –it
qassuarpaa	V	(no generation)
qassuppaa	V	(no generation)
qassuppoq	V	(no generation)
qassuserpoq	V	(no generation)
qassusiarpoq	V	(no generation)
qassusiorpaa	V	(no generation)
qassusiorpoq	V	(no generation)
qassusivaa	V	(no generation)
qassusivoq	V	(no generation)
qassut	N	–ip, –it
qassutaarserpoq	V	(no generation)
qassutaasiorpoq	V	(no generation)
qassutit	N, pl.	-
qassutsiimivaa	V	(no generation)
qassutsippaa	V	(no generation)
qassuumisippaa	V	(no generation)
qassuumivoq	V	(no generation)
qasuallaalinngilaq	V	(no generation)
qasuallaaqaaq	V	(no generation)
qasuallaaraluarpoq	V	(no generation)
qasuallaarpaluppoq	V	(no generation)
qasuallaarpasippoq	V	(no generation)
qasuallaarpoq	V	(no generation)
qasuallaarunanngilaq	V	(no generation)
qasuallaarunarpoq	V	(no generation)
qasuerfi¦k	N	–up, –it
qasuerfissaqanngilaq	V	(no generation)
qasuerfissarsivoq	V	(no generation)
qasuernart¦oq	N	–up, –ut
qasuerpoq	V	(no generation)
qasuersaarfi¦k	N	–up, –it
qasuer¦saarfik	N	{–saarfiup, –taarfiup}, {–saarfiit, –taarfiit}
qasuersaarne¦q	N	–rup, –rit
qasuer¦saarneq	N	{–saarnerup, –taarnerup}, {–saarnerit, –taarnerit}
qasuersaarpoq	V	(no generation)
qasuersaartitsine¦q	N	–rup, –rit
qasuersaarut	N	–ip, –it
qasuersaaserpaa	V	(no generation)
qasuersaatigaa	V	(no generation)
qasuerserne¦q	N	–rup, –rit
qasuerserpoq	V	(no generation)
qasuersimavoq	V	(no generation)
qasugaluaqaaq	V	(no generation)
qasuippoq	V	(no generation)
qasuiss¦oq	N	–up, –ut
qasui¦ssoq	N	{–ssup, –ttup}, {–ssut, –ttut}
qasujaassu¦seq	N	–tsip, –tsit
qasujaats¦oq	N	–up, –ut
qasujunnarsivippoq	V	(no generation)
qasukkarne¦q	N	–rup, –rit
qasukkarpoq	V	(no generation)
qasukkarsimalerpoq	V	(no generation)
qasukkarsimas¦oq	N	–up, –ut
qasukkiartorpoq	V	(no generation)
qasukkunnaqaaq	V	(no generation)
qasukkuppaa	V	(no generation)
qasulerunnarsivoq	V	(no generation)
qasulluinnarpoq	V	(no generation)
qasunarluinnart¦oq	N	–up, –ut
qasunarpoq	V	(no generation)
qasunart¦oq	N	–up, –ut
qasune¦q	N	–rup, –rit
qasungaannarpoq	V	(no generation)
qasungajunnaarpoq	V	(no generation)
qasungasoorpoq	V	(no generation)
qasungas¦oq	N	–up, –ut
qasungasormioraa	V	(no generation)
qasungavoq	V	(no generation)
qasunngat	N	–ip, –it
qasuppaa	V	(no generation)
qasuppoq	V	(no generation)
qasusaannarpoq	V	(no generation)
qasusaat	N	–ip, –it
qasusarpoq	V	(no generation)
qasusoorne¦q	N	–rup, –rit
qasusoorpoq	V	(no generation)
qasusoorsimas¦oq	N	–up, –ut
qasusuippoq	V	(no generation)
qasusuissu¦seq	N	–tsip, –tsit
qasusuits¦oq	N	–up, –ut
qasutalluinnarpoq	V	(no generation)
qasutappoq	V	(no generation)
qasuteqqippaa	V	(no generation)
qasuterivoq	V	(no generation)
qasuterpaa	V	(no generation)
qasutippaa	V	(no generation)
qasutsippaa	V	(no generation)
qasutsivoq	V	(no generation)
qasutsuippoq	V	(no generation)
qasuttoorpoq	V	(no generation)
qasuvoq	V	(no generation)
qataajaqivallaaqaaq	V	(no generation)
qataajaqivoq	V	(no generation)
qataalligaluttuinnarpoq	V	(no generation)
qataallisaarpoq	V	(no generation)
qataallivoq	V	(no generation)
qataanneerpoq	V	(no generation)
qataanne¦q	N	–rup, –rit
qataappoq	V	(no generation)
qatangiinnarpoq	V	(no generation)
qatangippoq	V	(no generation)
qatanngut	N	–ip, –it
qatanngutaalluarpoq	V	(no generation)
qatanngutaavoq	V	(no generation)
qatanngutigaa	V	(no generation)
qatanngutigiinniat	N, pl.	-
qatanngutisia¦q	N	–p, –t
qatanngutissa¦q	N	–p, –t
qatigaarpoq	V	(no generation)
qatiga¦k	N	–ap, –at
qatigal¦ik	N	{–iup, –lip, –lup}, –lit
qatigalluppoq	V	(no generation)
qatigatt¦ooq	N	–uup, –uut
qatigattuusa¦q	N	–p, –t
qatiggerpoq	V	(no generation)
qatiggersoorpoq	V	(no generation)
qatiingaarpoq	V	(no generation)
qatiingane¦q	N	–rup, –rit
qatiingaqaaq	V	(no generation)
qatiingas¦oq	N	–up, –ut
qatiingavallaaqaaq	V	(no generation)
qatiingavoq	V	(no generation)
qati¦k	N	–up, –it
qatikillivoq	V	(no generation)
qatikippoq	V	(no generation)
qatimaaffigaa	V	(no generation)
qatimaanne¦q	N	–rup, –rit
qatimaappaa	V	(no generation)
qatimaappalaarpoq	V	(no generation)
qatimaa¦ppoq	V	–nngilaq
qatimaa¦q	N	–p, –t
qatimaattorsuuvoq	V	(no generation)
qatimaluppoq	V	(no generation)
qatimaluttuinnaavoq	V	(no generation)
qatimaluuppaa	V	(no generation)
qatimmippaa	V	(no generation)
qatimmippoq	V	(no generation)
qatit¦ooq	N	–uup, –uut
qatitoorpaa	V	(no generation)
qatitoorpaluppoq	V	(no generation)
qatitoorpoq	V	(no generation)
qatitoorsorpoq	V	(no generation)
qatitoorsu¦aq	N	–up, –it
qatittorpaa	V	(no generation)
qatittorpoq	V	(no generation)
qatittorsimavoq	V	(no generation)
qatittoruloorpoq	V	(no generation)
qatittuuppaa	V	(no generation)
qatitujaarsu¦aq	N	–up, –it
qatitulerpoq	V	(no generation)
qatitune¦q	N	–rup, –rit
qatit¦uneq	N	{–ornup, –unerup}, {–ornit, –unerit}
qatituvoq	V	(no generation)
qatserine¦q	N	–rup, –rit
qatserisart¦oq	N	–up, –ut
qatserisartoqarfi¦k	N	–up, –it
qatserisartoqarne¦q	N	–rup, –rit
qatserisartut	N, pl.	-
qatseris¦oq	N	–up, –ut
qatserivoq	V	(no generation)
qatserpaa	V	(no generation)
qatsersorluarpaa	V	(no generation)
qatsersorpaa	V	(no generation)
qatserut	N	–ip, –it
qatserutaasivi¦k	N	–up, –it
qatserutaavoq	V	(no generation)
qatsiaqerpalu¦k	N	–up, –it
qatsiarpoq	V	(no generation)
qatsinne¦q	N	–rup, –rit
qatsinnersaavoq	V	(no generation)
qatsinnersa¦q	N	–p, –t
qatsinnersarsu¦aq	N	–up, –it
qatsinnerulaarpoq	V	(no generation)
qatsinneruvoq	V	(no generation)
qatsiorpaa	V	(no generation)
qatsiorpoq	V	(no generation)
qatsi¦ppoq	V	–nngilaq
qatsissortoormiu	N	–p, –t
qatsivippoq	V	(no generation)
qatsivoq	V	(no generation)
qatsoriartorpoq	V	(no generation)
qatsorippoq	V	(no generation)
qatsorpoq	V	(no generation)
qatsorumaataarpoq	V	(no generation)
qatsoruttorpoq	V	(no generation)
qatsumii¦ppoq	V	–nngilaq
qatsumiitippaa	V	(no generation)
qatsungagajuppoq	V	(no generation)
qatsungane¦q	N	–rup, –rit
qatsunganersu¦aq	N	–up, –it
qatsungasaannarpoq	V	(no generation)
qatsungattorpoq	V	(no generation)
qatsungavoq	V	(no generation)
qatsunnaqaaq	V	(no generation)
qatsunngari¦k	N	–up, –it
qatsunngarissu¦aq	N	–up, –it
qatsuppaa	V	(no generation)
qatsussaavoq	V	(no generation)
qatsussa¦q	N	–p, –t
qatsussine¦q	N	–rup, –rit
qatsussivoq	V	(no generation)
qatsutsuinaarpaa	V	(no generation)
qatsuumisaarpoq	V	(no generation)
qatsuumivoq	V	(no generation)
qattaa¦raq	N	–qqap, –qqat
qattaarpaa	V	(no generation)
qattaarserpoq	V	(no generation)
qattaarsertaannarpoq	V	(no generation)
qattaavak¦oq	N	–up, –ut
qattaava¦q	N	–p, –t
qattaavartaarpoq	V	(no generation)
qattaliorpoq	V	(no generation)
qatta¦q	N	–p, –t
qattarsivoq	V	(no generation)
qattarsu¦aq	N	–up, –it
qattartaarpoq	V	(no generation)
qattoraappoq	V	(no generation)
qattujaarpoq	V	(no generation)
qattulaarpoq	V	(no generation)
qattune¦q	N	–rup, –rit
qatt¦uneq	N	{–ornup, –unerup}, {–ornit, –unerit}
qattunerasaa¦q	N	–p, –t
qattunersaavoq	V	(no generation)
qattunersa¦q	N	–p, –t
qattuner¦saq	N	{–sap, –tap}, {–sat, –tat}
qattuneruvoq	V	(no generation)
qattunnippoq	V	(no generation)
qattusivoq	V	(no generation)
qattu¦sooq	N	{–suup, –tuup}, {–suut, –tuut}
qattutsi¦ppoq	V	–nngilaq
qattuusaarpoq	V	(no generation)
qattuvoq	V	(no generation)
qavaarpaluppoq	V	(no generation)
qavaavoq	V	(no generation)
qava¦k	N	–ap, –at
qavanii¦ppoq	V	–nngilaq
qavaniissimavoq	V	(no generation)
qavannga¦q	N	–p, –t
qavanngarni¦saq	N	–tsap, –tsat
qavanngarpoq	V	(no generation)
qavanngarsarnerpoq	V	(no generation)
qavanngarsu¦aq	N	–up, –it
qavappaluppoq	V	(no generation)
qavaru¦seq	N	–tsip, –tsit
qavassivoq	V	(no generation)
qavavi¦k	N	–up, –it
qavungaannaqqooqaaq	V	(no generation)
qavungaannarpoq	V	(no generation)
qavunnaappaa	V	(no generation)
qavunnaa¦q	N	–p, –t
qavunnarpoq	V	(no generation)
qavunnart¦oq	N	–up, –ut
qavuunaqquppaa	V	(no generation)
qavuunaqquppoq	V	(no generation)
q¦eeq	N	–iip, –iit
qeeqalerpoq	V	(no generation)
qeeqarpoq	V	(no generation)
qeeraa¦raq	N	–qqap, –qqat
qeeraasa¦q	N	–p, –t
qeeraatsia¦q	N	–p, –t
qeeraatsi¦aq	N	–up, –it
qee¦raq	N	–qqap, –qqat
qeerlerpaa	V	(no generation)
qeerlimiusaarfi¦k	N	–up, –it
qeerlimiusaarpoq	V	(no generation)
qeerlisaarpaa	V	(no generation)
qeerliukkaarpoq	V	(no generation)
qeerliukkaarusiorpoq	V	(no generation)
qeerliukkaarut	N	–ip, –it
qeerliussaarpoq	V	(no generation)
qeerluaqatsivoq	V	(no generation)
qeerluaqitsivoq	V	(no generation)
qeerlut¦ooq	N	–uup, –uut
qeerlutoorna¦q	N	–p, –t
qeerlutoorniarpoq	V	(no generation)
qeerlutuua¦raq	N	–qqap, –qqat
qeerlutuupiarsu¦k	N	–up, –it
qeerraavaa	V	(no generation)
qeerrappoq	V	(no generation)
qeersaa¦q	N	–p, –t
qeersaarpoq	V	(no generation)
qeersaart¦oq	N	–up, –ut
qeersaartuinnaavoq	V	(no generation)
qeerseraarpoq	V	(no generation)
qeers¦ooq	N	–uup, –uut
qeersoorsu¦aq	N	–up, –it
qeersorpoq	V	(no generation)
qeersu¦aq	N	–up, –it
qeersuuvoq	V	(no generation)
qeertorpoq	V	(no generation)
qeqaannarpoq	V	(no generation)
qeqaannarumavoq	V	(no generation)
qeqaat	N	–ip, –it
qeqaqat	N	–ip, –it
qeqarallarpoq	V	(no generation)
qeqarfi¦k	N	–up, –it
qeqarne¦q	N	–rup, –rit
qeqarpoq	V	(no generation)
qeqarti	N	–p, –t
qeqartippaa	V	(no generation)
qeqartitsivoq	V	(no generation)
qeqart¦oq	N	–up, –ut
qeqartuarpoq	V	(no generation)
qeqartussa¦q	N	–p, –t
Qeqertaalu¦k	N	–up, –it
Qeqertaalu¦k	Prop	–up, –it
qeqertaa¦raq	N	–qqap, –qqat
qeqertaasa¦q	N	–p, –t
qeqertaatsia¦q	N	–p, –t
qeqertaatsi¦aq	N	–up, –it
qeqertanngu¦aq	N	–up, –it
qeqerta¦q	N	–p, –t
qeqertarmiu	N	–p, –t
qeqertarpassuaqarfi¦k	N	–up, –it
Qeqertarsu¦aq	N	–up, –it
Qeqertarsu¦aq	Prop	–up
qeqertarsu¦aq	N	–up, –it
Qeqertarsuatsia¦q	N	–ap, –at
qeqertasussu¦k	N	–up, –it
Qeqertat	N, pl.	-
qeqertavaanngu¦aq	N	–up, –it
qeqertavaaqi	N	–p, –t
qeq¦oq	N	–up, –ut
qeqorpaa	V	(no generation)
qeqqaarippoq	V	(no generation)
qeqqaarissaarpoq	V	(no generation)
qeqqaarissimavoq	V	(no generation)
qeqqaariss¦oq	N	–up, –ut
qeqqaari¦ssoq	N	{–ssup, –ttup}, {–ssut, –ttut}
q¦eqqaniippoq	V	{–eqqaniinngilaq, –itianiinngilaq}
qeqqarippoq	V	(no generation)
qeqqarissu¦seq	N	–tsip, –tsit
qeqqaserpoq	V	(no generation)
qeqqasiorpoq	V	(no generation)
qeqqiarnarpoq	V	(no generation)
qeqqilluarpoq	V	(no generation)
qeqqippoq	V	(no generation)
qeqquanippoq	V	(no generation)
qeqqu¦aq	N	–ssap, –ssat
qeqquaraarsu¦k	N	–up, –it
qeqquarsu¦aq	N	–up, –it
qeqqu¦seq	N	–tsip, –tsit
qeqqusserpoq	V	(no generation)
qequ¦iaaneq	N	{–ajaanerup, –iaanerup}, {–ajaanerit, –iaanerit}
qequl¦ik	N	{–iup, –lip, –lup}, –lit
qequlissu¦aq	N	–up, –it
qequusa¦q	N	–p, –t
qeraaluppaluppoq	V	(no generation)
qeraaluppoq	V	(no generation)
qeraarpallarippoq	V	(no generation)
qeraarpalunne¦q	N	–rup, –rit
qeraarpaluppoq	V	(no generation)
qeraarpoq	V	(no generation)
qeraaserpoq	V	(no generation)
qeratalaarpoq	V	(no generation)
qeratalappoq	V	(no generation)
qerataluppoq	V	(no generation)
qeratalutt¦oq	N	–up, –ut
qeratas¦ooq	N	–uup, –uut
qerata¦sooq	N	{–suup, –tuup}, {–suut, –tuut}
qeratas¦oq	N	–up, –ut
qeratavoq	V	(no generation)
qerattaarippoq	V	(no generation)
qerattaat	N	–ip, –it
qerattaqquserpaa	V	(no generation)
qerattaqqusersorpaa	V	(no generation)
qerattaqqut	N	–ip, –it
qerattarpoq	V	(no generation)
qerattarsaat	N	–ip, –it
qerattarsarpaa	V	(no generation)
qerattarsiivaa	V	(no generation)
qerattarsimas¦oq	N	–up, –ut
qeriia¦k	N	–ap, –at
qerimmappoq	V	(no generation)
qerinarpoq	V	(no generation)
qerinnarfi¦k	N	–up, –it
qerinnarpoq	V	(no generation)
qerinnarsivoq	V	(no generation)
qerinne¦q	N	–rup, –rit
qerippaa	V	(no generation)
qerippoq	V	(no generation)
qerisippaa	V	(no generation)
qerisoorne¦q	N	–rup, –rit
qerisoorpoq	V	(no generation)
qeris¦oq	N	–up, –ut
qeritita¦q	N	–p, –t
qerititsine¦q	N	–rup, –rit
qerititsivi¦k	N	–up, –it
qerititsi¦vik	N	{–ffiup, –viup}, {–ffiit, –viit}
qerititsivoq	V	(no generation)
qeritserpaa	V	(no generation)
qeritserpoq	V	(no generation)
qeriunnaarpoq	V	(no generation)
qerivippoq	V	(no generation)
qerivoq	V	(no generation)
qerlaarpaa	V	(no generation)
qerlaartorsuuaa	V	(no generation)
qerla¦q	N	–p, –t
qerlaquserpaa	V	(no generation)
qerlaqut	N	–ip, –it
qerlerniarpaa	V	(no generation)
qerlerpaa	V	(no generation)
qerlertorpaa	V	(no generation)
qerlertoruuppoq	V	(no generation)
qerlertuuppoq	V	(no generation)
qerleruppaa	V	(no generation)
qerluffi¦k	N	–up, –it
qerluppaa	V	(no generation)
qerluppoq	V	(no generation)
qerlussivoq	V	(no generation)
qerlusungarpaa	V	(no generation)
qernaallagaa	V	(no generation)
qernaalla¦k	N	–ap, –at
qernaallappoq	V	(no generation)
qernaaluppoq	V	(no generation)
qernaarpalaarpoq	V	(no generation)
qernalaa¦q	N	–p, –t
qernaluaa¦q	N	–p, –t
qernaluaarpoq	V	(no generation)
qernaluppoq	V	(no generation)
qernalussivoq	V	(no generation)
qernalutsi¦ppoq	V	–nngilaq
qernalutt¦oq	N	–up, –ut
qernaluttuinnaavoq	V	(no generation)
qernari¦k	N	–up, –it
qernarilluinnarpoq	V	(no generation)
qernarippoq	V	(no generation)
qernarissuunngilaq	V	(no generation)
qernarivi¦k	N	–up, –it
qernarpaa	V	(no generation)
qernarpoq	V	(no generation)
qerne¦q	N	–rup, –rit
qerneqqerpoq	V	(no generation)
qerneraalerpoq	V	(no generation)
qerneraaluppoq	V	(no generation)
qerneraanngu¦aq	N	–up, –it
qerneraannguarpoq	V	(no generation)
qerneraa¦q	N	–p, –t
qerneraarne¦q	N	–rup, –rit
qerneraarpoq	V	(no generation)
qernerpoq	V	(no generation)
qernersaaserpaa	V	(no generation)
qernersaat	N	–ip, –it
qernersarpaa	V	(no generation)
qernertaarsu¦k	N	–up, –it
qernerta¦q	N	–p, –t
qernertikkaluttuinnarpoq	V	(no generation)
qernert¦oq	N	–up, –ut
qernertormi¦oq	N	–up, –ut
qernertormiu	N	–p, –t
Qernertuarsuit	N, pl.	-
qernerujutt¦oq	N	–up, –ut
qernerusivi¦k	N	–up, –it
qernerut	N	–ip, –it
qerngusserpoq	V	(no generation)
qerngussersorpoq	V	(no generation)
qerngut	N	–ip, –it
qernialuttuinnaavoq	V	(no generation)
qernipaaj¦ooq	N	–uup, –uut
qernipaluppoq	V	(no generation)
qernualavoq	V	(no generation)
qernu¦aq	N	–ssap, –ssat
qernusserpoq	V	(no generation)
qernussersorpoq	V	(no generation)
qernut	N	–ip, –it
qerrappoq	V	(no generation)
qerrarippoq	V	(no generation)
qerrarissivoq	V	(no generation)
qerrassimavoq	V	(no generation)
qerrorasaa¦q	N	–p, –t
qerrorasaarpoq	V	(no generation)
qerruppaa	V	(no generation)
qerruppoq	V	(no generation)
qerrussaavoq	V	(no generation)
qerrussa¦q	N	–p, –t
qerrut	N, pl.	-
qerrutitippaa	V	(no generation)
qerrut¦itippoq	V	{–itsinngilaq, –sitsinngilaq, –itinngilaq, –sinngilaq}
qersutarpaa	V	(no generation)
qerunne¦q	N	–rup, –rit
qeruppoq	V	(no generation)
qerussorpaa	V	(no generation)
qerussorpoq	V	(no generation)
qerutit	N, pl.	-
qia	N	–p, –t
qiaa¦gaq	N	–kkap, –kkat
qiaa¦q	N	–p, –t
qiaaraa	V	(no generation)
qiaarisa¦q	N	–p, –t
qiaarpaa	V	(no generation)
qiaarpoq	V	(no generation)
qiaarsivoq	V	(no generation)
qiaatigaa	V	(no generation)
qiagajuppoq	V	(no generation)
qiagajutt¦oq	N	–up, –ut
qiagajuut	N	–ip, –it
qiagajuut	N, pl.	-
qiajanerulluinnalerpoq	V	(no generation)
qiajanerulluinnarpoq	V	(no generation)
qiajaneruvoq	V	(no generation)
qiajanngilaq	V	(no generation)
qiajartorpoq	V	(no generation)
qiajavallaarpoq	V	(no generation)
qiajavoq	V	(no generation)
qiajuataarpoq	V	(no generation)
qiajumatuvoq	V	(no generation)
qiajunnaartinniarsaraa	V	(no generation)
qia¦k	N	–ap, –at
qiakkaavoq	V	(no generation)
qialluulavoq	V	(no generation)
qiamersorpaa	V	(no generation)
qiammiartorpoq	V	(no generation)
qiammiartuutigaa	V	(no generation)
qiangaarpoq	V	(no generation)
qiangaarsuppoq	V	(no generation)
qiangiilippoq	V	(no generation)
qianissarpoq	V	(no generation)
qianngoorne¦q	N	–rup, –rit
qianngoorpoq	V	(no generation)
qianngujoorne¦q	N	–rup, –rit
qianngujoorpoq	V	(no generation)
qianngujoortitsivoq	V	(no generation)
qiannisorujussuuvoq	V	(no generation)
qiannivoq	V	(no generation)
qiaqqammerpaa	V	(no generation)
qiaqqammerpoq	V	(no generation)
qiarsulavoq	V	(no generation)
qiarsunne¦q	N	–rup, –rit
qiarsuppoq	V	(no generation)
qiarujoorpoq	V	(no generation)
qiarujuppoq	V	(no generation)
qiarusaarne¦q	N	–rup, –rit
qiarusaarpoq	V	(no generation)
qiaruusaarpoq	V	(no generation)
qiasa¦q	N	–p, –t
qiasorujussuuvoq	V	(no generation)
qiassa¦q	N	–p, –t
qiassu¦aq	N	–up, –it
qiasuarpaluppoq	V	(no generation)
qiasunnguvoq	V	(no generation)
qiatippaa	V	(no generation)
qiat¦ooq	N	–uup, –uut
qiatoorsu¦aq	N	–up, –it
qiatuvoq	V	(no generation)
qiavaa	V	(no generation)
qiavoq	V	(no generation)
qiffarilluinnarpoq	V	(no generation)
qiffarippoq	V	(no generation)
qiffarissivoq	V	(no generation)
qiffuppaa	V	(no generation)
qiiaammeriataarpoq	V	(no generation)
qiiaammerpoq	V	(no generation)
qiiaammersorujussuuvoq	V	(no generation)
qiiaammivoq	V	(no generation)
qiiaarserajuppoq	V	(no generation)
qiiaarserpoq	V	(no generation)
qiiaarsertuarpoq	V	(no generation)
qiiajavoq	V	(no generation)
qiiakkuppaa	V	(no generation)
qiiakkussivoq	V	(no generation)
qiianaqaaq	V	(no generation)
qiianaqis¦oq	N	–up, –ut
qiianaraa	V	(no generation)
qiianarpallaaqaaq	V	(no generation)
qiianarpoq	V	(no generation)
qiianarsivoq	V	(no generation)
qiianarunnaarpoq	V	(no generation)
qiianniunnaarpoq	V	(no generation)
qiiannivippoq	V	(no generation)
qiiannivoq	V	(no generation)
qiia¦q	N	–p, –t
qiiaqaaq	V	(no generation)
qiiarlunne¦q	N	–rup, –rit
qiiarluppoq	V	(no generation)
qiiat¦ooq	N	–uup, –uut
qiiatserpoq	V	(no generation)
qiiattorpoq	V	(no generation)
qiiatuvoq	V	(no generation)
qiiavallaaqaaq	V	(no generation)
qiiavoq	V	(no generation)
qiilaakkunnaarpoq	V	(no generation)
qiilaalliorpoq	V	(no generation)
qiilaallivoq	V	(no generation)
qiilaappoq	V	(no generation)
qiilangerpoq	V	(no generation)
qiilaqaaq	V	(no generation)
qiilasaarpoq	V	(no generation)
qiilasarpaa	V	(no generation)
qiila¦sooq	N	{–suup, –tuup}, {–suut, –tuut}
qiilavoq	V	(no generation)
qiilerpoq	V	(no generation)
qiillappoq	V	(no generation)
qiillassarpaa	V	(no generation)
qiillassarpoq	V	(no generation)
qiillatsivippoq	V	(no generation)
qiimaalligaluttuinnalerpoq	V	(no generation)
qiimaalluinnarpoq	V	(no generation)
qiimaappoq	V	(no generation)
qiimanart¦oq	N	–up, –ut
qiimaqasiuppaa	V	(no generation)
qiimasaarpoq	V	(no generation)
qiimas¦oq	N	–up, –ut
qiimassu¦seq	N	–tsip, –tsit
qiimassuseqarluarne¦q	N	–rup, –rit
qiimasunne¦q	N	–rup, –rit
qiimasuppoq	V	(no generation)
qiimasuut	N	–ip, –it
qiimatsanne¦q	N	–rup, –rit
qiimavissorpoq	V	(no generation)
qiimavoq	V	(no generation)
qiimmaallappoq	V	(no generation)
qiimmaammernart¦oq	N	–up, –ut
qiimmaammisaarpoq	V	(no generation)
qiimmaammisippaa	V	(no generation)
qiimmaari¦ssoq	N	{–ssup, –ttup}, {–ssut, –ttut}
qiimmappoq	V	(no generation)
qiimmassaane¦q	N	–rup, –rit
qiimmassaat	N	–ip, –it
qiimmassaavoq	V	(no generation)
qiimmassarne¦q	N	–rup, –rit
qiimmassarpaa	V	(no generation)
qiimmassarpoq	V	(no generation)
qiimmassimaarpoq	V	(no generation)
qiimmatsaatigaa	V	(no generation)
qiimmatsappoq	V	(no generation)
qiimmatsatt¦oq	N	–up, –ut
qiimmattaat	N	–ip, –it
qiimmattaateqarluarne¦q	N	–rup, –rit
qiimmattangaarne¦q	N	–rup, –rit
qiimmattarnart¦oq	N	–up, –ut
qiimmattarne¦q	N	–rup, –rit
qiimmattarpoq	V	(no generation)
qiimmattartippaa	V	(no generation)
qiimmisaarpoq	V	(no generation)
qiingavoq	V	(no generation)
qiiniaanngilaq	V	(no generation)
qiiniaarpoq	V	(no generation)
qiinikkaluttuinnarpoq	V	(no generation)
qiinippoq	V	(no generation)
qiinngakkaluttuinnarpoq	V	(no generation)
qiinngappoq	V	(no generation)
qiinngassarpaa	V	(no generation)
qiioqi	N	–p, –t
qiioqinngu¦aq	N	–up, –it
qiipattarpaa	V	(no generation)
qiippoq	V	(no generation)
qiisagaa	V	(no generation)
qiisagajuppoq	V	(no generation)
qiisanaqaaq	V	(no generation)
qiisavoq	V	(no generation)
qiitoqeerpoq	V	(no generation)
qiitoqerpoq	V	(no generation)
qiitsaarpoq	V	(no generation)
qiitsaartippaa	V	(no generation)
qiitsaarutigaa	V	(no generation)
qiitsaarutissa¦q	N	–p, –t
qiitsarippoq	V	(no generation)
qiitsarissivoq	V	(no generation)
qiitsarivippoq	V	(no generation)
qiitsat	N	–ip, –it
qiitsatigaa	V	(no generation)
qiitserpaa	V	(no generation)
qiitserpoq	V	(no generation)
qiittoorpoq	V	(no generation)
qiivalas¦oq	N	–up, –ut
qiivalavoq	V	(no generation)
qiivallaatigaa	V	(no generation)
qiivallakkaluttuinnarpoq	V	(no generation)
qiivallappoq	V	(no generation)
qiivallassimaarpoq	V	(no generation)
qiivappoq	V	(no generation)
qiiviarpaa	V	(no generation)
qiiviartippoq	V	(no generation)
qikkeruppoq	V	(no generation)
qikkiarpoq	V	(no generation)
qilaagutserpaa	V	(no generation)
qilaalersorpaa	V	(no generation)
qilaanngarpaa	V	(no generation)
qilaanngarpoq	V	(no generation)
qilaanngavippaa	V	(no generation)
qilaanngavippoq	V	(no generation)
qilaanngoorpoq	V	(no generation)
qilaannguallaannarpoq	V	(no generation)
qilaannguallappoq	V	(no generation)
qilaannguarpaluppoq	V	(no generation)
qilaanngusaasa¦q	N	–p, –t
qilaanngusa¦q	N	–p, –t
qilaappaluppoq	V	(no generation)
qilaa¦q	N	–p, –t
qilaaqanngits¦oq	N	–up, –ut
qilaarmiu	N	–p, –t
qilaarmiut	N, pl.	-
qilaaserpoq	V	(no generation)
qilaasisarpoq	V	(no generation)
qilaassisart¦oq	N	–up, –ut
qilaat	N	–ip, –it
qilaat	N, pl.	-
qilaatersorpoq	V	(no generation)
qilaatersortart¦oq	N	–up, –ut
qilaatersort¦oq	N	–up, –ut
qila¦k	N	–ap, –at
Qilakits¦oq	N	–up, –ut
qilakkoorpoq	V	(no generation)
qilakullerpoq	V	(no generation)
qilalerne¦q	N	–rup, –rit
qilalerpoq	V	(no generation)
qilaliarfi¦k	N	–up, –it
qilaliarpoq	V	(no generation)
qilalivippoq	V	(no generation)
qilalluinnalerpoq	V	(no generation)
qilaluarpoq	V	(no generation)
qilalu¦gaq	N	–kkap, –kkat
qilalugarnia¦q	N	–p, –t
qilalugarpoq	V	(no generation)
qilalukkerajukkunnaarpoq	V	(no generation)
qilalukkerpoq	V	(no generation)
qilamittorpoq	V	(no generation)
qilammippaa	V	(no generation)
qilammippoq	V	(no generation)
qilammiu	N	–p, –t
qilammiut	N, pl.	-
qilanaappaa	V	(no generation)
qilanaaraa	V	(no generation)
qilanaarnaqaaq	V	(no generation)
qilanaarne¦q	N	–rup, –rit
qilanaarpoq	V	(no generation)
qilanaartippaa	V	(no generation)
qilanaart¦oq	N	–up, –ut
qilanaartorne¦q	N	–rup, –rit
qilanaartorpoq	V	(no generation)
qilanaartuuserpoq	V	(no generation)
qilanaartuut	N	–ip, –it
qilanaarutigaa	V	(no generation)
qilanarratsaappaa	V	(no generation)
qilanarratsappoq	V	(no generation)
qilanngaarpaluppoq	V	(no generation)
qilanngaavoq	V	(no generation)
qilannga¦q	N	–p, –t
qilanngarpoq	V	(no generation)
qilanngoorpoq	V	(no generation)
qilappaa	V	(no generation)
qilappoq	V	(no generation)
qilarunniarpaa	V	(no generation)
qilaruppaa	V	(no generation)
qilarussaavoq	V	(no generation)
qilarussa¦q	N	–p, –t
qilatsi¦ppoq	V	–nngilaq
qilattaane¦q	N	–rup, –rit
qilattaat	N	–ip, –it
qilattaat	N, pl.	-
qilattaavoq	V	(no generation)
qilatta¦gaq	N	–kkap, –kkat
qilattagassia¦q	N	–p, –t
qilattarpaa	V	(no generation)
qilattoorpoq	V	(no generation)
qilavaa	V	(no generation)
qilavoq	V	(no generation)
qileqqerpoq	V	(no generation)
qileqqingasoorpoq	V	(no generation)
qileqqingavoq	V	(no generation)
qileqqiuppoq	V	(no generation)
qilerlaarpaa	V	(no generation)
qilermiliuppaa	V	(no generation)
qilermippaa	V	(no generation)
qilerneeruppoq	V	(no generation)
qilerne¦q	N	–rup, –rit
qilernerusa¦q	N	–p, –t
qilernerussaarpoq	V	(no generation)
qilerniusa¦q	N	–p, –t
qile¦roq	N	–qqup, –qqut
qilerpaa	V	(no generation)
qilerpoq	V	(no generation)
qilerseriaa¦seq	N	–tsip, –tsit
qilers¦eriaaseq	N	{–eriaatsip, –iperiaatsip}, {–eriaatsit, –iperiaatsit}
qilerserpoq	V	(no generation)
qilersine¦q	N	–rup, –rit
qilersissaarpoq	V	(no generation)
qilersiuserpoq	V	(no generation)
qilersiussaarpoq	V	(no generation)
qilersiut	N	–ip, –it
qilersivoq	V	(no generation)
qilersorpaa	V	(no generation)
qilersorsimanngits¦oq	N	–up, –ut
qilersuivoq	V	(no generation)
qilersuuppaa	V	(no generation)
qilertaaruppoq	V	(no generation)
qilertaasa¦q	N	–p, –t
qilertaasaqart¦oq	N	–up, –ut
qilerta¦q	N	–p, –t
qilertat	N, pl.	-
qilerti	N	–p, –t
qilertikits¦oq	N	–up, –ut
qilertil¦ik	N	{–iup, –lip, –lup}, –lit
qilertippoq	V	(no generation)
qilertit¦ooq	N	–uup, –uut
qilerul¦ik	N	{–iup, –lip, –lup}, –lit
qileruliuppoq	V	(no generation)
qilerunippoq	V	(no generation)
qileruppaa	V	(no generation)
qilerussaajarpaa	V	(no generation)
qilerussaarpaa	V	(no generation)
qilerussaarpoq	V	(no generation)
qilerut	N	–ip, –it
qilerutaajarpaa	V	(no generation)
qilerutaarpaa	V	(no generation)
qilerutissa¦q	N	–p, –t
qilerutissia¦q	N	–p, –t
qili¦gaq	N	–kkap, –kkat
qiligassaaruppoq	V	(no generation)
qili¦k	N	{–ngup, –up}, {–it, –ngit}
qilippaavoq	V	(no generation)
qilippa¦k	N	–ap, –at
qilippanippoq	V	(no generation)
qilippippoq	V	(no generation)
qillaalaa¦q	N	–p, –t
qillaalaaqaqaaq	V	(no generation)
qillaalaarpoq	V	(no generation)
qillaalane¦q	N	–rup, –rit
qillaalas¦oq	N	–up, –ut
qillaalasuinnaavoq	V	(no generation)
qillaalavoq	V	(no generation)
qillaallappoq	V	(no generation)
qillaallattarpoq	V	(no generation)
qillaallattuinnaavoq	V	(no generation)
qillaaluppoq	V	(no generation)
qillaalutsippoq	V	(no generation)
qillaaluttuinnaavoq	V	(no generation)
qillaarpaa	V	(no generation)
qillaarpaluppoq	V	(no generation)
qillaarpaluttuinnaavoq	V	(no generation)
qillaarpoq	V	(no generation)
qillaki¦ak	N	–ssap, –ssat
qillakiassiorpoq	V	(no generation)
qillakiattarpoq	V	(no generation)
qilla¦q	N	–p, –t
qillaqqort¦ooq	N	–uup, –uut
qillari¦k	N	–up, –it
qillarilluinnarpoq	V	(no generation)
qillarippoq	V	(no generation)
qillarissaane¦q	N	–rup, –rit
qillarissaavoq	V	(no generation)
qillarissarpaa	V	(no generation)
qillarissivoq	V	(no generation)
qillariss¦oq	N	–up, –ut
qillari¦ssoq	N	{–ssup, –ttup}, {–ssut, –ttut}
qillarlerpoq	V	(no generation)
qillarliaappoq	V	(no generation)
qillarlissarippoq	V	(no generation)
qillarluppallaanngilaq	V	(no generation)
qillarluppoq	V	(no generation)
qillarna¦q	N	–p, –t
qillaruummisaarpoq	V	(no generation)
qillaruummivoq	V	(no generation)
qillat	N	–ip, –it
qillat	N, pl.	-
qillatigaa	V	(no generation)
qillerine¦q	N	–rup, –rit
qillerivoq	V	(no generation)
qillerniiarpaa	V	(no generation)
qillerpaa	V	(no generation)
qillerpoq	V	(no generation)
qillersaaserpaa	V	(no generation)
qillersaat	N	–ip, –it
qillersaavoq	V	(no generation)
qillersarpaa	V	(no generation)
qillersia¦q	N	–p, –t
qillers¦oq	N	–up, –ut
qillert¦oq	N	–up, –ut
qillertoqqeris¦oq	N	–up, –ut
qillertoram¦ineq	N	{–ernup, –inerup, –iniup}, {–ernit, –inerit, –iniit}
qillertoram¦ineq	N	–ernup, –ernit
qillerto¦raq	N	–qqap, –qqat
qillertoratsia¦q	N	–ap, –at
qillertoratsia¦q	N	–p, –t
qillertorpaa	V	(no generation)
qillertuusa¦q	N	–p, –t
qillerujuppoq	V	(no generation)
qillerujutsippoq	V	(no generation)
qillerujuttuinnaavoq	V	(no generation)
qillerussu¦aq	N	–up, –it
qillerut	N	–ip, –it
qilligaavoq	V	(no generation)
qilligassa¦q	N	–p, –t
qilline¦q	N	–rup, –rit
qill¦ineq	N	{–ernup, –inerup}, {–ernit, –inerit}
qillinnguarsi	Interj	(no generation)
qillivoq	V	(no generation)
qill¦oq	N	–up, –ut
qillornia¦q	N	–p, –t
qillort¦ooq	N	–uup, –uut
qilluakippoq	V	(no generation)
qillu¦aq	N	{–ap, –ssap}, {–at, –ssat}
qilluarippoq	V	(no generation)
qilluariss¦oq	N	–up, –ut
qilluari¦ssoq	N	{–ssup, –ttup}, {–ssut, –ttut}
qilluarut	N	–ip, –it
qillugaa	V	(no generation)
qillugisa¦q	N	–p, –t
qillugitsaappaa	V	(no generation)
qillunnaqaaq	V	(no generation)
qilluppaa	V	(no generation)
qilluppoq	V	(no generation)
qillussivi¦k	N	–up, –it
qillussi¦vik	N	{–ffiup, –viup}, {–ffiit, –viit}
qillutaarpoq	V	(no generation)
qilluta¦q	N	–p, –t
qillutsivi¦k	N	–up, –it
qiloorpaa	V	(no generation)
qiloorpoq	V	(no generation)
qiloorsimavoq	V	(no generation)
qiloqqingavoq	V	(no generation)
qiloqqippoq	V	(no generation)
qiloqqisippaa	V	(no generation)
qiloqqusooqaaq	V	(no generation)
qiloqqus¦oq	N	–up, –ut
qiloraraa	V	(no generation)
qilorartorpaa	V	(no generation)
qilorartorpoq	V	(no generation)
qilorartuusiorpoq	V	(no generation)
qilorartuut	N	–ip, –it
qilorartuutigaa	V	(no generation)
qiloriarpaa	V	(no generation)
qiloriarsivoq	V	(no generation)
qilorlaarpaa	V	(no generation)
qilorlaarpoq	V	(no generation)
qiluaa	V	(no generation)
qiluallappallappoq	V	(no generation)
qiluappaa	V	(no generation)
qiluata¦q	N	–p, –t
qilugajuppoq	V	(no generation)
qiluguppoq	V	(no generation)
qilujunnaarpoq	V	(no generation)
qilummippaa	V	(no generation)
qilummisuuvoq	V	(no generation)
qilummiunnaarpaa	V	(no generation)
qilummivaa	V	(no generation)
qilummivoq	V	(no generation)
qilungavoq	V	(no generation)
qilunne¦q	N	–rup, –rit
qilupa¦gaq	N	–kkap, –kkat
qilupagartorpoq	V	(no generation)
qilupappaa	V	(no generation)
qiluppaa	V	(no generation)
qiluppallappoq	V	(no generation)
qiluppalulillarpoq	V	(no generation)
qiluppoq	V	(no generation)
qilusarne¦q	N	–rup, –rit
qilusoorpoq	V	(no generation)
qilussinnaavaa	V	(no generation)
qilussunnilaarpoq	V	(no generation)
qilussunnippoq	V	(no generation)
qiluta¦q	N	–p, –t
qilutitsine¦q	N	–rup, –rit
qilut¦itsineq	N	{–itsinerup, –sitsinerup}, {–itsinerit, –sitsinerit}
qilutitsinersu¦aq	N	–up, –it
qilut¦itsinersuaq	N	{–itsinersuup, –sitsinersuup}, {–itsinersuit, –sitsinersuit}
qilutitsivoq	V	(no generation)
qilutsippaa	V	(no generation)
qilutta¦gaq	N	–kkap, –kkat
qiluttarpaa	V	(no generation)
Qiluttuusat	N, pl.	-
qiluttuusat	N, pl.	-
qiluvoq	V	(no generation)
qimaaffigaa	V	(no generation)
qimaaffi¦k	N	–up, –it
qimaaffissa¦q	N	–p, –t
qimaajusaarpoq	V	(no generation)
qimaane¦q	N	–rup, –rit
qimaarsuataarpoq	V	(no generation)
qimaasaarutaanngilaq	V	(no generation)
qimaasivaa	V	(no generation)
qimaas¦oq	N	–up, –ut
qimaatippaa	V	(no generation)
qimaavigaa	V	(no generation)
qimaavoq	V	(no generation)
qimagaasimane¦q	N	–rup, –rit
qimagaassu¦seq	N	–tsip, –tsit
qimaguppoq	V	(no generation)
qimagusimavoq	V	(no generation)
qimagussorne¦q	N	–rup, –rit
qimagutititsine¦q	N	–rup, –rit
qimagut¦ititsineq	N	{–ititsinerup, –itsitsinerup, –sititsinerup, –sitsitsinerup}, {–ititsinerit, –itsitsinerit, –sititsinerit, –sitsitsinerit}
qimajuillivaa	V	(no generation)
qimajuippaa	V	(no generation)
qimajuisa¦q	N	–p, –t
qimakkallarnaviarunanngilaa	V	(no generation)
qimakkusuppaa	V	(no generation)
qimallugaa	V	(no generation)
qimallunnaqaaq	V	(no generation)
qimallunnarpoq	V	(no generation)
qimapallattarpaa	V	(no generation)
qimappaa	V	(no generation)
qimarngui¦k	N	–up, –it
qimarnguppaa	V	(no generation)
qimarngus¦oq	N	–up, –ut
qimarngussine¦q	N	–rup, –rit
qimarngussivoq	V	(no generation)
qimarnguvoq	V	(no generation)
qimarnuppaa	V	(no generation)
qimarnussa¦q	N	–p, –t
qimarnussine¦q	N	–rup, –rit
qimarnussivoq	V	(no generation)
qimarnuvoq	V	(no generation)
qimarrassivoq	V	(no generation)
qimarrat	N	–ip, –it
qimarratigaa	V	(no generation)
qimarravigaa	V	(no generation)
qimarravi¦k	N	–up, –it
qimataas¦oq	N	–up, –ut
qimataavoq	V	(no generation)
qimata¦q	N	–p, –t
qimataqarpoq	V	(no generation)
qimatikkiartorpoq	V	(no generation)
qimatikkumavoq	V	(no generation)
qimatippaa	V	(no generation)
qimati¦ppoq	V	–nngilaq
qimat¦ippoq	V	–sinngilaq
qimatoqarpoq	V	(no generation)
qimatserasuarpaa	V	(no generation)
qimatserpaa	V	(no generation)
qimatsippaa	V	(no generation)
qimatsisarfi¦k	N	–up, –it
qimatsivigaa	V	(no generation)
qimatsivoq	V	(no generation)
qimattaaserpaa	V	(no generation)
qimatu	N	–p, –t
qimatueruppoq	V	(no generation)
qimatulia¦q	N	–p, –t
qimatuligallassavaa	V	(no generation)
qimatulisaannarpoq	V	(no generation)
qimatulisa¦q	N	–p, –t
qimatulivaa	V	(no generation)
qimatulivi¦k	N	–up, –it
qimatulivoq	V	(no generation)
qimatusarpoq	V	(no generation)
qimatusartaannarpoq	V	(no generation)
qimatuuvoq	V	(no generation)
qimavissunngilaa	V	(no generation)
qimeqqut	N	–ip, –it
qimeqqutissaaruppoq	V	(no generation)
qimeriakippoq	V	(no generation)
qimeri¦aq	N	–ssap, –ssat
qimeriaqqort¦ooq	N	–uup, –uut
qimeriinnaalillart¦oq	N	–up, –ut
qimerloorpaa	V	(no generation)
qimerloorpoq	V	(no generation)
qimerloortaannarpaa	V	(no generation)
qimerloortippaa	V	(no generation)
qimerloortitsine¦q	N	–rup, –rit
qimerloortitsivoq	V	(no generation)
qimerlugaasa¦q	N	–p, –t
qimerlu¦k	N	–up, –it
qimerlul¦ik	N	{–iup, –lip, –lup}, –lit
qimerlumine¦q	N	–rup, –rit
qimerlum¦ineq	N	–ernup, –ernit
qimerluttorpoq	V	(no generation)
qimerluu¦gaq	N	–kkap, –kkat
qimerluugaqarpoq	V	(no generation)
qimerluuigajuppoq	V	(no generation)
qimerluuine¦q	N	–rup, –rit
qimerluuisarpoq	V	(no generation)
qimerluuivoq	V	(no generation)
qimerluukkerpaa	V	(no generation)
qimi¦aq	N	–ssap, –ssat
qimiartorpaa	V	(no generation)
qiminne¦q	N	–rup, –rit
qimippaa	V	(no generation)
qimippoq	V	(no generation)
qimisaanngunaqaaq	V	(no generation)
qimisaanngutippaa	V	(no generation)
qimisaannguvoq	V	(no generation)
qimisserpaa	V	(no generation)
qimissersuivoq	V	(no generation)
qimitippaa	V	(no generation)
qimitsine¦q	N	–rup, –rit
qimitsisarfi¦k	N	–up, –it
qimitsivoq	V	(no generation)
qimiuserpaa	V	(no generation)
qimiut	N	–ip, –it
qimiutaavoq	V	(no generation)
qimmeerserpoq	V	(no generation)
qimmeersertaannarpoq	V	(no generation)
qimmeersiut	N	–ip, –it
qimmeersiutigaa	V	(no generation)
qimm¦eq	N	–ip, –it
qimmeqarne¦q	N	–rup, –rit
qimmeraa	V	(no generation)
qimmersu¦aq	N	–up, –it
qimmersuumavoq	V	(no generation)
qimmiaraavoq	V	(no generation)
qimmia¦raq	N	–qqap, –qqat
qimm¦iaraq	N	{–eeqqap, –iaqqap}, {–eeqqat, –iaqqat}
qimmiarsuusa¦q	N	–p, –t
qimmiitserpaa	V	(no generation)
qimmiitserpoq	V	(no generation)
qimmilia¦q	N	–p, –t
qimmil¦ik	N	{–iup, –lip, –lup}, –lit
qimmilivoq	V	(no generation)
qimmit	N, pl.	-
qimmorippoq	V	(no generation)
qimmorissaarpoq	V	(no generation)
qimmorissivoq	V	(no generation)
qimmorluppoq	V	(no generation)
qimmortungaarpoq	V	(no generation)
qimmukkiartorpaa	V	(no generation)
qimmuppaa	V	(no generation)
qimmuppoq	V	(no generation)
qimmussiivaa	V	(no generation)
qimmussinnaanngilaa	V	(no generation)
qimmuuppoq	V	(no generation)
qimmuussiivaa	V	(no generation)
qimmuutilerpoq	V	(no generation)
qimmuuttoorpoq	V	(no generation)
qimoriarsarpaa	V	(no generation)
qimugaa	V	(no generation)
qimukattaraa	V	(no generation)
qimukattarimmersorpaa	V	(no generation)
qimukattaritippoq	V	(no generation)
qimuppaa	V	(no generation)
qimuppoq	V	(no generation)
qimuss¦eq	N	–ip, –it
qimusseqarfi¦k	N	–up, –it
qimusserarne¦q	N	–rup, –rit
qimusserarnerit	N, pl.	-
qimusserarpoq	V	(no generation)
Qimusseriarsu¦aq	N	–up, –it
qimusserne¦q	N	–rup, –rit
qimusserpoq	V	(no generation)
qimussersi	N	–p, –t
qimussers¦oq	N	–up, –ut
qimusser¦soq	N	{–sup, –tup}, {–sut, –tut}
qimussert¦oq	N	–up, –ut
qimusser¦toq	N	{–sup, –tup}, {–sut, –tut}
qimussit	N, pl.	-
qimussiuppaa	V	(no generation)
qimussiussis¦oq	N	–up, –ut
qimussiut	N	–ip, –it
qimutsi	N	–p, –t
qimutsigaa	V	(no generation)
qimutsil¦ik	N	{–iup, –lip, –lup}, –lit
qimutsivoq	V	(no generation)
qimutt¦oq	N	–up, –ut
qimuttuarsu¦k	N	–up, –it
qimuttuarsuusanngu¦aq	N	–up, –it
qimuttuitsoqarfi¦k	N	–up, –it
qimu¦ttuitsoqarfik	N	{–juitsoqarfiup, –ttuitsoqarfiup}, {–juitsoqarfiit, –ttuitsoqarfiit}
qimuttuitsorne¦q	N	–rup, –rit
qimuttuitsut	N, pl.	-
qimu¦ttuitsut	N, pl.	{–juitsut, –ttuitsut}
qimuttussa¦q	N	–p, –t
qinaallappoq	V	(no generation)
qinaallattuinnaavoq	V	(no generation)
qinaaluppoq	V	(no generation)
qinaaluttuinnaavoq	V	(no generation)
qinaa¦q	N	–p, –t
qinaaraa	V	(no generation)
qinaarilluanngilaa	V	(no generation)
qinaaritippaa	V	(no generation)
qinaarpallajuippoq	V	(no generation)
qinaarpallappoq	V	(no generation)
qinaarpallattoqanngilaq	V	(no generation)
qinaarpoq	V	(no generation)
qinaasivoq	V	(no generation)
qinaluppoq	V	(no generation)
qineqqusaarpoq	V	(no generation)
qineqqusaart¦oq	N	–up, –ut
qineqqusaarut	N	–ip, –it
qinerlerpoq	V	(no generation)
qinerlersigaa	V	(no generation)
qinerliuppaa	V	(no generation)
qinerpaa	V	(no generation)
qinerpoq	V	(no generation)
qiners¦eq	N	–ip, –it
qinerseqqinne¦q	N	–rup, –rit
qiner¦seqqinneq	N	{–seqqinnerup, –leqqinnerup}, {–seqqinnerit, –leqqinnerit}
qiner¦seriaaseq	N	{–seriaatsip, –siperiaatsip, –leriaatsip}, {–seriaatsit, –siperiaatsit, –leriaatsit}
qiner¦siartunngitsoortoq	N	{–leriartunngitsoortup, –siartunngitsoortup}, {–leriartunngitsoortut, –siartunngitsoortut}
qinersiluppoq	V	(no generation)
qiner¦sineq	N	{–lernerup, –sinerup}, {–lernerit, –sinerit}
qiner¦sinissaq	N	{–lernissap, –sinissap}, {–lernissat, –sinissat}
qinersisart¦oq	N	–up, –ut
qiner¦sisartoq	N	{–lersartup, –sisartup}, {–lersartut, –sisartut}
qiner¦sisinnaasoq	N	{–lersinnaasup, –sisinnaasup}, {–lersinnaasut, –sisinnaasut}
qiner¦sisinnaassuseqarneq	N	{–lersinnaassuseqarnerup, –sisinnaassuseqarnerup}, {–lersinnaassuseqarnerit, –sisinnaassuseqarnerit}
qiner¦sisinnaatitaaneq	N	{–lersinnaatitaanerup, –sisinnaatitaanerup}, {–lersinnaatitaanerit, –sisinnaatitaanerit}
qiner¦sisinnaatitaasoq	N	{–lersinnaatitaasup, –sisinnaatitaasup}, {–lersinnaatitaasut, –sisinnaatitaasut}
qinersisitsis¦oq	N	–up, –ut
qiner¦sisitsisoq	N	{–lersitsisup, –sisitsisup}, {–lersitsisut, –sisitsisut}
qiner¦sisoq	N	{–lersup, –lertup, –sisup, –situp}, {–lersut, –lertut, –sisut, –situt}
qinersivi¦k	N	–up, –it
qiner¦sivik	N	{–lerfiup, –sifiup, –siviup}, {–lerfiit, –sifiit, –siviit}
qinersivoq	V	(no generation)
qinerterpoq	V	(no generation)
qinert¦oq	N	–up, –ut
qiner¦toq	N	{–sup, –tup}, {–sut, –tut}
qinertuannguarpoq	V	(no generation)
qinertuuvoq	V	(no generation)
qingaanngu¦aq	N	–up, –it
qingaa¦q	N	–p, –t
qingaarpoq	V	(no generation)
qingaarsinaqaaq	V	(no generation)
qingaarsivoq	V	(no generation)
qingaarsu¦aq	N	–up, –it
Qingaat	N	–ip, –it
Qingaat	N, pl.	-
qingakillivoq	V	(no generation)
qingakippoq	V	(no generation)
qingakisaarpoq	V	(no generation)
qingakivippoq	V	(no generation)
qingakkoorpalu¦k	N	–up, –it
qingakkoorpoq	V	(no generation)
qingal¦ik	N	{–iup, –lip, –lup}, –lit
qingalippoq	V	(no generation)
qingalissu¦aq	N	–up, –it
qingal¦issuaq	N	{–ersuup, –issuup}, {–ersuit, –issuit}
qin¦gaq	N	–ngap, –ngat
qingaqqortuvoq	V	(no generation)
qingarippoq	V	(no generation)
qingarissivoq	V	(no generation)
qingarmiulissu¦aq	N	–up, –it
qingartaarpoq	V	(no generation)
qingarta¦q	N	–p, –t
qingartaqqerpoq	V	(no generation)
qingartaqqersimavoq	V	(no generation)
qingartaqqut	N	–ip, –it
qingarta¦raq	N	–qqap, –qqat
qingartararsu¦aq	N	–up, –it
qingart¦ooq	N	–uup, –uut
qingartoorsu¦aq	N	–up, –it
qingartuvoq	V	(no generation)
qingassarippoq	V	(no generation)
qingassarissorsuuvoq	V	(no generation)
qingeri¦aq	N	–ssap, –ssat
qingerpaa	V	(no generation)
qingerpoq	V	(no generation)
qingersivoq	V	(no generation)
qingertuarpoq	V	(no generation)
qinigaaffi¦k	N	–up, –it
qinigaane¦q	N	–rup, –rit
qinigaanngitsoorpoq	V	(no generation)
qinigaaqqammer¦soq	N	{–sup, –tup}, {–sut, –tut}
qinigaaqqinne¦q	N	–rup, –rit
qinigaaqqitt¦oq	N	–up, –ut
qinigaaqqi¦ttoq	N	{–ssup, –ttup}, {–ssut, –ttut}
qinigaarlaa¦q	N	–p, –t
qinigaasinnaane¦q	N	–rup, –rit
qinigaasinnaas¦oq	N	–up, –ut
qinigaavoq	V	(no generation)
qini¦gaq	N	–kkap, –kkat
qinigaraa	V	(no generation)
qinigassaatitaane¦q	N	–rup, –rit
qinigassaavoq	V	(no generation)
qinigassanngortinne¦q	N	–rup, –rit
qinigassanngortinneqaqqinne¦q	N	–rup, –rit
qinigassanngortippoq	V	(no generation)
qinigassanngortitsine¦q	N	–rup, –rit
qinigassanngortitsis¦oq	N	–up, –ut
qinigassanngortitsisut	N, pl.	-
qinigassanngorti¦ttoq	N	{–ttup, –ssup}, {–ttut, –ssut}
qinigassa¦q	N	–p, –t
qinigassaqarne¦q	N	–rup, –rit
qinigassaqartitaane¦q	N	–rup, –rit
qinigassiissut	N	–ip, –it
qinimisaarpoq	V	(no generation)
qiningaassu¦seq	N	–tsip, –tsit
qiningane¦q	N	–rup, –rit
qiningas¦oq	N	–up, –ut
qiningasorsuuvoq	V	(no generation)
qiningassu¦seq	N	–tsip, –tsit
qiningavallaaqaaq	V	(no generation)
qiningavoq	V	(no generation)
qininngaappaa	V	(no generation)
qininngajas¦oq	N	–up, –ut
qininngappoq	V	(no generation)
qininngassarpaa	V	(no generation)
qininngavigaa	V	(no generation)
qiniuppaa	V	(no generation)
qinnak¦oq	N	–up, –ut
qinnakoraa	V	(no generation)
qinnaku	N	–p, –t
qinnakuuvoq	V	(no generation)
qinnappoq	V	(no generation)
qinnarippoq	V	(no generation)
qinnarissaarpoq	V	(no generation)
qinnarissivoq	V	(no generation)
qinnarluppaa	V	(no generation)
qinnarluppoq	V	(no generation)
qinne¦q	N	–rup, –rit
qinneqqort¦ooq	N	–uup, –uut
qinneriaassu¦aq	N	–up, –it
qinneriaat	N	–ip, –it
qinneriaatee¦raq	N	–qqap, –qqat
qinneriarpaa	V	(no generation)
qinneriarpoq	V	(no generation)
qinnerpaa	V	(no generation)
qinnertuvoq	V	(no generation)
qinngaarsorpaa	V	(no generation)
qinngaarsuivoq	V	(no generation)
qinngakkoorpoq	V	(no generation)
qinngakkoortitsivoq	V	(no generation)
qinngaqquffigaa	V	(no generation)
qinngaqquffigisaavoq	V	(no generation)
qinngaqqunnaqaaq	V	(no generation)
qinngaqqunnarpoq	V	(no generation)
qinngaqqunnartippaa	V	(no generation)
qinngaqqunnart¦oq	N	–up, –ut
qinngaqqunnassu¦seq	N	–tsip, –tsit
qinngaqquppaa	V	(no generation)
qinngaqquppoq	V	(no generation)
qinngaqqussu¦seq	N	–tsip, –tsit
qinngaqqutt¦oq	N	–up, –ut
qinngariinne¦q	N	–rup, –rit
qinngarinnippoq	V	(no generation)
qinngarisaavoq	V	(no generation)
qinngarisa¦q	N	–p, –t
qinngarnaqaaq	V	(no generation)
qinngarnarpoq	V	(no generation)
qinngarnart¦oq	N	–up, –ut
qinngarpaa	V	(no generation)
qinngarpoq	V	(no generation)
qinngarsorpaa	V	(no generation)
qinngarsorti	N	–p, –t
qinngarsortigaa	V	(no generation)
qinngarsuine¦q	N	–rup, –rit
qinngarsuis¦oq	N	–up, –ut
qinngarsuivoq	V	(no generation)
qinngart¦oq	N	–up, –ut
qinngasaarajuppoq	V	(no generation)
qinngasaarine¦q	N	–rup, –rit
qinngasaarisarpoq	V	(no generation)
qinngasaarivoq	V	(no generation)
qinngasaarneqa¦rtuartoq	N	{–rtuartup, –tuartup}, {–rtuartut, –tuartut}
qinngasaarpaa	V	(no generation)
qinngasaavoq	V	(no generation)
qinngat	N, pl.	-
qinngia¦q	N	–p, –t
qinngippaa	V	(no generation)
qinngippoq	V	(no generation)
qinng¦oq	N	–up, –ut
qinngoqqortuvoq	V	(no generation)
qinngoqquppaa	V	(no generation)
qinngoquserpaa	V	(no generation)
qinngoqusiuppaa	V	(no generation)
qinngoqut	N	–ip, –it
qinngorfigaa	V	(no generation)
qinngorl¦eq	N	–iup, –iit
qinngorlerpoq	V	(no generation)
qinngorluppoq	V	(no generation)
qinngorne¦q	N	–rup, –rit
qinngornerpoq	V	(no generation)
qinngorpoq	V	(no generation)
Qinngorpu¦t	Prop	–p
qinngorsimaffigineqarpoq	V	(no generation)
qinngortart¦oq	N	–up, –ut
qinngortippaa	V	(no generation)
qinngort¦ooq	N	–uup, –uut
qinngortoorsu¦aq	N	–up, –it
qinngortuvoq	V	(no generation)
qinnguajoorne¦q	N	–rup, –rit
qinnguajoorpoq	V	(no generation)
qinnguajoorutigaa	V	(no generation)
qinngualavoq	V	(no generation)
qinngu¦aq	N	–ssap, –ssat
qinnguarpaa	V	(no generation)
qinnguarpoq	V	(no generation)
qinnguarsimajuarpoq	V	(no generation)
qinnguartaane¦q	N	–rup, –rit
qinnguartaasiorpoq	V	(no generation)
qinnguartaat	N	–ip, –it
qinnguartaat	N, pl.	-
qinnguartaavoq	V	(no generation)
qinnguartarajuppoq	V	(no generation)
qinnguartarpaa	V	(no generation)
qinnguartarpoq	V	(no generation)
qinnguartartinne¦q	N	–rup, –rit
qinnguartartippoq	V	(no generation)
qinnguartartissimas¦oq	N	–up, –ut
qinnguartartis¦simasoq	N	{–simasup, –imasup}, {–simasut, –imasut}
qinnguartartittaat	N	–ip, –it
qinnguartarti¦ttaat	N	{–ttaatip, –ssaatip}, {–ttaatit, –ssaatit}
qinngukinaarpaa	V	(no generation)
qinngukippoq	V	(no generation)
qinngulane¦q	N	–rup, –rit
qinnguluppoq	V	(no generation)
qinnguppaa	V	(no generation)
qinnguppoq	V	(no generation)
qinngusaal¦ik	N	{–iup, –lip, –lup}, –lit
qinngusaa¦q	N	–p, –t
qinnguserpaa	V	(no generation)
qinngusersaarpoq	V	(no generation)
qinngusisaarpoq	V	(no generation)
qinngussu¦aq	N	–up, –it
qinngut	N	–ip, –it
qinngut	N, pl.	-
qinngutaarserpoq	V	(no generation)
qinngutaarsersimavoq	V	(no generation)
qinngutitaarniarpoq	V	(no generation)
qinngutitaarpoq	V	(no generation)
qinnguumivoq	V	(no generation)
qinnia¦q	N	–p, –t
qinnikaarpaa	V	(no generation)
qinnikaarpoq	V	(no generation)
qinnikaart¦oq	N	–up, –ut
qinnikaartuinna¦q	N	–ap, –at
qinnikippoq	V	(no generation)
qinnikkaart¦oq	N	–up, –ut
qinnil¦ik	N	{–iup, –lip, –lup}, –lit
qinniliuut	N	–ip, –it
qinnilluarpoq	V	(no generation)
qinniluppoq	V	(no generation)
qinninikippoq	V	(no generation)
qinnivaa	V	(no generation)
qinnivi¦k	N	–up, –it
qinnivoq	V	(no generation)
qinnorilluinnarpoq	V	(no generation)
qinnorippoq	V	(no generation)
qinnorissaarpoq	V	(no generation)
qinnu¦aq	N	–ssap, –ssat
qinnuarsu¦aq	N	–up, –it
qinnuigaa	V	(no generation)
qinnuigiuarpaa	V	(no generation)
qinnui¦k	N	–up, –it
qinnuisaarpoq	V	(no generation)
qinnuissaavoq	V	(no generation)
qinnupisaarpoq	V	(no generation)
qinnuppaa	V	(no generation)
qinnussaavoq	V	(no generation)
qinnusserpoq	V	(no generation)
qinnussersorpoq	V	(no generation)
qinnussisigaa	V	(no generation)
qinnussisoraa	V	(no generation)
qinnussivoq	V	(no generation)
qinnut	N	–ip, –it
qinnutaajunnaarpoq	V	(no generation)
qinnutaanngilaq	V	(no generation)
qinnutaavoq	V	(no generation)
qinnuteqaat	N	–ip, –it
qinnuteqarfissa¦q	N	–p, –t
qinnuteqarne¦q	N	–rup, –rit
qinnuteqarnissa¦q	N	–p, –t
qinnuteqarpoq	V	(no generation)
qinnuteqarsimas¦oq	N	–up, –ut
qinnuteqart¦oq	N	–up, –ut
qinnutigaa	V	(no generation)
qinnutigisa¦q	N	–p, –t
qinnutissa¦q	N	–p, –t
qinnutit	N, pl.	-
qinnuttuinna¦gaq	N	–kkap, –kkat
qinnuuloorne¦q	N	–rup, –rit
qinnuuloorpoq	V	(no generation)
qinnuuloortaannarpoq	V	(no generation)
qinnuumivoq	V	(no generation)
qin¦oq	N	–up, –ut
qinoqatigiinne¦q	N	–rup, –rit
qinoqatigii¦ssut	N, pl.	{–ssut, –ttut}
qinoqqippoq	V	(no generation)
qinorasaanngeqaaq	V	(no generation)
qinorasaarpoq	V	(no generation)
qinorsu¦aq	N	–up, –it
qinuarpoq	V	(no generation)
qinugaa	V	(no generation)
qinugajuppoq	V	(no generation)
qinuginninne¦q	N	–rup, –rit
qinuginnippoq	V	(no generation)
qinuginnitt¦oq	N	–up, –ut
qinugisaane¦q	N	–rup, –rit
qinugisaavoq	V	(no generation)
qinuiaasiorpoq	V	(no generation)
qinuiaat	N	–ip, –it
qinukkarpaa	V	(no generation)
qinullersarpaa	V	(no generation)
qinune¦q	N	–rup, –rit
qinunikkiartorpoq	V	(no generation)
qinunippoq	V	(no generation)
qinusaannarpoq	V	(no generation)
qinusarfi¦k	N	–up, –it
qinusarne¦q	N	–rup, –rit
qinusarpoq	V	(no generation)
qinusart¦oq	N	–up, –ut
qinusartuinnaane¦q	N	–rup, –rit
qinussaarpoq	V	(no generation)
qinussaarsinnaanngilaq	V	(no generation)
qinutsappoq	V	(no generation)
qinuvoq	V	(no generation)
qiorfi¦k	N	–up, –it
qiorneqanngits¦oq	N	–up, –ut
qiorniku	N	–p, –t
qiorpaa	V	(no generation)
qiorroorpoq	V	(no generation)
qiorsimas¦oq	N	–up, –ut
qiorsine¦q	N	–rup, –rit
qiorsivoq	V	(no generation)
qiortaat	N	–ip, –it
qiortaavoq	V	(no generation)
qiorta¦gaq	N	–kkap, –kkat
qioruppoq	V	(no generation)
qipalualuppoq	V	(no generation)
qipalu¦aq	N	–ssap, –ssat
qipattarpaa	V	(no generation)
qipeerpoq	V	(no generation)
qipeeruppaa	V	(no generation)
qipeeruppoq	V	(no generation)
qipeqq¦oq	N	–up, –ut
qipeqqort¦ooq	N	–uup, –uut
qipeqqul¦ik	N	{–iup, –lip, –lup}, –lit
qipeqquliorpoq	V	(no generation)
qipe¦roq	N	–qqup, –qqut
qiperorlu¦gaq	N	–kkap, –kkat
qiperorne¦q	N	–rup, –rit
qiperornil¦ik	N	{–iup, –lip, –lup}, –lit
qiperorpaa	V	(no generation)
qiperorsimavoq	V	(no generation)
qiperugaavoq	V	(no generation)
qiperu¦gaq	N	–kkap, –kkat
qiperuillaqqiss¦oq	N	–up, –ut
qiperuillaqqi¦ssoq	N	{–ssup, –ttup}, {–ssut, –ttut}
qiperuisart¦oq	N	–up, –ut
qiperuis¦oq	N	–up, –ut
qiperuivoq	V	(no generation)
qiperuuppoq	V	(no generation)
qiperuusiorpoq	V	(no generation)
qiperuut	N	–ip, –it
qipiiarpaa	V	(no generation)
qi¦pik	N	–piup, {–kkit, –piit}
qipiluallaqqippoq	V	(no generation)
qipiluatippaa	V	(no generation)
qipiluavoq	V	(no generation)
qipine¦q	N	–rup, –rit
qipineqarpoq	V	(no generation)
qipingane¦q	N	–rup, –rit
qipingasoorpoq	V	(no generation)
qipingatitsivoq	V	(no generation)
qipingavoq	V	(no generation)
qipinng¦oq	N	–up, –ut
qipinnguattaliuppaa	V	(no generation)
qipinnguatta¦q	N	–p, –t
qipinnguersippoq	V	(no generation)
qipinngu¦k	N	–up, –it
qipinngulunne¦q	N	–rup, –rit
qipinnguluppoq	V	(no generation)
qipinnguluttaannarpoq	V	(no generation)
qipinnguvoq	V	(no generation)
qipioorpoq	V	(no generation)
qipippaa	V	(no generation)
qipippoq	V	(no generation)
qipisa¦q	N	–p, –t
qipisaqq¦oq	N	–up, –ut
qipisari¦aq	N	{–ap, –ssap}, {–at, –ssat}
qipisari¦aq	N	–ssap, –ssat
qipisart¦oq	N	–up, –ut
qipisine¦q	N	–rup, –rit
qipisivoq	V	(no generation)
qipis¦oq	N	–up, –ut
qipissimavoq	V	(no generation)
qipissu¦aq	N	–up, –it
qipiteri¦aq	N	–ssap, –ssat
qipiteriuvoq	V	(no generation)
qipiterpaa	V	(no generation)
qipittorpaa	V	(no generation)
qipittorpoq	V	(no generation)
qipivaa	V	(no generation)
qipivoq	V	(no generation)
qipoqqaa¦q	N	–p, –t
qipoqqaassu¦aq	N	–up, –it
qipoqqaat	N	–ip, –it
qipoqqaat	N, pl.	-
Qipoqqa¦q	N	–ap, –at
qipoqqa¦q	N	–ap, –at
qipoqqarna¦q	N	–p, –t
qipoqqarpaa	V	(no generation)
qipoqqarta¦q	N	–p, –t
qipoqqartassiissutit	N, pl.	-
qipoqqartorpaa	V	(no generation)
qipoqqiorpaa	V	(no generation)
qipoqqivaa	V	(no generation)
qipoqqivoq	V	(no generation)
qipo¦raq	N	–qqap, –qqat
qiporarippoq	V	(no generation)
qiporartorpoq	V	(no generation)
qippa¦q	N	–ap, –at
qippariss¦oq	N	–up, –ut
qippari¦ssoq	N	{–ssup, –ttup}, {–ssut, –ttut}
qipparlutt¦oq	N	–up, –ut
qippia¦q	N	–p, –t
qippigajuppoq	V	(no generation)
qippiorpoq	V	(no generation)
qippivaa	V	(no generation)
qippivoq	V	(no generation)
qipp¦oq	N	–up, –ut
qippuppaa	V	(no generation)
qippussaavoq	V	(no generation)
qipput	N	–ip, –it
qipput	N, pl.	-
qipputaajarpoq	V	(no generation)
qipputaarserpoq	V	(no generation)
qi¦seq	N	{–sip, –tsip}, {–sit, –tsit}
qiserfigaa	V	(no generation)
qiserfi¦k	N	–up, –it
qiserpaa	V	(no generation)
qiserpoq	V	(no generation)
qisersarfi¦k	N	–up, –it
qisersu¦aq	N	–up, –it
qisertaannarpoq	V	(no generation)
qisoqqippaa	V	(no generation)
qisoqut	N	–ip, –it
qissaakujuppoq	V	(no generation)
qissaarpoq	V	(no generation)
qissaart¦oq	N	–up, –ut
qissaffigaa	V	(no generation)
qissakaavoq	V	(no generation)
qissakarpoq	V	(no generation)
qissakartippaa	V	(no generation)
qissallaappoq	V	(no generation)
qissallanne¦q	N	–rup, –rit
qissallappaa	V	(no generation)
qissallappoq	V	(no generation)
qissallatsippaa	V	(no generation)
qissangasoorpoq	V	(no generation)
qissangavallaaqaaq	V	(no generation)
qissangavoq	V	(no generation)
qissanniarpoq	V	(no generation)
qissanniut	N	–ip, –it
qissappaa	V	(no generation)
qissappoq	V	(no generation)
qissari¦aq	N	–ssap, –ssat
qissarpoq	V	(no generation)
qissartuallaaqaaq	V	(no generation)
qissartuvoq	V	(no generation)
qissarusiorpoq	V	(no generation)
qissarut	N	–ip, –it
qissarutaarpaa	V	(no generation)
qissaserpoq	V	(no generation)
qissaseruttort¦oq	N	–up, –ut
qissa¦seruttortoq	N	{–seruttortup, –tileruttortup}, {–seruttortut, –tileruttortut}
qissat	N	–ip, –it
qissataavoq	V	(no generation)
qissatigaa	V	(no generation)
qissattaat	N	–ip, –it
qissattarpoq	V	(no generation)
qissattorfigaa	V	(no generation)
qissattorpaa	V	(no generation)
qissattorpoq	V	(no generation)
qissattuusiorpoq	V	(no generation)
qissattuut	N	–ip, –it
qissavigaa	V	(no generation)
qisserfigaa	V	(no generation)
qisserlu¦k	N	–up, –it
qisserluliuppaa	V	(no generation)
qisserluppoq	V	(no generation)
qisserpoq	V	(no generation)
qissertaarpoq	V	(no generation)
qissiaavoq	V	(no generation)
qissia¦q	N	–p, –t
qissiaraa	V	(no generation)
qissiarpoq	V	(no generation)
qissiarsu¦aq	N	–up, –it
qissiartaannarpoq	V	(no generation)
qissiartaat	N	–ip, –it
qissiartaat	N, pl.	-
qissigaa	V	(no generation)
qissigikkuppaa	V	(no generation)
qissigitsiaannarpaa	V	(no generation)
qissigusuppoq	V	(no generation)
qissikalatippaa	V	(no generation)
qissikalavoq	V	(no generation)
qissimavoq	V	(no generation)
qissimigaarpaa	V	(no generation)
qissimigaarpoq	V	(no generation)
qissimigaarsimavaa	V	(no generation)
qissiminne¦q	N	–rup, –rit
qissimippaa	V	(no generation)
qissimippoq	V	(no generation)
qissinnaqaaq	V	(no generation)
qissinnarpoq	V	(no generation)
qissinnart¦oq	N	–up, –ut
qissisaannarpoq	V	(no generation)
qissisarpoq	V	(no generation)
qissisart¦oq	N	–up, –ut
qissi¦t	N	–sip, –sit
qissiuppaa	V	(no generation)
qissiussa¦q	N	–p, –t
qissivi¦k	N	–up, –it
qissivoq	V	(no generation)
qissorippoq	V	(no generation)
qissu¦k	N	–up, –it
qissuliiarpaa	V	(no generation)
qissullerpoq	V	(no generation)
qissuppaa	V	(no generation)
qissuppoq	V	(no generation)
qissut	N	–ip, –it
qisuariaat	N	–ip, –it
qisuarianngilaq	V	(no generation)
qisuariarfiginninne¦q	N	–rup, –rit
qisuariarne¦q	N	–rup, –rit
qisuariarpoq	V	(no generation)
qisuariartanngitsut	N, pl.	-
qisuavoq	V	(no generation)
qisuerniarfi¦k	N	–up, –it
qisugaa	V	(no generation)
qisugisaavoq	V	(no generation)
qisuisorpoq	V	(no generation)
qisuisortussaavoq	V	(no generation)
qisu¦k	N	–up, –it
qisul¦ineq	N	{–ernup, –inerup}, {–ernit, –inerit}
qisulliorpoq	V	(no generation)
qisunne¦q	N	–rup, –rit
qisuppaa	V	(no generation)
qisussaannaavoq	V	(no generation)
qisussaasivi¦k	N	–up, –it
qisussa¦q	N	–p, –t
qisusserpaa	V	(no generation)
qisussiaminikulla¦k	N	–ap, –at
qisussia¦q	N	–p, –t
qisussiassa¦q	N	–p, –t
qisussimavoq	V	(no generation)
qisussiorpoq	V	(no generation)
qisussiort¦oq	N	–up, –ut
qisuss¦iortoq	N	{–iortup, –aliortup}, {–iortut, –aliortut}
qisussivoq	V	(no generation)
qisussunni¦ppoq	V	–nngilaq
qisuttalerpaa	V	(no generation)
qisutta¦q	N	–p, –t
qisuttarpoq	V	(no generation)
qisuttassa¦q	N	–p, –t
qisuttassiorpoq	V	(no generation)
qisuttorpaa	V	(no generation)
qisuttuiffi¦k	N	–up, –it
qisu¦ttuiffik	N	{–juiffiup, –ttuiffiup}, {–juiffiit, –ttuiffiit}
qisuttuine¦q	N	–rup, –rit
qisuttuisarfi¦k	N	–up, –it
qisuttuis¦oq	N	–up, –ut
qisuttui¦vik	N	{–ffiup, –viup}, {–ffiit, –viit}
qisuttuivoq	V	(no generation)
qisuttuuminngilaq	V	(no generation)
qisuttuut	N	–ip, –it
qisuttuut	N, pl.	-
qisuusivi¦k	N	–up, –it
qisuusivissu¦aq	N	–up, –it
qisuusivittaa¦q	N	–p, –t
qisuusiviuvoq	V	(no generation)
qisuuvoq	V	(no generation)
qitaarpoq	V	(no generation)
qitaasarpoq	V	(no generation)
q¦iteq	N	{–eqqup, –itip}, {–eqqit, –itit}
qiteqqerivoq	V	(no generation)
qiteqqulluarpoq	V	(no generation)
qiteqqunne¦q	N	–rup, –rit
qiteqquppaa	V	(no generation)
qiteqquppoq	V	(no generation)
qiteqquta¦q	N	–p, –t
qiteqquut	N	–ip, –it
qitequserpoq	V	(no generation)
qitequt	N	–ip, –it
qitequtaarpaa	V	(no generation)
qitequ¦tileqqusissut	N	{–seqqusissutip, –tileqqusissutip}, {–seqqusissutit, –tileqqusissutit}
qiteraarsivoq	V	(no generation)
qiteraasa¦q	N	–p, –t
qiteraassaarpoq	V	(no generation)
qiteraassaartippaa	V	(no generation)
qiteral¦ik	N	{–iup, –lip, –lup}, –lit
qiteraluppoq	V	(no generation)
qite¦raq	N	–qqap, –qqat
qiterarpoq	V	(no generation)
qiterartal¦ik	N	{–iup, –lip, –lup}, –lit
qiteriaa¦seq	N	–tsip, –tsit
qiteriarne¦q	N	–rup, –rit
qiterisaqarfi¦k	N	–up, –it
qiteritita¦q	N	–p, –t
qiterl¦eq	N	–iup, –iit
qiterlerminne¦q	N	–rup, –rit
qit¦erlunneq	N	{–erlunnerup, –ilunnerup}, {–erlunnerit, –ilunnerit}
qiterluppoq	V	(no generation)
qitermiu	N	–p, –t
Qitermiut	N, pl.	-
qiterparpaa	V	(no generation)
qiterparpoq	V	(no generation)
qiterpia¦q	N	–p, –t
qiterpiarpaa	V	(no generation)
qiterrusappoq	V	(no generation)
qitersivaa	V	(no generation)
qitersorpoq	V	(no generation)
qiterummiugaa	V	(no generation)
qiteruserpaa	V	(no generation)
qiteruserpoq	V	(no generation)
qiterut	N	–ip, –it
qiterutil¦ik	N	{–iup, –lip, –lup}, –lit
qitiffarippoq	V	(no generation)
qitigiaanna¦q	N	–ap, –at
qitigi¦aq	N	–ssap, –ssat
qitigiarpoq	V	(no generation)
qitigiarsorne¦q	N	–rup, –rit
qitigiar¦sorneq	N	{–sornerup, –tornerup}, {–sornerit, –tornerit}
qitigiarsorpoq	V	(no generation)
qitigissiort¦oq	N	–up, –ut
qitik	N	(no generation)
qitikkajuppoq	V	(no generation)
qitikkajutt¦oq	N	–up, –ut
qitikkiarpoq	V	(no generation)
qitikkiartorpoq	V	(no generation)
qitikkumatuvoq	V	(no generation)
qitinne¦q	N	–rup, –rit
qitinnersu¦aq	N	–up, –it
qitippoq	V	(no generation)
qititsappoq	V	(no generation)
qitittart¦oq	N	–up, –ut
qitius¦oq	N	–up, –ut
qitiusoqarfi¦k	N	–up, –it
qitiusorta¦q	N	–p, –t
qitiutitaane¦q	N	–rup, –rit
qitiutita¦q	N	–p, –t
qitivilluarsinnaavoq	V	(no generation)
qitivippoq	V	(no generation)
qitorlu¦k	N	–up, –it
qitornaarpoq	V	(no generation)
qitornaaruppoq	V	(no generation)
qitornaats¦oq	N	–up, –ut
qitornal¦ik	N	{–iup, –lip, –lup}, –lit
qitornanngu¦aq	N	–up, –it
qitorna¦q	N	–p, –t
qitornaqanngilaq	V	(no generation)
qitornarsia¦q	N	–p, –t
qitornarsiarineqarallarsimas¦oq	N	–up, –ut
qitornarsiarineqarallarsimavoq	V	(no generation)
qitornartaaqqaart¦oq	N	–up, –ut
qitornartaarfigaa	V	(no generation)
qitornartaarpoq	V	(no generation)
qitornassa¦q	N	–p, –t
qitornatua¦q	N	–p, –t
qitornavissial¦ik	N	{–iup, –lip, –lup}, –lit
qitornavissiallit	N, pl.	-
qitornavissia¦q	N	–p, –t
qitornavissiartaarne¦q	N	–rup, –rit
qitornavissiartaarpoq	V	(no generation)
qitornavissiat	N, pl.	-
qitorngaarpoq	V	(no generation)
qitorngal¦ik	N	{–iup, –lip, –lup}, –lit
qitornga¦q	N	–p, –t
qitorngaqanngilaq	V	(no generation)
qitorngarsia¦q	N	–p, –t
qitorngartaarpoq	V	(no generation)
qitorngassa¦q	N	–p, –t
qitorngiorpoq	V	(no generation)
qitorngivoq	V	(no generation)
qitorniorpoq	V	(no generation)
qitornivigaa	V	(no generation)
qitornivoq	V	(no generation)
qitsarippoq	V	(no generation)
qitseraavoq	V	(no generation)
qitserarfi¦k	N	–up, –it
qitserarpaa	V	(no generation)
qitserarpoq	V	(no generation)
qitserart¦oq	N	–up, –ut
qitserisaannarpoq	V	(no generation)
qitserit¦ooq	N	–uup, –uut
qitserituvoq	V	(no generation)
qitserivoq	V	(no generation)
qitsi¦ppoq	V	–nngilaq
qitsuaavoq	V	(no generation)
qitsua¦raq	N	–qqap, –qqat
qitsuarpaa	V	(no generation)
qitsuarsu¦k	N	–up, –it
qitsuinertoqaaq	V	(no generation)
qitsuivoq	V	(no generation)
qitsu¦k	N	–up, –it
qitsulluarpoq	V	(no generation)
qitsunne¦q	N	–rup, –rit
qitsunnersu¦aq	N	–up, –it
qitsunnert¦ooq	N	–uup, –uut
qitsupappaa	V	(no generation)
qitsupassimavaa	V	(no generation)
qitsupattaarpaa	V	(no generation)
qitsuppaa	V	(no generation)
qitsuppaluppoq	V	(no generation)
qitsuppoq	V	(no generation)
qitsussimavaa	V	(no generation)
qitsussu¦aq	N	–up, –it
qitsuttaarpoq	V	(no generation)
qitsuuserpaa	V	(no generation)
qitsuusersorpaa	V	(no generation)
qitsuut	N	–ip, –it
qitsuuteqarne¦q	N	–rup, –rit
qittareqqissaarpoq	V	(no generation)
qittarippoq	V	(no generation)
qittarivippoq	V	(no generation)
qittarluppoq	V	(no generation)
qittarne¦q	N	–rup, –rit
qittarnerpoq	V	(no generation)
qittarpoq	V	(no generation)
qittas¦eq	N	–ip, –it
qittaserpoq	V	(no generation)
qittasiusart¦oq	N	–up, –ut
qituaarpoq	V	(no generation)
qitualaarpoq	V	(no generation)
qituallappoq	V	(no generation)
qituarpoq	V	(no generation)
qituffarippoq	V	(no generation)
qituillaqqeqaaq	V	(no generation)
qituippoq	V	(no generation)
qitujaarpoq	V	(no generation)
qituliorsaavoq	V	(no generation)
qituliorsarpaa	V	(no generation)
qitulisaat	N	–ip, –it
qitulisaavoq	V	(no generation)
qitulisarpaa	V	(no generation)
qitulivoq	V	(no generation)
qitulliaappoq	V	(no generation)
qitulligaarpoq	V	(no generation)
qitulligarpoq	V	(no generation)
qitullippoq	V	(no generation)
qitullisippaa	V	(no generation)
qitunne¦q	N	–rup, –rit
qitupe¦raq	N	–qqap, –qqat
qituppoq	V	(no generation)
qitusuppoq	V	(no generation)
qitutsaappaa	V	(no generation)
qitutsappoq	V	(no generation)
qitutsigajuppoq	V	(no generation)
qitutsilerpoq	V	(no generation)
qitutsi¦ppoq	V	–nngilaq
qitutsivoq	V	(no generation)
qitutt¦oq	N	–up, –ut
qituttul¦ik	N	{–iup, –lip, –lup}, –lit
qituttunngu¦aq	N	–up, –it
qituttut	N, pl.	-
qiulerpallaassanngilaq	V	(no generation)
qiulerpoq	V	(no generation)
qiulinngilaq	V	(no generation)
qiunngujoorpoq	V	(no generation)
qiusivaa	V	(no generation)
qiutappoq	V	(no generation)
qiutserpoq	V	(no generation)
qiuuserpoq	V	(no generation)
qiuut	N	–ip, –it
qiuutit	N, pl.	-
qiuvoq	V	(no generation)
qivaaqi	N	–p, –t
qivaasarpoq	V	(no generation)
qiveerpoq	V	(no generation)
qiverluarpoq	V	(no generation)
qiverne¦q	N	–rup, –rit
qivernersiut	N	–ip, –it
qiverpoq	V	(no generation)
qiversarfi¦k	N	–up, –it
qiversart¦oq	N	–up, –ut
qiversippaa	V	(no generation)
qiversoorpoq	V	(no generation)
qiverulluarpaa	V	(no generation)
qiveruppaa	V	(no generation)
qiviallaavaa	V	(no generation)
qiviallaavoq	V	(no generation)
qiviaqquaa	V	(no generation)
qiviarnaveersaarpoq	V	(no generation)
qiviarpaa	V	(no generation)
qiviarpoq	V	(no generation)
qiviarsaavoq	V	(no generation)
qiviarsarpaa	V	(no generation)
qiviarumajunnaarsippaa	V	(no generation)
qiviinnarsimavoq	V	(no generation)
qivingavallaarpoq	V	(no generation)
qivingavoq	V	(no generation)
qivinngaarippoq	V	(no generation)
qivinngataarpoq	V	(no generation)
qivi¦oq	N	–up, –ut
qivi¦ppoq	V	–nngilaq
qivisingajappaa	V	(no generation)
qivisivaa	V	(no generation)
qivissutigaa	V	(no generation)
qivita¦q	N	–p, –t
qivitippaa	V	(no generation)
qivitsi¦ppoq	V	–nngilaq
qivitt¦oq	N	–up, –ut
qivittorsiorpoq	V	(no generation)
qivittulersaarpoq	V	(no generation)
qivittulersaarutit	N, pl.	-
qivittutoq¦aq	N	{–qap, –ap}, {–qat, –at}
qivittuusaarpoq	V	(no generation)
qivituppoq	V	(no generation)
qiviu	N	–p, –t
qiviuiaavoq	V	(no generation)
qiviuiarpaa	V	(no generation)
qiviuinnaavoq	V	(no generation)
qiviuinna¦q	N	–ap, –at
qiviul¦ik	N	{–iup, –lip, –lup}, –lit
qiviulisa¦q	N	–p, –t
qiviut	N, pl.	-
qiviuusat	N, pl.	-
qiviveerpoq	V	(no generation)
qiviveersippaa	V	(no generation)
q¦ooq	N	–uup, –uut
qooqersorajuppoq	V	(no generation)
qooqersorpoq	V	(no generation)
qooqila	N	–p, –t
qooqilavoq	V	(no generation)
qooqqaaluppoq	V	(no generation)
qooqqaa¦q	N	–p, –t
qooqqaarippoq	V	(no generation)
qooqqa¦q	N	–ap, –at
qooqqerpaa	V	(no generation)
qooqqerpoq	V	(no generation)
qooqqersimane¦q	N	–rup, –rit
qooqqersorpaa	V	(no generation)
qooqqiarpoq	V	(no generation)
qooqqiit	N	–ip, –it
qooqqilerusiorpoq	V	(no generation)
qooqqilerut	N	–ip, –it
qooqqiliut	N	–ip, –it
qooqqine¦q	N	–rup, –rit
qooqqinert¦ooq	N	–uup, –uut
qooqqiorpaa	V	(no generation)
qooqqivaa	V	(no generation)
qooqqivoq	V	(no generation)
qooqqut	N, pl.	-
qooriakippoq	V	(no generation)
qooriakits¦oq	N	–up, –ut
Qoorng¦oq	N	–up, –ut
Qoorngormi¦oq	N	–up, –ut
qoorngortuut	N	–ip, –it
qoorngortuut	N, pl.	-
qoornguj¦ooq	N	–uup, –uut
qoorn¦oq	N	–up, –ut
Qoornormi¦oq	N	–up, –ut
qoornortuut	N	–ip, –it
qoornortuut	N, pl.	-
qoornuj¦ooq	N	–uup, –uut
qoo¦roq	N	–qqup, –qqut
qoororsu¦aq	N	–up, –it
qoorort¦ooq	N	–uup, –uut
qoorortuua¦raq	N	–qqap, –qqat
qoortuvoq	V	(no generation)
qooruaarpaa	V	(no generation)
qooruaarpoq	V	(no generation)
qooruaartuinnaavoq	V	(no generation)
qooru¦aq	N	–ssap, –ssat
qooruarpaa	V	(no generation)
qooruppaa	V	(no generation)
qoorusiorpoq	V	(no generation)
qoorussaavoq	V	(no generation)
qoorusuatsia¦q	N	–p, –t
qoorusu¦k	N	–up, –it
qoorusunngu¦aq	N	–up, –it
qoorusussu¦aq	N	–up, –it
qoorut	N	–ip, –it
qoorutaaruppoq	V	(no generation)
qoqaa¦q	N	–p, –t
qoqaarippoq	V	(no generation)
qoqaarissilluarpoq	V	(no generation)
qoqassiinia¦q	N	–p, –t
qoqassiivoq	V	(no generation)
qoqassisa¦q	N	–p, –t
qoqassivaa	V	(no generation)
qoqeraa	V	(no generation)
qoqerittaappoq	V	(no generation)
qoqernaqaaq	V	(no generation)
qoqernarpoq	V	(no generation)
qoqerpaa	V	(no generation)
qoqerpoq	V	(no generation)
qoqianngunaqaaq	V	(no generation)
qoqianngusaannarpoq	V	(no generation)
qoqiannguvoq	V	(no generation)
qoqq¦oq	N	–up, –ut
qorfi¦k	N	–up, –it
qorfilerpoq	V	(no generation)
qorliarpoq	V	(no generation)
qorl¦oq	N	–up, –ut
qorlorfi¦k	N	–up, –it
qorlorpoq	V	(no generation)
qorlortitsivi¦k	N	–up, –it
qorlortitsi¦vik	N	{–ffiup, –viup}, {–ffiit, –viit}
Qorlort¦oq	N	–up, –ut
qorlort¦oq	N	–up, –ut
qorluiarpoq	V	(no generation)
qorlunngutitsivoq	V	(no generation)
qorlunnguvoq	V	(no generation)
qorluulaalla¦k	N	–ap, –at
qorluulaarpoq	V	(no generation)
qorluulavoq	V	(no generation)
qorsaqqorpoq	V	(no generation)
qorsaqqortarpoq	V	(no generation)
qors¦ineq	N	{–ernup, –inerup}, {–ernit, –inerit}
qorsooqqippoq	V	(no generation)
qorsooqqissivoq	V	(no generation)
qorsooqqiss¦oq	N	–up, –ut
qorsooqqi¦ssoq	N	{–ssup, –ttup}, {–ssut, –ttut}
qorsooqqissuuvoq	V	(no generation)
qorsorpaluppoq	V	(no generation)
qorsorpalutt¦oq	N	–up, –ut
qorsu¦k	N	–up, –it
qorsunnialaarpoq	V	(no generation)
qorsunnippoq	V	(no generation)
qorsuppaluppoq	V	(no generation)
quaaffigaa	V	(no generation)
quaa¦ppoq	V	–nngilaq
quaaqqippoq	V	(no generation)
quaaqqivoq	V	(no generation)
quaartorpoq	V	(no generation)
quaasivoq	V	(no generation)
quaat	N	–ip, –it
quaataaruppoq	V	(no generation)
quaatitaarpoq	V	(no generation)
quajaasivoq	V	(no generation)
quajaassu¦aq	N	–up, –it
quajaat	N	–ip, –it
quajaatit	N, pl.	-
qu¦aq	N	–ssap, –ssat
quaraarpaa	V	(no generation)
quaraarpaluppoq	V	(no generation)
quaraarpoq	V	(no generation)
quaraasarpoq	V	(no generation)
quaraavoq	V	(no generation)
quarakippoq	V	(no generation)
quaranippoq	V	(no generation)
qua¦raq	N	–qqap, –qqat
quarsaangavoq	V	(no generation)
quarsaarne¦q	N	–rup, –rit
quarsaarpoq	V	(no generation)
quarsaarsimas¦oq	N	–up, –ut
quarsaartippaa	V	(no generation)
quarsaartitsivoq	V	(no generation)
quartaaruppoq	V	(no generation)
quartaasa¦q	N	–p, –t
quartagajuppoq	V	(no generation)
quartanippoq	V	(no generation)
Quarta¦q	N	–p, –t
Quarta¦q	Prop	–p
quarta¦q	N	–p, –t
quartasaannarpoq	V	(no generation)
quartatigaa	V	(no generation)
quartat¦ooq	N	–uup, –uut
quartavoq	V	(no generation)
quartorpoq	V	(no generation)
quasa¦k	N	–p, –t
quasalia¦q	N	–p, –t
quasaliarpoq	V	(no generation)
quasappoq	V	(no generation)
quasarpoq	V	(no generation)
quasart¦oq	N	–up, –ut
quasartuinnaavoq	V	(no generation)
quasasiorpoq	V	(no generation)
quasassu¦seq	N	–tsip, –tsit
quasatt¦oq	N	–up, –ut
quasivaa	V	(no generation)
quasivoq	V	(no generation)
quasserpaa	V	(no generation)
quassersorpaa	V	(no generation)
quassivaa	V	(no generation)
quassuganippoq	V	(no generation)
quassu¦gaq	N	–kkap, –kkat
quassugarsu¦aq	N	–up, –it
quassugippoq	V	(no generation)
quassugiss¦oq	N	–up, –ut
quassugi¦ssoq	N	{–ssup, –ttup}, {–ssut, –ttut}
quassuiarpaa	V	(no generation)
quassuits¦oq	N	–up, –ut
quassu¦k	N	–up, –it
quassulerpaa	V	(no generation)
quassulersorpaa	V	(no generation)
quassul¦ik	N	{–iup, –lip, –lup}, –lit
quassunngu¦aq	N	–up, –it
Quassussu¦aq	N	–up, –it
Quassussu¦aq	Prop	–up, –it
quassutt¦ooq	N	–uup, –uut
quatserivoq	V	(no generation)
quatserpoq	V	(no generation)
quee¦raq	N	–qqap, –qqat
qu¦eeraq	N	{–eeqqap, –iaqqap}, {–eeqqat, –iaqqat}
queerne¦q	N	–rup, –rit
queerpoq	V	(no generation)
querasaarajuppoq	V	(no generation)
querasaarfigaa	V	(no generation)
querasaarpoq	V	(no generation)
querpoq	V	(no generation)
quersa¦q	N	–p, –t
quersarlerpoq	V	(no generation)
quersarluppoq	V	(no generation)
querserarpoq	V	(no generation)
querserpoq	V	(no generation)
quersorne¦q	N	–rup, –rit
quersorpoq	V	(no generation)
quersortaannarpoq	V	(no generation)
quersortarpoq	V	(no generation)
quersortuuvoq	V	(no generation)
quersualeris¦oq	N	–up, –ut
quersu¦aq	N	–up, –it
quertaarpoq	V	(no generation)
quert¦eq	N	–ip, –it
quertil¦ik	N	{–iup, –lip, –lup}, –lit
quertinippoq	V	(no generation)
quertuinnaavoq	V	(no generation)
queruersaat	N	–ip, –it
querunne¦q	N	–rup, –rit
queruppoq	V	(no generation)
querusuersaappaa	V	(no generation)
querusuersarpoq	V	(no generation)
querusukkunnaarpoq	V	(no generation)
querusuppoq	V	(no generation)
querutsi¦ppoq	V	–nngilaq
quffavoq	V	(no generation)
qui	N	–p, –t
quiagaa	V	(no generation)
quiaginngilaa	V	(no generation)
quiakkia¦q	N	–ap, –at
quianaappoq	V	(no generation)
quianaarpaa	V	(no generation)
quiananngilaq	V	(no generation)
quianarpoq	V	(no generation)
quianarsivoq	V	(no generation)
quianart¦oq	N	–up, –ut
quianartulia¦q	N	–p, –t
quianartut	N, pl.	-
quianavippoq	V	(no generation)
quiappoq	V	(no generation)
quia¦q	N	–p, –t
quiartorpoq	V	(no generation)
quiasaarajuppoq	V	(no generation)
quiasaarisart¦oq	N	–up, –ut
quiasaarne¦q	N	–rup, –rit
quiasaarpoq	V	(no generation)
quiasaartart¦oq	N	–up, –ut
quiasaarut	N	–ip, –it
quiasaarutiginninne¦q	N	–rup, –rit
quiasaarutiginnippoq	V	(no generation)
quiasaarutit	N, pl.	-
quiassuaat	N	–ip, –it
quiassuaatipalaa¦q	N	–p, –t
quiassuaavoq	V	(no generation)
quiassuarne¦q	N	–rup, –rit
quiassuarpaa	V	(no generation)
quiasukkajuppoq	V	(no generation)
quiasunne¦q	N	–rup, –rit
quiasunnert¦ooq	N	–uup, –uut
quiasuppoq	V	(no generation)
quiasutsippaa	V	(no generation)
quiasutsitsivoq	V	(no generation)
quiasuutigaa	V	(no generation)
quiatsaappaa	V	(no generation)
quiatsaassivoq	V	(no generation)
quiatsappoq	V	(no generation)
quiattaappoq	V	(no generation)
quiattarpoq	V	(no generation)
quigajuppoq	V	(no generation)
quikulaarpoq	V	(no generation)
quilerratsaappaa	V	(no generation)
quilerratsappoq	V	(no generation)
quilerroorpoq	V	(no generation)
quilerroorutigaa	V	(no generation)
quilertagaa	V	(no generation)
quilertanarpoq	V	(no generation)
quilertanart¦oq	N	–up, –ut
quilertassutigaa	V	(no generation)
quilertavoq	V	(no generation)
quiliorpaa	V	(no generation)
quiliorpoq	V	(no generation)
quilivippoq	V	(no generation)
quinagaa	V	(no generation)
quinannaqaaq	V	(no generation)
quinannarpoq	V	(no generation)
quinappoq	V	(no generation)
quinaqaaq	V	(no generation)
quinassaarivoq	V	(no generation)
quinassaarpaa	V	(no generation)
quinassinnaanngilaq	V	(no generation)
quinat¦ooq	N	–uup, –uut
quinatoorsu¦aq	N	–up, –it
quinatunersaavoq	V	(no generation)
quinatuvoq	V	(no generation)
quine¦q	N	–rup, –rit
quisaat	N	–ip, –it
quisaatit	N, pl.	-
quisarfi¦k	N	–up, –it
quisarpaa	V	(no generation)
quivaa	V	(no generation)
quivoq	V	(no generation)
qujaannarfigaa	V	(no generation)
qujaannarpoq	V	(no generation)
qujaavaalliorpoq	V	(no generation)
qujaavaalluinnarpoq	V	(no generation)
qujaavaappoq	V	(no generation)
qujaffigaa	V	(no generation)
qujagaa	V	(no generation)
qujaginnippallaarne¦q	N	–rup, –rit
qujagisaavoq	V	(no generation)
qujagisa¦q	N	–p, –t
qujagissaavoq	V	(no generation)
qujajuippoq	V	(no generation)
qujamasuffigaa	V	(no generation)
qujamasuppoq	V	(no generation)
qujamasutt¦oq	N	–up, –ut
qujamasuutigaa	V	(no generation)
qujanaallak	Interj	(no generation)
qujanaqaaq	V	(no generation)
qujanarniarpoq	V	(no generation)
qujanarniart¦oq	N	–up, –ut
qujanarpoq	V	(no generation)
qujanarsilat	Interj	(no generation)
qujanarsuaq	Interj	(no generation)
qujanartuarpoq	V	(no generation)
qujanarujussuaq	Interj	(no generation)
qujanavik	Interj	(no generation)
qujanavissuaq	Interj	(no generation)
qujaniarpoq	V	(no generation)
qujaniut	N	–ip, –it
qujaniutaavoq	V	(no generation)
qujaniuteqarne¦q	N	–rup, –rit
qujarmavaa	V	(no generation)
qujarmavoq	V	(no generation)
qujarulluarpaa	V	(no generation)
qujaruppaa	V	(no generation)
qujasaarpoq	V	(no generation)
qujasaat	N	–ip, –it
qujasaavoq	V	(no generation)
qujasarpaa	V	(no generation)
qujasseralappoq	V	(no generation)
qujassut	N	–ip, –it
qujassutaavoq	V	(no generation)
qujassutigaa	V	(no generation)
qujasuippoq	V	(no generation)
qujatippaa	V	(no generation)
qujavaa	V	(no generation)
qujavoq	V	(no generation)
qukkiartorpoq	V	(no generation)
qulaajaane¦q	N	–rup, –rit
qulaajaavoq	V	(no generation)
qulaajarpaa	V	(no generation)
qulaakkiartorpaa	V	(no generation)
qulaakkoorpaa	V	(no generation)
qulaakkoorpoq	V	(no generation)
qulaaluanngorluarpoq	V	(no generation)
qulaaluaraarpoq	V	(no generation)
qulaaluat	Num	-
qulaanii¦ppoq	V	–nngilaq
qulaaniittorta¦q	N	–p, –t
qulaappaa	V	(no generation)
qulaappoq	V	(no generation)
qulaarneqarpoq	V	(no generation)
qulaarpaa	V	(no generation)
qulaarpoq	V	(no generation)
qulaarsivoq	V	(no generation)
qulaartippaa	V	(no generation)
qulaasungarpaa	V	(no generation)
qulaasungartippoq	V	(no generation)
qulaatiinnarpaa	V	(no generation)
qulaatsorpallaaqaaq	V	(no generation)
qulaatsorpoq	V	(no generation)
qulaavaavaa	V	(no generation)
qulakkeerine¦q	N	–rup, –rit
qulakkeerpaa	V	(no generation)
qulangerpaa	V	(no generation)
qulangersimavaa	V	(no generation)
qulangersorpaa	V	(no generation)
qulangiaavoq	V	(no generation)
qulangiavaa	V	(no generation)
qulangiisuuvoq	V	(no generation)
qulangiivoq	V	(no generation)
qulangiuaarivoq	V	(no generation)
qulangiuppaa	V	(no generation)
qulangiuppoq	V	(no generation)
qulaqqeerluinnarpaa	V	(no generation)
qulaqqeerpaa	V	(no generation)
qularaa	V	(no generation)
qulariartuinnalerpaa	V	(no generation)
qularilluinnarpaa	V	(no generation)
qularinngilaa	V	(no generation)
qulariummerpaa	V	(no generation)
qulariunnaarpaa	V	(no generation)
qularivippaa	V	(no generation)
qularnaallisaat	N	–ip, –it
qularnaappoq	V	(no generation)
qularnaarin¦ninneq	N	{–erup, –ninnerup}, {–erit, –ninnerit}
qularnaarpaa	V	(no generation)
qularnaat	N	–ip, –it
qularnaats¦oq	N	–up, –ut
qularnanngilaq	V	(no generation)
qularnanngissu¦seq	N	–tsip, –tsit
qularnanngits¦oq	N	–up, –ut
qularnaqaaq	V	(no generation)
qularnarpoq	V	(no generation)
qularnart¦oq	N	–up, –ut
qularnartoqarpoq	V	(no generation)
qularnartoqartitsine¦q	N	–rup, –rit
qularnaveeqqu¦seeriaaseq	N	{–seeriaatsip, –tileeriaatsip}, {–seeriaatsit, –tileeriaatsit}
qularnaveeqquserpaa	V	(no generation)
qularnaveeqqusiiffigisa¦q	N	–p, –t
qularnaveeqqu¦siiffigisaq	N	{–siiffigisap, –tiliiffigisap}, {–siiffigisat, –tiliiffigisat}
qularnaveeqqusiiffi¦k	N	–up, –it
qularnaveeqqu¦siiffik	N	{–siiffiup, –tiliiffiup}, {–siiffiit, –tiliiffiit}
qularnaveeqqusiine¦q	N	–rup, –rit
qularnaveeqqu¦siineq	N	{–siinerup, –tiliinerup}, {–siinerit, –tiliinerit}
qularnaveeqqu¦siissut	N	{–siissutip, –tiliissutip}, {–siissutit, –tiliissutit}
qularnaveeqqut	N	–ip, –it
qularne¦q	N	–rup, –rit
qularpoq	V	(no generation)
qularsaavoq	V	(no generation)
qulart¦oq	N	–up, –ut
qularunnaarsitaane¦q	N	–rup, –rit
qularutigaa	V	(no generation)
qularutiginngilaa	V	(no generation)
qulassa¦q	N	–p, –t
qulassarpoq	V	(no generation)
qulassutigaa	V	(no generation)
qul¦e	N	–ip, –it
qulequserpaa	V	(no generation)
qulequsiuppaa	V	(no generation)
qulequt	N	–ip, –it
qulequtaa¦raq	N	–qqap, –qqat
qulequtaavoq	V	(no generation)
qulequtaliuppaa	V	(no generation)
qulequt¦aq	N	{–ap, –tap}, {–at, –tat}
qulequtaqarpoq	V	(no generation)
qulequtaqatigiit	N, pl.	-
qulequtarisa¦q	N	–p, –t
quleraa	V	(no generation)
quleraarpoq	V	(no generation)
qulerarterut	N	–ip, –it
qulerfi¦k	N	–up, –it
quleriiaat	N, pl.	-
quleriit	N, pl.	-
qulertaarpoq	V	(no generation)
quleruakippoq	V	(no generation)
quleru¦aq	N	–ssap, –ssat
quleruart¦ooq	N	–uup, –uut
qulerusserpaa	V	(no generation)
qulerussersorpaa	V	(no generation)
qulerussiuppaa	V	(no generation)
quleruta¦q	N	–p, –t
quliffi¦k	N	–up, –it
quligaa	V	(no generation)
qulikkuutaareriaa¦seq	N	–tsip, –tsit
qulikkuutaarisaa¦seq	N	–tsip, –tsit
qulil¦ik	N	{–iup, –lip, –lup}, –lit
qulimiguul¦ik	N	{–iup, –lip, –lup}, –lit
qulingiluaat	N	–ip, –it
qulingiluanngorpoq	V	(no generation)
qulingiluaraarpoq	V	(no generation)
qulingiluariarpoq	V	(no generation)
qulingiluat	Num	-
qulinne¦q	N	–rup, –rit
qulinnii¦ppoq	V	–nngilaq
qulippaa	V	(no generation)
qulippoq	V	(no generation)
qulisa¦q	N	–p, –t
qulisimalerpoq	V	(no generation)
qulisimane¦q	N	–rup, –rit
qulis¦imaneq	N	{–imanerup, –simanerup}, {–imanerit, –simanerit}
qulisimas¦oq	N	–up, –ut
qulis¦imasoq	N	{–imasup, –simasup}, {–imasut, –simasut}
qulisimavoq	V	(no generation)
qulissaaruppoq	V	(no generation)
qulissaavoq	V	(no generation)
qulissa¦q	N	–p, –t
qulisserpoq	V	(no generation)
qulissinniitt¦oq	N	–up, –ut
qulissiuppaa	V	(no generation)
qulissiuserpoq	V	(no generation)
qulissiut	N	–ip, –it
qulissiutitaarpoq	V	(no generation)
qulit	N, pl.	-
qulit	Num	-
qulitsa¦q	N	–p, –t
qulitt¦oq	N	–up, –ut
quli¦ttoq	N	{–ssup, –ttup}, {–ssut, –ttut}
quliut	N	–ip, –it
quliutaaruppoq	V	(no generation)
quliutissa¦q	N	–p, –t
quliutitaarpoq	V	(no generation)
qulivaa	V	(no generation)
qulivoq	V	(no generation)
qullaappaa	V	(no generation)
qullaassat	N, pl.	-
qullaassivoq	V	(no generation)
qullane¦q	N	–rup, –rit
qullariartort¦oq	N	–up, –ut
qullarnerpaaffi¦k	N	–up, –it
qullarnerpaa¦ffik	N	{–ffiup, –juffiup}, {–ffiit, –juffiit}
qullarpaa	V	(no generation)
qullarpoq	V	(no generation)
qullarsarpoq	V	(no generation)
qullarsimavoq	V	(no generation)
qullartaasia¦q	N	–p, –t
qullartaa¦siaq	N	{–siap, –tiliap}, {–siat, –tiliat}
qullartartulia¦q	N	–p, –t
qullarterpaa	V	(no generation)
qullarterpoq	V	(no generation)
qullartitta¦gaq	N	–kkap, –kkat
qullatikkarpoq	V	(no generation)
qull¦eeraq	N	{–eeqqap, –iaqqap}, {–eeqqat, –iaqqat}
qull¦eq	N	–iup, –iit
qullermii¦ppoq	V	–nngilaq
qullerpaa¦q	N	–p, –t
qullersaa¦q	N	–p, –t
qullersaarpoq	V	(no generation)
qullersaatitaane¦q	N	–rup, –rit
qullersa¦q	N	–p, –t
qullersaqarfi¦k	N	–up, –it
qullersivoq	V	(no generation)
qullersu¦aq	N	–up, –it
qullerusa¦q	N	–p, –t
qulli	N	–p, –t
qullilerfi¦k	N	–up, –it
qullililerpoq	V	(no generation)
qulliliorpoq	V	(no generation)
qullilivoq	V	(no generation)
qullingerpoq	V	(no generation)
qullingiarpaa	V	(no generation)
qullingiarpoq	V	(no generation)
qullingiartorpoq	V	(no generation)
qullingiuserpoq	V	(no generation)
qullingiut	N	–ip, –it
qullipajuppoq	V	(no generation)
qullipippoq	V	(no generation)
qullissaqarfi¦k	N	–up, –it
qullissia¦q	N	–p, –t
qulliuaannangajappoq	V	(no generation)
qulliuvoq	V	(no generation)
qullivaa	V	(no generation)
qullivoq	V	(no generation)
qulloorpoq	V	(no generation)
qullorfi¦k	N	–up, –it
qullorpaa	V	(no generation)
qullorpoq	V	(no generation)
qullortippaa	V	(no generation)
qullort¦oq	N	–up, –ut
qulluatserpaa	V	(no generation)
qulluatserpoq	V	(no generation)
qulluatsersimavoq	V	(no generation)
qullugaavoq	V	(no generation)
qullu¦gaq	N	–kkap, –kkat
qullugassa¦q	N	–p, –t
qullugiaarsu¦k	N	–up, –it
qullugiaarsussu¦aq	N	–up, –it
qullugianippoq	V	(no generation)
qullugi¦aq	N	–ssap, –ssat
qulluiaarsu¦k	N	–up, –it
qulluiaarsussu¦aq	N	–up, –it
qulluianippoq	V	(no generation)
qullui¦aq	N	–ssap, –ssat
qulluisaannarpoq	V	(no generation)
qulluisarpoq	V	(no generation)
qulluisippaa	V	(no generation)
qulluivoq	V	(no generation)
qullu¦k	N	–up, –it
qullukkia¦q	N	–p, –t
qullukkiorpoq	V	(no generation)
qullukkivoq	V	(no generation)
qullungagaa	V	(no generation)
qullunganaqaaq	V	(no generation)
qullungavoq	V	(no generation)
qullunne¦q	N	–rup, –rit
qullunneqarpoq	V	(no generation)
qulluppaa	V	(no generation)
qulluppoq	V	(no generation)
qullutserpaa	V	(no generation)
qullutserpoq	V	(no generation)
qullutsippaa	V	(no generation)
qullutsiterpaa	V	(no generation)
qulor¦oq	N	–up, –ut
qulororpoq	V	(no generation)
qulororsimaannalerpoq	V	(no generation)
quloruulerpoq	V	(no generation)
quloruuppaa	V	(no generation)
quloruussaavoq	V	(no generation)
quloruuvoq	V	(no generation)
qulualaarpoq	V	(no generation)
qulualaartaat	N	–ip, –it
qulualaartarpoq	V	(no generation)
quluarpoq	V	(no generation)
quluasorsuuvoq	V	(no generation)
quluavoq	V	(no generation)
qulujoqquummerpoq	V	(no generation)
qulumaats¦oq	N	–up, –ut
qulussuppoq	V	(no generation)
qulussuuppaa	V	(no generation)
qulussuussivoq	V	(no generation)
qulusuttorpoq	V	(no generation)
quluta¦q	N	–p, –t
qulutsu¦k	N	–up, –it
qumaallagaa	V	(no generation)
qumaallappoq	V	(no generation)
qumaa¦q	N	–p, –t
qumaarsussu¦aq	N	–up, –it
qumalatsisimavoq	V	(no generation)
qumalatsivoq	V	(no generation)
qumaluppoq	V	(no generation)
qumangaqaaq	V	(no generation)
qumangarlu¦k	N	–up, –it
qumangavallaarpoq	V	(no generation)
qumangavoq	V	(no generation)
qumanippoq	V	(no generation)
qumanngaallaannarpoq	V	(no generation)
qumanngaallappoq	V	(no generation)
qumanngaallatsippaa	V	(no generation)
quma¦q	N	–p, –t
qumarpaa	V	(no generation)
qumarpoq	V	(no generation)
qumarsimavoq	V	(no generation)
qumartinneqarsinnaanngits¦oq	N	–up, –ut
qumartippaa	V	(no generation)
qumartitsine¦q	N	–rup, –rit
qumerruppoq	V	(no generation)
qumiguppaa	V	(no generation)
qumiingavoq	V	(no generation)
quminngaarpoq	V	(no generation)
qumippoq	V	(no generation)
qumissorpoq	V	(no generation)
qumitserpoq	V	(no generation)
qumiuppaa	V	(no generation)
qummaataraa	V	(no generation)
qummaatarivoq	V	(no generation)
qummarfi¦k	N	–up, –it
qummarne¦q	N	–rup, –rit
qummarpoq	V	(no generation)
qummartarne¦q	N	–rup, –rit
qummiartorpoq	V	(no generation)
qummippoq	V	(no generation)
qummoorpoq	V	(no generation)
qummoroorpoq	V	(no generation)
qummoroortaasiorpoq	V	(no generation)
qummoroortaat	N	–ip, –it
qummoroortarpoq	V	(no generation)
qummoroortart¦oq	N	–up, –ut
qummoroortitsissut	N	–ip, –it
qummoroortitsivoq	V	(no generation)
qummoroortussa¦q	N	–p, –t
qummorsorpoq	V	(no generation)
qummorsort¦oq	N	–up, –ut
qummuatta¦q	N	–p, –t
qummukaappaa	V	(no generation)
qummukaassivoq	V	(no generation)
qummukajaanngu¦aq	N	–up, –it
qummukajaa¦q	N	–p, –t
qummukarpoq	V	(no generation)
qummukuj¦ooq	N	–uup, –uut
qungaluppoq	V	(no generation)
qunga¦seq	N	–tsip, –tsit
qungasequt	N	–ip, –it
qungaseriarpoq	V	(no generation)
qungaserorpaa	V	(no generation)
qungaserrappoq	V	(no generation)
qungasers¦ooq	N	–uup, –uut
qungaserut	N	–ip, –it
qungasiarpaa	V	(no generation)
qungasiiarpoq	V	(no generation)
qungasiinna¦q	N	–ap, –at
qungasikippoq	V	(no generation)
qungasiluppoq	V	(no generation)
qungasim¦ineq	N	{–ernup, –inerup}, {–ernit, –inerit}
qungasim¦ineq	N	–ernup, –ernit
qungasiusa¦q	N	–p, –t
qungatserine¦q	N	–rup, –rit
qungatserivoq	V	(no generation)
qungi¦aq	N	–ssap, –ssat
qungiarpaa	V	(no generation)
qungiarpoq	V	(no generation)
qungiart¦ooq	N	–uup, –uut
qungiarulli¦k	N	–up, –it
qungorlusa¦q	N	–p, –t
qungujorutsi¦ppoq	V	–nngilaq
qungujuarsuppoq	V	(no generation)
qungujuffigaa	V	(no generation)
qungujulaarpoq	V	(no generation)
qungujulaart¦oq	N	–up, –ut
qungujulavoq	V	(no generation)
qungujunnaveersaarpoq	V	(no generation)
qungujunne¦q	N	–rup, –rit
qungujunnivi¦k	N	–up, –it
qungujuppaa	V	(no generation)
qungujuppoq	V	(no generation)
qungujutsippaa	V	(no generation)
qungujuumivoq	V	(no generation)
qungule¦q	N	–rup, –rit
qungulertorpoq	V	(no generation)
qunguliusa¦q	N	–p, –t
qungussutaarpoq	V	(no generation)
qungussutaarutigaa	V	(no generation)
qungussutari¦aq	N	–ssap, –ssat
qungusuppoq	V	(no generation)
qungutsarippoq	V	(no generation)
qungutsarissaarpoq	V	(no generation)
qungutsat	N	–ip, –it
qungutsataavoq	V	(no generation)
qungutsatigaa	V	(no generation)
quniillivoq	V	(no generation)
quniippoq	V	(no generation)
quniits¦oq	N	–up, –ut
quniivippoq	V	(no generation)
qunnaa¦q	N	–p, –t
qunne¦q	N	–rup, –rit
qunneqqippoq	V	(no generation)
qunneqqisippaa	V	(no generation)
qunneqqisitaarpoq	V	(no generation)
qunneqqiuppoq	V	(no generation)
qunneraatsia¦q	N	–ap, –at
qunneraatsi¦aq	N	–up, –it
qunneraavoq	V	(no generation)
qunneranngu¦aq	N	–up, –it
qunne¦raq	N	–qqap, –qqat
qunnerarsu¦aq	N	–up, –it
qunnermii¦ppoq	V	–nngilaq
qunnersu¦aq	N	–up, –it
qunnertal¦ik	N	{–iup, –lip, –lup}, –lit
qunngiarpaa	V	(no generation)
qunngiarpoq	V	(no generation)
qunngiartippaa	V	(no generation)
qunng¦oq	N	–up, –ut
qunngorsorpoq	V	(no generation)
qunnippoq	V	(no generation)
qunnisippaa	V	(no generation)
qunnueqanngilaq	V	(no generation)
qunnuigaa	V	(no generation)
qunnuiginngilaa	V	(no generation)
qunnui¦k	N	–up, –it
qunuffeqanngits¦oq	N	–up, –ut
qunugaa	V	(no generation)
qunugisaaruppoq	V	(no generation)
qunugisa¦q	N	–p, –t
qunujas¦oq	N	–up, –ut
qunujavoq	V	(no generation)
qunulersippaa	V	(no generation)
qunullerpoq	V	(no generation)
qunulliuppaa	V	(no generation)
qununaqaaq	V	(no generation)
qununarpoq	V	(no generation)
qununarsivoq	V	(no generation)
qununngilaq	V	(no generation)
qunusaarine¦q	N	–rup, –rit
qunusaarpaa	V	(no generation)
qunusaarut	N	–ip, –it
qunusia¦q	N	–p, –t
qunusiaraa	V	(no generation)
qunus¦oq	N	–up, –ut
qunusuilluinnarpoq	V	(no generation)
qunusuinne¦q	N	–rup, –rit
qunusuippoq	V	(no generation)
qunusuits¦oq	N	–up, –ut
qunutippaa	V	(no generation)
qunutitaane¦q	N	–rup, –rit
qunutitaas¦oq	N	–up, –ut
qunutitaavoq	V	(no generation)
qunutitsine¦q	N	–rup, –rit
qunutitsis¦oq	N	–up, –ut
qunutitsivoq	V	(no generation)
qunut¦ooq	N	–uup, –uut
qunutsappoq	V	(no generation)
qunutune¦q	N	–rup, –rit
qunutuvoq	V	(no generation)
qunuvoq	V	(no generation)
qupaloraarsu¦k	N	–up, –it
qupalorarsu¦gaq	N	–kkap, –kkat
qupalorarsu¦k	N	–up, –it
qupaluarsu¦k	N	–up, –it
qupanavarsu¦k	N	–up, –it
qupannaa¦q	N	–p, –t
qupannaatsiaasa¦q	N	–p, –t
qupannaatsia¦q	N	–ap, –at
quperl¦oq	N	–up, –ut
quperlorpoq	V	(no generation)
quperlorsiorpoq	V	(no generation)
quperlorsu¦aq	N	–up, –it
quperlussanippoq	V	(no generation)
quperlussa¦q	N	–p, –t
quperlussarpoq	V	(no generation)
quperluusa¦q	N	–p, –t
quperluusat	N, pl.	-
qupine¦q	N	–rup, –rit
qupingajanne¦q	N	–rup, –rit
qupinnguallanne¦q	N	–rup, –rit
qupinnguallappoq	V	(no generation)
qupinnguallatsippaa	V	(no generation)
qupinnguallatsitsivoq	V	(no generation)
qupinngulaarpoq	V	(no generation)
qupinngulaartitsivoq	V	(no generation)
qupisoorpoq	V	(no generation)
qupitaappoq	V	(no generation)
qupivaa	V	(no generation)
qupivoq	V	(no generation)
quppaa	V	(no generation)
quppaaruppoq	V	(no generation)
quppajo¦rak	N	–qqap, –qqat
quppajoranippoq	V	(no generation)
quppajo¦raq	N	–qqap, –qqat
quppakorpoq	V	(no generation)
quppaku	N	–p, –t
quppakuppoq	V	(no generation)
quppakuuvoq	V	(no generation)
quppal¦ik	N	{–iup, –lip, –lup}, –lit
quppa¦q	N	–p, –t
quppaqarpoq	V	(no generation)
quppaqqut	N	–ip, –it
quppaquserpaa	V	(no generation)
quppaqut	N	–ip, –it
quppaqutaavoq	V	(no generation)
quppaqutserpaa	V	(no generation)
quppart¦ooq	N	–uup, –uut
quppasserne¦q	N	–rup, –rit
quppasserpoq	V	(no generation)
qupperaasaannarpoq	V	(no generation)
qupperaavoq	V	(no generation)
qupperarpaa	V	(no generation)
qupperne¦q	N	–rup, –rit
quppernil¦ik	N	{–iup, –lip, –lup}, –lit
qupperpaa	V	(no generation)
qupperpoq	V	(no generation)
quppersagaa¦raq	N	–qqap, –qqat
quppersart¦oq	N	–up, –ut
quppiine¦q	N	–rup, –rit
quppiuppoq	V	(no generation)
quppoq	V	(no generation)
quppukkiartorpoq	V	(no generation)
quppuppaa	V	(no generation)
quppuppoq	V	(no generation)
quppussaavoq	V	(no generation)
quppussimavoq	V	(no generation)
qupput	N	–ip, –it
qupputaavoq	V	(no generation)
qupputissa¦q	N	–p, –t
qupputtoorpoq	V	(no generation)
qusasarpoq	V	(no generation)
qusavoq	V	(no generation)
quso¦raq	N	–qqap, –qqat
qusorartaarpoq	V	(no generation)
qussaannaa¦raq	N	–qqap, –qqat
qussaanna¦q	N	–ap, –at
qussaannarpoq	V	(no generation)
qussaasiorpoq	V	(no generation)
qussaasuuvoq	V	(no generation)
qussaat	N	–ip, –it
qussaataa¦raq	N	–qqap, –qqat
qussaat¦aq	N	{–ap, –tap}, {–at, –tat}
qussaatarsu¦aq	N	–up, –it
qussaavoq	V	(no generation)
qussa¦gaq	N	–kkap, –kkat
qussalaalline¦q	N	–rup, –rit
qussalaalliorpoq	V	(no generation)
qussalaappoq	V	(no generation)
qussalaatsorsu¦aq	N	–up, –it
qussalaat¦sorsuaq	N	{–sorsuup, –torsuup}, {–sorsuit, –torsuit}
qussalanaqaaq	V	(no generation)
qussalane¦q	N	–rup, –rit
qussalas¦oq	N	–up, –ut
qussalassu¦seq	N	–tsip, –tsit
qussalavoq	V	(no generation)
qussallaappaa	V	(no generation)
qussallaatigaa	V	(no generation)
qussallaffigaa	V	(no generation)
qussallappoq	V	(no generation)
qussallassinnaanngilaq	V	(no generation)
qussa¦q	N	–p, –t
qussarpaa	V	(no generation)
qussarpoq	V	(no generation)
qussartorpaa	V	(no generation)
qussiilluinnarpoq	V	(no generation)
qussiippoq	V	(no generation)
qussiivippoq	V	(no generation)
qussine¦q	N	–rup, –rit
quss¦ineq	N	{–ernup, –inerup}, {–ernit, –inerit}
qussinerasaarpoq	V	(no generation)
qussingaarpoq	V	(no generation)
qussinngaarpoq	V	(no generation)
qussippoq	V	(no generation)
qussiss¦oq	N	–up, –ut
qussi¦ssoq	N	{–ssup, –ttup}, {–ssut, –ttut}
qussissut	N	–ip, –it
qussissut	N, pl.	-
qussi¦ssut	N, pl.	{–ssut, –ttut}
qussivaa	V	(no generation)
qussivoq	V	(no generation)
quss¦oq	N	–up, –ut
qussorajavoq	V	(no generation)
qussorarpoq	V	(no generation)
qussorartippaa	V	(no generation)
qussu¦k	N	–up, –it
qussungaannarpoq	V	(no generation)
qussungaart¦oq	N	–up, –ut
qussungatsi¦ppoq	V	–nngilaq
qussungavoq	V	(no generation)
qussuppoq	V	(no generation)
qussutserpoq	V	(no generation)
qussuttaarpoq	V	(no generation)
qussuuserpaa	V	(no generation)
qussuut	N	–ip, –it
qusupaarpoq	V	(no generation)
qusupaavoq	V	(no generation)
qusupa¦k	N	–ap, –at
qusupalaarpoq	V	(no generation)
qutaarluinnaavoq	V	(no generation)
qutaarlu¦k	N	–up, –it
quterorpaa	V	(no generation)
quterorpoq	V	(no generation)
qutersaavoq	V	(no generation)
qutersa¦q	N	–p, –t
qutsannaqaaq	V	(no generation)
qutsannarpoq	V	(no generation)
qutsappaa	V	(no generation)
qutsaserpoq	V	(no generation)
qutsassivoq	V	(no generation)
qutsat	N	–ip, –it
qutsataavoq	V	(no generation)
qutsatigaa	V	(no generation)
qutsavigaa	V	(no generation)
qutsavigilluarpaa	V	(no generation)
qutsavigisaavoq	V	(no generation)
qutsavi¦k	N	–up, –it
qutsavissaraa	V	(no generation)
qutsinne¦q	N	–rup, –rit
qut¦sinneq	N	{–innerup, –sinnerup}, {–innerit, –sinnerit}
qutsinnerpaa¦q	N	–p, –t
qut¦sinnerpaaq	N	{–innerpaap, –sinnerpaap}, {–innerpaat, –sinnerpaat}
qutsinnersaat	N	–ip, –it
qut¦sinnersaat	N	{–innersaatip, –sinnersaatip}, {–innersaatit, –sinnersaatit}
qutsinnerus¦oq	N	–up, –ut
qut¦sinnerusoq	N	{–innerusup, –sinnerusup}, {–innerusut, –sinnerusut}
qutsinnerussaart¦oq	N	–up, –ut
qut¦sinnerussaartoq	N	{–innerussaartup, –sinnerussaartup}, {–innerussaartut, –sinnerussaartut}
qutsippaa	V	(no generation)
qutsippallaaqaaq	V	(no generation)
qutsippoq	V	(no generation)
qutsissivoq	V	(no generation)
qutsiss¦oq	N	–up, –ut
qutsi¦ssoq	N	{–ssup, –ttup}, {–ssut, –ttut}
qutsissormiuta¦q	N	–p, –t
qutsissormiut¦aq	N	{–ap, –tap}, {–at, –tat}
qutsi¦ssormiutaq	N	{–ssormiutap, –ttormiutap}, {–ssormiutat, –ttormiutat}
qutsissu¦seq	N	–tsip, –tsit
qut¦sissuseq	N	{–issutsip, –sissutsip}, {–issutsit, –sissutsit}
quts¦oq	N	–up, –ut
qutsunngu¦aq	N	–up, –it
qutsuuk	Interj	(no generation)
qutsuuvoq	V	(no generation)
quttaasa¦q	N	–p, –t
quttaaserpaa	V	(no generation)
quttappoq	V	(no generation)
quttarfigaa	V	(no generation)
quttarfi¦k	N	–up, –it
quttarpoq	V	(no generation)
quttassimavoq	V	(no generation)
qutt¦oq	N	–up, –ut
quttoraajarpoq	V	(no generation)
quttoraarpaa	V	(no generation)
quttoraarpoq	V	(no generation)
qutto¦raq	N	–qqap, –qqat
quttorarsivoq	V	(no generation)
qutuiarne¦q	N	–rup, –rit
qutu¦iarneq	N	{–ajarnerup, –iarnerup}, {–ajarnerit, –iarnerit}
qutuiarpoq	V	(no generation)
qutu¦k	N	–p, –t
quuaqisarpaa	V	(no generation)
quuaquserpaa	V	(no generation)
quuaqut	N	–ip, –it
quuaqutaarpaa	V	(no generation)
quuguppaa	V	(no generation)
quugussaavoq	V	(no generation)
quugussa¦q	N	–p, –t
quuguttart¦oq	N	–up, –ut
quui¦k	N	–p, –t
quui¦k	N	–up, –it
quuissorpoq	V	(no generation)
quuitt¦ooq	N	–uup, –uut
quukkaluttuinnarpoq	V	(no generation)
quukkiartorpoq	V	(no generation)
quulavaa	V	(no generation)
quulavoq	V	(no generation)
quuli¦ooq	N	–uup, –uut
quuli¦oq	N	–up, –ut
quuliu¦k	N	–up, –it
quulluarpaa	V	(no generation)
quulluarpoq	V	(no generation)
quumippaa	V	(no generation)
quumissarpaa	V	(no generation)
quummerpoq	V	(no generation)
quummersoorpoq	V	(no generation)
quummersorpoq	V	(no generation)
quummiartorpoq	V	(no generation)
quummingaannarpoq	V	(no generation)
quummingas¦oq	N	–up, –ut
quummingavoq	V	(no generation)
quummiuppaa	V	(no generation)
quummiussa¦q	N	–p, –t
quummiuttari¦aq	N	{–ssap, –ap}, {–ssat, –at}
quummiuttari¦aq	N	–ssap, –ssat
quungasoorpoq	V	(no generation)
quungatippaa	V	(no generation)
quungavallaarpoq	V	(no generation)
quungavoq	V	(no generation)
quunneqarpoq	V	(no generation)
quup¦ooq	N	–uup, –uut
quuppaa	V	(no generation)
quuppoq	V	(no generation)
quusa¦q	N	–p, –t
quusaqusarpaa	V	(no generation)
quusaqusarpoq	V	(no generation)
quusartorpoq	V	(no generation)
quusi¦ooq	N	–uup, –uut
quusoorpoq	V	(no generation)
quusoortippaa	V	(no generation)
quutippaa	V	(no generation)
quutsippaa	V	(no generation)
