Lexeme	WC	Flexion
ta	Interj	(no generation)
taa	Interj	(no generation)
taagorneqart¦oq	N	–up, –ut
taag¦orpaa	V	–unngilaa
taaguillaqqi¦ppoq	V	–nngilaq
taaguine¦q	N	–rup, –rit
taagui¦voq	V	–nngilaq
taaguu¦ppaa	V	–tinngilaa
taaguus¦erpaa	V	–inngilaa
taaguu¦serpaa	V	{–tilinngilaa, –sinngilaa}
taaguuser¦suuserissut	N	{–suuserissutip, –suutilerissutip, –tuuserissutip, –tuutilerissutip}, {–suuserissutit, –suutilerissutit, –tuuserissutit, –tuutilerissutit}
taaguu¦sersuuserissut	N	{–sersuuserissut, –sersuuserittut, –sersuuserissutip, –sersuutilerissutip, –sertuuserissutip, –sertuutilerissutip, –tilersuuserissutip, –tilersuutilerissutip, –tilertuuserissutip, –tilertuutilerissutip, –tilersuuserissut, –tilersuuserittut}, {–sersuuserissutit, –sersuutilerissutit, –sertuuserissutit, –sertuutilerissutit, –tilersuuserissutit, –tilersuutilerissutit, –tilertuuserissutit, –tilertuutilerissutit}
taaguuser¦suut	N	{–suutip, –tuutip}, {–suutit, –tuutit}
taaguu¦sersuut	N	{–sersuutip, –sertuutip, –tilersuutip, –tilertuutip}, {–sersuutit, –sertuutit, –tilersuutit, –tilertuutit}
taaguut	N	–ip, –it
taaguut¦aannaq	N	{–aannaap, –iinnaap}, {–aannaat, –iinnaat}
taaguutil¦ik	N	{–iup, –lip, –lup}, –lit
taaguutit	N, pl.	-
taajakku	Pron, pl.	–a
taajakku¦a	Pron, pl.	–a
taaja¦nna	Pron	–ssuma, {–kku, –kkua}
taaji¦nnga	Pron	–ssuma, {–kku, –kkua}
taaj¦orpaa	V	–unngilaa
taaka	Interj	(no generation)
taakanii¦ppoq	V	–nngilaq
taakaniittutua¦q	N	–p, –t
taakanngaanngu¦aq	N	–up, –it
taakanngaanngua¦rpoq	V	–nngilaq
taakanngu¦aq	N	–up, –it
taakattar¦aa	V	–inngilaa
taakkars¦orpaa	V	–unngilaa
taakkart¦orpaa	V	–unngilaa
taakku	Pron, pl.	–a
taakku¦a	Pron, pl.	–a
taakulavaa	V	(no generation)
taakungaanna¦rpoq	V	–nngilaq
taakungaannarsima¦voq	V	–nngilaq
taakunnaakkuma¦vaa	V	–nngilaa
taakunnaa¦ppaa	V	–tinngilaa
taakunnaassi¦voq	V	–nngilaq
taakunna¦rpoq	V	–nngilaq
taakunnarsinnaanngilaq	V	(no generation)
taakunnartaannarpoq	V	(no generation)
taaliaa¦q	N	–p, –t
taaliaa¦rpaa	V	–nngilaa
taalia¦q	N	–p, –t
taallaasa¦q	N	–p, –t
taallaasia¦q	N	–p, –t
taallaliaanngits¦oq	N	–up, –ut
taallal¦ik	N	{–iup, –lip, –lup}, –lit
taalla¦q	N	–p, –t
taallars¦orpoq	V	–unngilaq
taallar¦sorpoq	V	{–sunngilaq, –tunngilaq}
taallat	N, pl.	-
taall¦erpaa	V	–inngilaa
taall¦erpoq	V	–inngilaq
taallersima¦vaa	V	–nngilaa
taalliaa¦voq	V	–nngilaq
taalliallaanna¦rpoq	V	–nngilaq
taallialla¦ppoq	V	–nngilaq
taallia¦q	N	–p, –t
taalliar¦aa	V	–inngilaa
taalliarpalaart¦oq	N	–up, –ut
taalliarpalu¦ppoq	V	–nngilaq
taalliarpalutt¦oq	N	–up, –ut
taalliarpaluttuinnaa¦voq	V	–nngilaq
taalliavi¦k	N	–up, –it
taalligu¦ppoq	V	–nngilaq
taallii¦voq	V	–nngilaq
taalliorne¦q	N	–rup, –rit
taalli¦orpoq	V	–unngilaq
taalliortaannarpoq	V	(no generation)
taalliort¦oq	N	–up, –ut
taalliortorsu¦aq	N	–up, –it
taalliortuu¦voq	V	–nngilaq
taalli¦ppaa	V	–nngilaa
taalliukkiart¦orpoq	V	–unngilaq
taalliu¦ppoq	V	–tinngilaq
taalliuukkuma¦vaa	V	–nngilaa
taalliuu¦ppaa	V	–tinngilaa
taalliuussi¦voq	V	–nngilaq
taalliuutig¦aa	V	–inngilaa
taalliuutigisa¦rpaa	V	–nngilaa
taalluaqqissaarpaa	V	(no generation)
taalluartaat	N	–ip, –it
taallugu¦ppoq	V	–tinngilaq
taallunne¦q	N	–rup, –rit
taallu¦ppoq	V	–nngilaq
taallutsi¦ppoq	V	–nngilaq
taalutaa¦rpoq	V	–nngilaq
taalutaaru¦ppoq	V	–tinngilaq
taalutaa¦voq	V	–nngilaq
taalut¦aq	N	{–ap, –tap}, {–at, –tat}
taalutar¦aa	V	–inngilaa
taalutars¦orpoq	V	–unngilaq
taaluts¦erpaa	V	–inngilaa
taaluts¦erpoq	V	–inngilaq
taalutsersima¦voq	V	–nngilaq
taalutsisaa¦rpoq	V	–nngilaq
taalutsiu¦ppaa	V	–tinngilaa
taama	Interj	(no generation)
taamaaginna¦rpoq	V	–nngilaq
taamaaginnarsinnaanngilaq	V	(no generation)
taamaaginnart¦oq	N	–up, –ut
taamaajanngilaq	V	(no generation)
taamaakkaluart¦oq	N	–up, –ut
taamaakkuna¦rpoq	V	–nngilaq
taamaakkusu¦ppoq	V	–nngilaq
taamaalaa¦rpoq	V	–nngilaq
taamaalioqqunngilaa	V	(no generation)
taamaali¦orpoq	V	–unngilaq
taamaalisaanna¦rpoq	V	–nngilaq
taamaalisaraaq	V	(no generation)
taamaalisa¦rpoq	V	–nngilaq
taamaalisinnaaler¦sippaa	V	{–sinngilaa, –tinngilaa}
taamaalisinnaa¦voq	V	–nngilaq
taamaalisukkut	N, pl.	-
taamaalisuusaarti¦ppaa	V	–nngilaa
taamaalisuusaartitsi¦voq	V	–nngilaq
taamaali¦voq	V	–nngilaq
taamaanneqarne¦q	N	–rup, –rit
taamaanngivippoq	V	(no generation)
taamaa¦ppoq	V	–nngilaq
taamaaqat	N	–ip, –it
taamaaqatig¦aa	V	–inngilaa
taamaaqatiginni¦ppoq	V	–nngilaq
taamaaqqajaas¦oq	N	–up, –ut
taamaaqqajanngilaq	V	(no generation)
taamaaqqunaqaaq	V	(no generation)
taamaarusaa¦rpoq	V	–nngilaq
taamaarusaartuarpoq	V	(no generation)
taamaasi¦orpoq	V	–unngilaq
taamaasi¦vaa	V	–nngilaa
taamaasi¦voq	V	–nngilaq
taamaassagunarpoq	V	(no generation)
taamaassangatitsine¦q	N	–rup, –rit
taamaassorinninne¦q	N	–rup, –rit
taamaassorinni¦ppoq	V	–nngilaq
taamaateqqu¦aa	V	–nngilaa
taamaat¦eqquaa	V	{–eqqunngilaa, –seqqunngilaa}
taamaatiinnarne¦q	N	–rup, –rit
taamaat¦iinnarneq	N	{–iinnarnerup, –siinnarnerup}, {–iinnarnerit, –siinnarnerit}
taamaatiinna¦rpaa	V	–nngilaa
taamaat¦iinnarpaa	V	{–iinnanngilaa, –siinnanngilaa}
taamaatiinna¦rpoq	V	–nngilaq
taamaat¦iinnarpoq	V	{–iinnanngilaq, –siinnanngilaq}
taamaati¦ppaa	V	–nngilaa
taamaat¦ippaa	V	{–inngilaa, –sinngilaa}
taamaatippoq	V	(no generation)
taamaatitsine¦q	N	–rup, –rit
taamaat¦itsineq	N	{–itsinerup, –sitsinerup}, {–itsinerit, –sitsinerit}
taamaatitsi¦voq	V	–nngilaq
taamaat¦itsivoq	V	{–itsinngilaq, –sitsinngilaq}
taamaatitt¦oq	N	–up, –ut
taamaat¦ittoq	N	{–ittup, –sittup}, {–ittut, –sittut}
taamaatt¦oq	N	–up, –ut
taamaattoqanngilaq	V	(no generation)
taamaattuaanna¦rpoq	V	–nngilaq
taamaattuart¦oq	N	–up, –ut
taamaattussaanngits¦oq	N	–up, –ut
taamaattuusaartitsine¦q	N	–rup, –rit
taamaattuusorinniinnarne¦q	N	–rup, –rit
taamak	Interj	(no generation)
taamanerujussu¦aq	N	–up, –it
taamisaarine¦q	N	–rup, –rit
taamungaannaq	Interj	(no generation)
taane¦q	N	–rup, –rit
taaneqanngits¦oq	N	–up, –ut
taaneqa¦rpoq	V	–nngilaq
taaneqarsinnaa¦voq	V	–nngilaq
taaneqartaanna¦rpoq	V	–nngilaq
taaneqarta¦rpoq	V	–nngilaq
taaneqartart¦oq	N	–up, –ut
taanerlu¦ppaa	V	–nngilaa
taanert¦ooq	N	–uup, –uut
taanertuna¦rpoq	V	–nngilaq
taanertu¦voq	V	–nngilaq
taanikeqaaq	V	(no generation)
taanikilli¦voq	V	–nngilaq
taaniki¦ppoq	V	–nngilaq
taanikivi¦ppoq	V	–nngilaq
taa¦nna	Pron	–ssuma, {–kku, –kkua}
taannaasorsiut	N	–ip, –it
taa¦nnaasorsiut	N	{–kkuusorsiutip, –nnaasorsiutip}, {–kkuusorsiutit, –nnaasorsiutit}
taannaassu¦seq	N	–tsip, –tsit
taa¦nnaassuseq	N	{–kkuussutsip, –nnaassutsip}, {–kkuussutsit, –nnaassutsit}
taannaa¦voq	V	–nngilaq
taannaqa	Interj	(no generation)
taannaqa¦rpoq	V	–nngilaq
taannar¦aa	V	–inngilaa
taannarinni¦ppoq	V	–nngilaq
taannarisaa¦voq	V	–nngilaq
taannarisa¦q	N	–p, –t
taannarluinna¦q	N	–ap, –at
taannarusakasi¦k	N	–up, –it
taannarusarsu¦aq	N	–up, –it
taann¦erpaa	V	–inngilaa
taanngilaq	V	(no generation)
taapali¦ppoq	V	–nngilaq
taa¦ppaa	V	–nngilaa
taa¦ppoq	V	{–tinngilaq, –nngilaq}
ta¦aq	N	{–ap, –rrup}, –at
taaqaaq	V	(no generation)
taaqqaa¦gaq	N	–kkap, –kkat
taaqq¦orpoq	V	–unngilaq
taaqqorsimaannal¦erpoq	V	–inngilaq
taaqqungasa¦rpoq	V	–nngilaq
taaqqungavallaa¦rpoq	V	–nngilaq
taaqqunga¦voq	V	–nngilaq
taaqquuma¦voq	V	–nngilaq
taaqutaa¦voq	V	–nngilaq
taarmiuu¦voq	V	–nngilaq
taarmiu¦voq	V	–nngilaq
taarm¦oorpaa	V	–uunngilaa
taarne¦q	N	–rup, –rit
taarnersaa¦voq	V	–nngilaq
taarnersa¦q	N	–p, –t
taarnersu¦aq	N	–up, –it
taarnert¦ooq	N	–uup, –uut
taarnertuallaanngilaq	V	(no generation)
taarnertusi¦voq	V	–nngilaq
taarnertu¦voq	V	–nngilaq
taa¦rpoq	V	–nngilaq
taarraja¦rpaa	V	–nngilaa
taarseeqqusissuteqarne¦q	N	–rup, –rit
taarserneqa¦rpoq	V	–nngilaq
taars¦erpaa	V	–inngilaa
taarserpoq	V	(no generation)
taarsersinnaa¦vaa	V	–nngilaa
taarsers¦orpaa	V	–unngilaa
taarsersuiunnaa¦rpoq	V	–nngilaq
taarsersuut	N	–ip, –it
taarsersuutit	N, pl.	-
taarserutt¦orpoq	V	–unngilaq
taarsiaallusi¦voq	V	–nngilaq
taarsiaalluvoq	V	(no generation)
taarsiaa¦rpoq	V	–nngilaq
taarsiarsaa¦rpoq	V	–nngilaq
taarsiassaa¦rpoq	V	–nngilaq
taarsigaane¦q	N	–rup, –rit
taarsigaa¦voq	V	–nngilaq
taarsigaluttuinnalerpoq	V	(no generation)
taarsi¦gaq	N	–kkap, –kkat
taarsigassa¦q	N	–p, –t
taarsigassarsia¦q	N	–p, –t
taarsigassarsiat	N, pl.	-
taarsigassarsine¦q	N	–rup, –rit
taarsigassarsiniarne¦q	N	–rup, –rit
taarsigassarsinia¦rpoq	V	–nngilaq
taarsigassarsiniartarfi¦k	N	–up, –it
taarsigassarsisitsine¦q	N	–rup, –rit
taarsigassarsisitsisarfi¦k	N	–up, –it
taarsigassarsisitsisarne¦q	N	–rup, –rit
taarsigassarsis¦oq	N	–up, –ut
taarsigassarsi¦voq	V	–nngilaq
taarsiiffigeqqune¦q	N	–rup, –rit
taarsiiffigineqaqqune¦q	N	–rup, –rit
taarsiiffigineqartussaas¦oq	N	–up, –ut
taarsiiffiginninne¦q	N	–rup, –rit
taarsiillua¦rpoq	V	–nngilaq
taarsiine¦q	N	–rup, –rit
taarsiisaanna¦rpoq	V	–nngilaq
taarsiisinnaa¦voq	V	–nngilaq
taarsiissut	N	–ip, –it
taarsiissuteqarne¦q	N	–rup, –rit
taarsii¦vigeqquneq	N	{–ffigeqqunerup, –vigeqqunerup}, {–ffigeqqunerit, –vigeqqunerit}
taarsii¦voq	V	–nngilaq
taarsilerne¦q	N	–rup, –rit
taarsilluinnart¦oq	N	–up, –ut
taarsimaart¦oq	N	–up, –ut
taarsi¦orpoq	V	–unngilaq
taarsissu¦ppaa	V	–tinngilaa
taarsitsii¦voq	V	–nngilaq
taarsiukkuma¦vaa	V	–nngilaa
taarsiu¦ppaa	V	–tinngilaa
taarsiu¦serpaa	V	{–sinngilaa, –tilinngilaa}
taarsiu¦serpaa	V	–tilinngilaa
taarsiussa¦q	N	–p, –t
taarsiussi¦voq	V	–nngilaq
taarsiut	N	–ip, –it
taarsivi¦ppoq	V	–nngilaq
taarsi¦voq	V	–nngilaq
taarsu¦aq	N	–up, –it
taartaas¦oq	N	–up, –ut
taart¦aasoq	N	{–aasup, –iusup}, {–aasut, –iusut}
taartaatita¦q	N	–p, –t
taart¦aatitaq	N	{–aatitap, –iutitap}, {–aatitat, –iutitat}
taartaa¦voq	V	–nngilaq
taart¦aavoq	V	{–aanngilaq, –iunngilaq}
taarta¦q	N	–p, –t
taarteqarlua¦rpoq	V	–nngilaq
taarteqa¦rpoq	V	–nngilaq
taarti	N	–p, –t
taartig¦aa	V	–inngilaa
taartigeeqatigiinne¦q	N	–rup, –rit
taartigiinne¦q	N	–rup, –rit
taartikkaluttuinnarpoq	V	(no generation)
taartinne¦q	N	–rup, –rit
taartippoq	V	(no generation)
taartisiaa¦voq	V	–nngilaq
taartisia¦q	N	–p, –t
taartisiar¦aa	V	–inngilaa
taartissaaru¦ppoq	V	–tinngilaq
taartissa¦q	N	–p, –t
taartittaanna¦rpoq	V	–nngilaq
taartoornaqaaq	V	(no generation)
taartoornarsivoq	V	(no generation)
taart¦oorpoq	V	–uunngilaq
taart¦oq	N	–up, –ut
taartormiu	N	–p, –t
taartorsu¦aq	N	–up, –it
taartuarsaa¦rpoq	V	–nngilaq
taartuarsaartalerpoq	V	(no generation)
taartueruffissa¦q	N	–p, –t
taartuerukkumaarpoq	V	(no generation)
taartueru¦ppoq	V	–tinngilaq
taartuinnaa¦voq	V	–nngilaq
taar¦tuinnaavoq	V	{–tuinnaanngilaq, –suinnaanngilaq}
taartumiikkumanngilaq	V	(no generation)
taartumii¦ppoq	V	–nngilaq
taarutaa¦rpaa	V	–nngilaa
taarutaa¦rpoq	V	–nngilaq
taaruts¦erpaa	V	–inngilaa
taarut¦serpaa	V	{–italinngilaa, –sinngilaa}
taarutsers¦orpaa	V	–unngilaa
taarutsiu¦ppoq	V	–tinngilaq
taasaa¦voq	V	–nngilaq
taasakulug¦aa	V	–inngilaa
taasakulu¦k	N	–up, –it
taasakuluu¦voq	V	–nngilaq
taasa¦q	N	–p, –t
taasa¦rpaa	V	–nngilaa
taasiinnarniut	N	–ip, –it
taasine¦q	N	–rup, –rit
taasinerit	N, pl.	-
taasinerlu¦ppoq	V	–nngilaq
taasisinnaane¦q	N	–rup, –rit
taasisinnaas¦oq	N	–up, –ut
taasisitsine¦q	N	–rup, –rit
taasis¦oq	N	–up, –ut
taasi¦voq	V	–nngilaq
taassaanngilaq	V	(no generation)
taassaanngits¦oq	N	–up, –ut
taassaa¦voq	V	–nngilaq
taassi¦voq	V	–nngilaq
taassut	N	–ip, –it
taassutaa¦voq	V	–nngilaq
taassutig¦aa	V	–inngilaa
taata¦q	N	–p, –t
taataqanngilaq	V	(no generation)
taateraanikkiart¦orpoq	V	–unngilaq
taateraani¦ppoq	V	–nngilaq
taateraa¦q	N	–p, –t
taateraa¦raq	N	–qqap, –qqat
taateraarna¦q	N	–p, –t
taateraarnia¦rpoq	V	–nngilaq
taatseri¦voq	V	–nngilaq
taats¦erpoq	V	–inngilaq
taatsiaannagaas¦oq	N	–up, –ut
taatsiaanna¦gaq	N	–kkap, –kkat
taatsiaanna¦rpaa	V	–nngilaa
taatsiarpaa	V	(no generation)
taatsi¦ppaa	V	–nngilaa
taat¦sippaa	V	{–inngilaa, –sinngilaa}
taatsi¦voq	V	–nngilaq
taatt¦oq	N	–up, –ut
taattoqanngilaq	V	(no generation)
taattoqarlua¦rpoq	V	–nngilaq
taattori¦ppoq	V	–nngilaq
taattoriss¦oq	N	–up, –ut
taattori¦ssoq	N	{–ssup, –ttup}, {–ssut, –ttut}
taattorissu¦seq	N	–tsip, –tsit
taattorl¦erpoq	V	–inngilaq
taattorliu¦ppaa	V	–tinngilaa
taattorlu¦ppoq	V	–nngilaq
taattu	N	–p, –t
taattuerukkiart¦orpoq	V	–unngilaq
taattueru¦ppoq	V	–tinngilaq
taattuerutivi¦ppoq	V	–nngilaq
taattunikkiart¦orpoq	V	–unngilaq
taattuni¦ppoq	V	–nngilaq
taattunissinnaanngilaq	V	(no generation)
taatugooq	Interj	(no generation)
taatu¦ppaa	V	–nngilaa
taatuuku	Interj	(no generation)
taatuuna	Interj	(no generation)
taa¦vaa	V	–nngilaa
taavaanna¦q	N	–ap, –at
taavaniikkunnarsivoq	V	(no generation)
taavanii¦ppoq	V	–nngilaq
taavaniissima¦voq	V	–nngilaq
taa¦voq	V	–nngilaq
taffartu¦voq	V	–nngilaq
taggaats¦oq	N	–up, –ut
taggari¦k	N	–up, –it
taggari¦ppoq	V	–nngilaq
taggarissorsu¦uvoq	V	{–aanngilaq, –unngilaq}
taggari¦ssorsuuvoq	V	{–ssorsuaanngilaq, –ssorsuunngilaq, –ttorsuaanngilaq, –ttorsuunngilaq}
taggarissu¦aq	N	–up, –it
taggarivi¦k	N	–up, –it
taggarlu¦ppaa	V	–nngilaa
taggerlu¦igajuppoq	V	–tsigajunngilaq
taggerlu¦ivoq	V	{–inngilaq, –tsinngilaq}
taggerlu¦ppaa	V	–nngilaa
taggikkumanngilaa	V	(no generation)
taggi¦ppaa	V	–nngilaa
taggisaasa¦q	N	–p, –t
taggisaas¦oq	N	–up, –ut
taggisaa¦voq	V	–nngilaq
taggisinngorti¦ppaa	V	–nngilaa
taggissa¦q	N	–p, –t
taggissi¦voq	V	–nngilaq
taggi¦t	N	–sip, –sit
tagiaane¦q	N	–rup, –rit
tagialaa¦rpaa	V	–nngilaa
tagia¦rpaa	V	–nngilaa
tagiartaasi¦orpoq	V	–unngilaq
tagiartaa¦siorpoq	V	{–siunngilaq, –tiliunngilaq}
tagiartaat	N	–ip, –it
tagiart¦orpaa	V	–unngilaa
tagiartortinne¦q	N	–rup, –rit
tagiartuine¦q	N	–rup, –rit
tagiartuisart¦oq	N	–up, –ut
tagiartui¦voq	V	–nngilaq
tagiukkunnaa¦rpaa	V	–nngilaa
tagiukkunnaa¦rpoq	V	–nngilaq
tagiu¦ppaa	V	–tinngilaa
tagiu¦ppoq	V	–tinngilaq
tagiusi¦orpoq	V	–unngilaq
tagiu¦siorpoq	V	{–siunngilaq, –tiliunngilaq}
tagiussaa¦voq	V	–nngilaq
tagiussi¦voq	V	–nngilaq
tagiussu¦aq	N	–up, –it
tagiut	N	–ip, –it
tagiutaaru¦ppoq	V	–tinngilaq
tagiutaa¦voq	V	–nngilaq
tagusa¦rpaa	V	–nngilaa
taja¦q	N	–p, –t
tajaqut	N	–ip, –it
tajarna¦q	N	–p, –t
tajarne¦q	N	–rup, –rit
tajarnert¦orpoq	V	–unngilaq
tajartaa¦rpoq	V	–nngilaq
tajarusi¦orpoq	V	–unngilaq
tajaru¦siorpoq	V	{–siunngilaq, –tiliunngilaq}
tajarut	N	–ip, –it
tajarut	N, pl.	-
tajarutaaru¦ppoq	V	–tinngilaq
tajarutit	N, pl.	-
takakku	Pron, pl.	–a
takananiinngilaq	V	(no generation)
takananii¦ppoq	V	–nngilaq
takananiissima¦voq	V	–nngilaq
takananngaanngu¦aq	N	–up, –it
takanannga¦rpoq	V	–nngilaq
taka¦nna	Pron	–ssuma, {–kku, –kkua}
takannakanne¦q	N	–rup, –rit
takig¦aa	V	–inngilaa
takilaa¦rpoq	V	–nngilaq
takinersaa¦voq	V	–nngilaq
takineru¦voq	V	–nngilaq
ta¦kineruvoq	V	{–kinerunngilaq, –nnerunngilaq}
takis¦ooq	N	–uup, –uut
takisoorsu¦aq	N	–up, –it
takis¦oq	N	–up, –ut
takissu¦seq	N	–tsip, –tsit
takisut	N, pl.	-
takisuukuj¦ooq	N	–uup, –uut
takisuulia¦q	N	–p, –t
takisuuliat	N, pl.	-
takitig¦aaq	V	–inngilaq
takivallaanngilaq	V	(no generation)
takivallaaqaaq	V	(no generation)
takivallaa¦rpoq	V	–nngilaq
takivallaarsor¦aa	V	–inngilaa
takivallaarunnaarpoq	V	(no generation)
takivi¦ppoq	V	–nngilaq
taki¦voq	V	–nngilaq
takkajaa¦q	N	–p, –t
takkajaaqaaq	V	(no generation)
takkajaa¦rpoq	V	–nngilaq
takkajaarsu¦aq	N	–up, –it
takkiga	Interj	(no generation)
takkiganii¦ppoq	V	–nngilaq
takkiganiitt¦oq	N	–up, –ut
takkigannga¦rpoq	V	–nngilaq
takkikku	Pron, pl.	–a
takki¦nnga	Pron	–ssuma, {–kku, –kkua}
takkorl¦erpaa	V	–inngilaa
takkorli¦orpaa	V	–unngilaa
takkorliui¦voq	V	–nngilaq
takkorliunne¦q	N	–rup, –rit
takkorliunnerusalerne¦q	N	–rup, –rit
takkorliu¦ppaa	V	–tinngilaa
takkorlui¦voq	V	–nngilaq
takkorlu¦ppaa	V	–nngilaa
takkorlussima¦vaa	V	–nngilaa
takkorlussivoq	V	(no generation)
takkorsarti¦ppaa	V	–nngilaa
takkortuallaaqaaq	V	(no generation)
takkortu¦voq	V	–nngilaq
takku	N	–p, –t
takkuffig¦aa	V	–inngilaa
takkuffi¦k	N	–up, –it
takkuig¦aa	V	–inngilaa
takkui¦k	N	–up, –it
takkuits¦oorpoq	V	–uunngilaq
takkuiunngilaq	V	(no generation)
takkukkasuarpoq	V	(no generation)
takkunne¦q	N	–rup, –rit
takku¦ppoq	V	–tinngilaq
takkussari¦ppoq	V	–nngilaq
takkut	N	–ip, –it
takkut	N, pl.	-
takkutaa¦voq	V	–nngilaq
takkuteqqi¦ppoq	V	–nngilaq
takkutig¦aa	V	–inngilaa
takkut¦ikulassuseq	N	{–ikulassutsip, –sikulassutsip}, {–ikulassutsit, –sikulassutsit}
takkutilert¦orpoq	V	–unngilaq
takkutilussinnarpoq	V	(no generation)
takkutinngikkallassaaq	V	(no generation)
takkutinngilluinnarpoq	V	(no generation)
takkut¦inngitsoorneq	N	{–inngitsoornerup, –sinngitsoornerup}, {–inngitsoornerit, –sinngitsoornerit}
takku¦tipallappoq	V	{–ppallanngilaq, –terpallanngilaq, –tipallanngilaq, –tippallanngilaq, –tsipallanngilaq, –tsippallanngilaq}
takkut¦issaarpoq	V	{–issaanngilaq, –sissaanngilaq}
takkutissajunnarsivoq	V	(no generation)
takkutissamaarpoq	V	(no generation)
takkutiuilluinna¦rpoq	V	–nngilaq
takkutiuippallaaqaaq	V	(no generation)
takkutiui¦ppoq	V	–nngilaq
takkuttar¦aaq	V	–inngilaq
takkutt¦oq	N	–up, –ut
takkuttuaanna¦rpoq	V	–nngilaq
takoqqikkusukkaluaqaa	V	(no generation)
takoqqi¦ppaa	V	–nngilaa
takoqqusaa¦rpaa	V	–nngilaa
takoqqusaa¦rpoq	V	–nngilaq
takoqqusaartuarpoq	V	(no generation)
takoqqusaarut	N	–ip, –it
takoqqusaarutig¦aa	V	–inngilaa
takoqquvoq	V	(no generation)
takoquts¦erpoq	V	–inngilaq
takorannaa¦rpaa	V	–nngilaa
takorannaa¦rpoq	V	–nngilaq
takorannaartuanngua¦rpoq	V	–nngilaq
takoranneqaaq	V	(no generation)
takorann¦erpoq	V	–inngilaq
takorannersorsuu¦voq	V	–nngilaq
takorannersorsu¦uvoq	V	{–aanngilaq, –unngilaq}
takoranner¦sorsuuvoq	V	{–sorsuaanngilaq, –sorsuunngilaq, –torsuaanngilaq, –torsuunngilaq}
takorannivi¦ppoq	V	–nngilaq
takorliu¦ppaa	V	–tinngilaa
takorloorne¦q	N	–rup, –rit
takorloorneqarsinnaas¦oq	N	–up, –ut
takorl¦oorpaa	V	–uunngilaa
takorl¦oorpoq	V	–uunngilaq
takorloorsinnaa¦vaa	V	–nngilaa
takorloortuarpaa	V	(no generation)
takorluu¦gaq	N	–kkap, –kkat
takorluugaqarne¦q	N	–rup, –rit
takorluugaqa¦rpoq	V	–nngilaq
takorluuine¦q	N	–rup, –rit
takorluuisinnaane¦q	N	–rup, –rit
takorluuisinnaas¦oq	N	–up, –ut
takorluui¦voq	V	–nngilaq
takorluukkersaa¦rpoq	V	–nngilaq
takorluukkersaarut	N	–ip, –it
takornarialerine¦q	N	–rup, –rit
takornaria¦q	N	–p, –t
takornariaqarne¦q	N	–rup, –rit
takornariaqartitsine¦q	N	–rup, –rit
takornariaqartitsisarfi¦k	N	–up, –it
takornariarne¦q	N	–rup, –rit
takornaria¦rpoq	V	–nngilaq
takornariartaassu¦aq	N	–up, –it
takornariartaat	N	–ip, –it
takornariartaat	N, pl.	-
takornariartitsine¦q	N	–rup, –rit
takornariartitsi¦veqarfik	N	{–ffeqarfiup, –veqarfiup}, {–ffeqarfiit, –veqarfiit}
takornariartitsi¦vik	N	{–ffiup, –viup}, {–ffiit, –viit}
takornariart¦orpoq	V	–unngilaq
takornariar¦torpoq	V	{–sunngilaq, –tunngilaq}
takornaril¦erpaa	V	–inngilaa
takornarnia¦q	N	–p, –t
takornarnia¦rpaa	V	–nngilaa
takornarnia¦rpoq	V	–nngilaq
takornarniarti¦ppaa	V	–nngilaa
takorna¦rpaa	V	–nngilaa
takorna¦rpoq	V	–nngilaq
takornartaanngilaq	V	(no generation)
takornartaanngits¦oq	N	–up, –ut
takornartaa¦voq	V	–nngilaq
takornarta¦q	N	–p, –t
takornartarisa¦q	N	–p, –t
takornar¦tarisaq	N	{–arisap, –tarisap}, {–arisat, –tarisat}
takorngarnia¦q	N	–p, –t
takorngarnia¦rpaa	V	–nngilaa
takorngarnia¦rpoq	V	–nngilaq
takornga¦rpaa	V	–nngilaa
takornga¦rpoq	V	–nngilaq
takorngartaanngilaq	V	(no generation)
takorngartaa¦voq	V	–nngilaq
takorngarta¦q	N	–p, –t
takorngi¦orpaa	V	–unngilaa
takorngi¦orpoq	V	–unngilaq
takorni¦orpaa	V	–unngilaa
takorni¦orpoq	V	–unngilaq
takorniui¦voq	V	–nngilaq
takor¦oorpaa	V	–uunngilaa
takor¦oorpoq	V	–uunngilaq
takoroorsaari¦voq	V	–nngilaq
takoroorsaa¦rpaa	V	–nngilaa
takoroorsaarut	N	–ip, –it
takorr¦oorpoq	V	–uunngilaq
takorruu¦gaq	N	–kkap, –kkat
takorruuine¦q	N	–rup, –rit
takorusui¦voq	V	–nngilaq
takorusulluinnarpaa	V	(no generation)
takorusunnaqaaq	V	(no generation)
takorusu¦ppaa	V	–nngilaa
takorutt¦orpaa	V	–unngilaa
taku¦aa	V	–nngilaa
takugallanngilaa	V	(no generation)
takuinngisaannarpaa	V	(no generation)
takujarsu¦ppaa	V	–nngilaa
takujuananngilaq	V	(no generation)
takujuana¦rpoq	V	–nngilaq
takujui¦ppaa	V	–nngilaa
takujuisa¦q	N	–p, –t
takujumajunnaavippaa	V	(no generation)
takujuminaa¦ppoq	V	–nngilaq
takujuminaatsikkaluaqaa	V	(no generation)
takujumina¦rpoq	V	–nngilaq
takujuminarsa¦rpoq	V	–nngilaq
takujuminarsinnaa¦voq	V	–nngilaq
takujuminart¦oq	N	–up, –ut
takukata¦ppaa	V	–nngilaa
takukulaa¦rpaa	V	–nngilaa
takulertornart¦oq	N	–up, –ut
takull¦erpaa	V	–inngilaa
takullii¦voq	V	–nngilaq
takulluaatig¦aa	V	–inngilaa
takulluarnarpoq	V	(no generation)
takullua¦rpaa	V	–nngilaa
takulu¦ppaa	V	–nngilaa
takumasaqa¦rpoq	V	–nngilaq
takuma¦voq	V	–nngilaq
takumig¦aa	V	–inngilaa
takumina¦rpoq	V	–nngilaq
takuminart¦oq	N	–up, –ut
takummaa¦vaa	V	–nngilaa
takummaa¦voq	V	–nngilaq
takuna¦rpoq	V	–nngilaq
takunaveerpaa	V	(no generation)
takuneqarsinnaanerul¦erpoq	V	–inngilaq
takuneqarsinnaa¦voq	V	–nngilaq
takuniaa¦voq	V	–nngilaq
takunia¦rpaa	V	–nngilaa
takuniinna¦rpoq	V	–nngilaq
takunnat	N	–ip, –it
takunngisaanna¦gaq	N	–kkap, –kkat
takunngisaanna¦rpaa	V	–nngilaa
takunngisa¦q	N	–p, –t
takunngisaqanngilaq	V	(no generation)
takunngitsoorpaa	V	(no generation)
takunngitsuu¦gaq	N	–kkap, –kkat
takunnguatsiaraluarpaa	V	(no generation)
takunnguatsiarpaa	V	(no generation)
takunnguna¦rpoq	V	–nngilaq
takunnguunnaqaaq	V	(no generation)
takunnguu¦ppaa	V	–tinngilaa
takunnguussa¦q	N	–p, –t
takunnguussi¦voq	V	–nngilaq
takunnguutig¦aa	V	–inngilaa
takunngu¦voq	V	–nngilaq
takunninniarne¦q	N	–rup, –rit
takunninnia¦rpoq	V	–nngilaq
takunni¦ppoq	V	–nngilaq
takunnissimasinnaas¦oq	N	–up, –ut
takunnissinnaalinngisaanna¦rpoq	V	–nngilaq
takunnissinnaatitaane¦q	N	–rup, –rit
takunnitt¦oq	N	–up, –ut
takusaagaju¦ppoq	V	–nngilaq
takusaanna¦rpaa	V	–nngilaa
takusaanngisaanna¦rpoq	V	–nngilaq
takusaasa¦rpoq	V	–nngilaq
takusaasuu¦voq	V	–nngilaq
takusaa¦voq	V	–nngilaq
takusajui¦ppaa	V	–nngilaa
takusaleqqaarpaa	V	(no generation)
takusamaa¦rpaa	V	–nngilaa
takusamaartaannarpaa	V	(no generation)
takusa¦q	N	–p, –t
takusaqarsorine¦q	N	–rup, –rit
takusaqartuusaa¦rpoq	V	–nngilaq
takusa¦rpaa	V	–nngilaa
takusartaa¦voq	V	–nngilaq
takusarta¦gaq	N	–kkap, –kkat
takusarti¦ppaa	V	–nngilaa
takusassaaru¦ppoq	V	–tinngilaq
takusassaa¦voq	V	–nngilaq
takusassarsi¦orpoq	V	–unngilaq
takusassarsiort¦oq	N	–up, –ut
takusinnaal¦erpaa	V	–inngilaa
takusinnaane¦q	N	–rup, –rit
takus¦oorpaa	V	–uunngilaa
takusorinninne¦q	N	–rup, –rit
takusorisa¦q	N	–p, –t
takusorisaqarne¦q	N	–rup, –rit
takussaajunnaa¦rpoq	V	–nngilaq
takussaal¦erpoq	V	–inngilaq
takussaallua¦rpoq	V	–nngilaq
takussaanngilaq	V	(no generation)
takussaanngits¦oq	N	–up, –ut
takussaa¦rpaa	V	–nngilaa
takussaas¦oq	N	–up, –ut
takussaa¦voq	V	–nngilaq
takussug¦aa	V	–inngilaa
takussuginni¦ppoq	V	–nngilaq
takussugisa¦q	N	–p, –t
takussugitsaa¦ppaa	V	–tinngilaa
takussuna¦rpoq	V	–nngilaq
takussunart¦oq	N	–up, –ut
takussusaa¦rpoq	V	–nngilaq
takussut	N	–ip, –it
takussutaa¦voq	V	–nngilaq
takussutissa¦q	N	–p, –t
takussutissia¦q	N	–p, –t
takussutissiar¦aa	V	–inngilaa
takussutissi¦ppaa	V	–nngilaa
takusu¦ppaa	V	–nngilaa
takuti¦ppaa	V	–nngilaa
takuti¦ppoq	V	–nngilaq
takutitsine¦q	N	–rup, –rit
takutitsi¦voq	V	–nngilaq
takutsu¦ppaa	V	–nngilaa
taku¦voq	V	–nngilaq
talakka¦ppoq	V	–nngilaq
talakkassutig¦aa	V	–inngilaa
talanti	N	–p, –t
talart¦eq	N	–ip, –it
talarti	N	–p, –t
tal¦eerpaa	V	–iinngilaa
taleeru¦ppoq	V	–tinngilaq
taleerussima¦voq	V	–nngilaq
taleerutivinngilaq	V	(no generation)
tal¦eq	N	–lip, –lit
taleqqasarfi¦k	N	–up, –it
taleqqavoq	V	(no generation)
tale¦roq	N	–qqup, –qqut
talerorsiut	N	–ip, –it
talerperl¦eq	N	–iup, –iit
talerpi¦k	N	–up, –it
talerpill¦eq	N	–iup, –iit
talerpiss¦orpoq	V	–unngilaq
talerpiu¦voq	V	–nngilaq
tal¦erpoq	V	–inngilaq
talers¦orpoq	V	–unngilaq
taler¦sorpoq	V	{–sunngilaq, –tunngilaq}
talertu¦voq	V	–nngilaq
taliffaa¦raq	N	–qqap, –qqat
taliffa¦k	N	–ap, –at
taliffig¦aa	V	–inngilaa
taliffigiumanngilaa	V	(no generation)
taliffi¦k	N	–up, –it
taliffissaaru¦ppoq	V	–tinngilaq
taliffissa¦q	N	–p, –t
taliffiu¦voq	V	–nngilaq
taliia¦rpoq	V	–nngilaq
taliinnart¦oq	N	–up, –ut
taliits¦oorpoq	V	–uunngilaq
taliitsoorti¦ppaa	V	–nngilaa
talikinaa¦rpaa	V	–nngilaa
taliki¦ppoq	V	–nngilaq
talikkiart¦orpoq	V	–unngilaq
talilu¦ppoq	V	–nngilaq
talinna¦ppoq	V	–nngilaq
tali¦ppaa	V	–nngilaa
tali¦ppoq	V	–nngilaq
talisi¦ppaa	V	–nngilaa
tali¦ttarfeqarfik	N	{–ssarfeqarfiup, –ttarfeqarfiup}, {–ssarfeqarfiit, –ttarfeqarfiit}
tali¦ttarfeqarneq	N	{–ssarfeqarnerup, –ttarfeqarnerup}, {–ssarfeqarnerit, –ttarfeqarnerit}
tali¦ttarfik	N	{–ssarfiup, –ttarfiup}, {–ssarfiit, –ttarfiit}
talleqqaju¦ppoq	V	–nngilaq
talleqqajutsi¦ppoq	V	–nngilaq
taller¦aaq	V	–inngilaq
tallerisaanna¦rpoq	V	–nngilaq
talleri¦voq	V	–nngilaq
tallialla¦ppoq	V	–nngilaq
talligu¦ppoq	V	–nngilaq
tallimaat	N	–ip, –it
tallimanngorne¦q	N	–rup, –rit
tallimanngornersu¦aq	N	–up, –it
tallimanngorneru¦voq	V	–nngilaq
tallimanngornikkut	N, pl.	-
tallimanng¦orpoq	V	–unngilaq
tallimanngort¦oq	N	–up, –ut
tallimaraa¦rpoq	V	–nngilaq
tallimaraarsima¦voq	V	–nngilaq
tallimaraarsinnaa¦voq	V	–nngilaq
tallimararterut	N	–ip, –it
tallimarsorfig¦aa	V	–inngilaa
tallimar¦sorfigaa	V	{–sorfiginngilaa, –torfiginngilaa}
tallimars¦orpoq	V	–unngilaq
tallimar¦sorpoq	V	{–sunngilaq, –tunngilaq}
tallimat	N, pl.	-
tallimat	Num, pl.	-
tallimmii¦voq	V	–nngilaq
tallimmiu¦ppaa	V	–tinngilaa
tallimmiussi¦voq	V	–nngilaq
talli¦ppaa	V	–nngilaa
talli¦ppoq	V	–nngilaq
tallisaas¦erpaa	V	–inngilaa
tallisaa¦serpaa	V	{–sinngilaa, –tilinngilaa}
tallisaat	N	–ip, –it
tallisart¦oq	N	–up, –ut
tallisi¦ppaa	V	–nngilaa
talli¦sippaa	V	{–sinngilaa, –tinngilaa}
tallis¦oorpoq	V	–uunngilaq
tallis¦simasoq	N	{–imasup, –simasup}, {–imasut, –simasut}
tallissima¦voq	V	–nngilaq
talli¦vaa	V	–nngilaa
tallivallaa¦rpoq	V	–nngilaq
talli¦voq	V	–nngilaq
tall¦oq	N	–up, –ut
tallort¦ooq	N	–uup, –uut
Tallorut	N	–ip, –it
tallorut	N	–ip, –it
talluki¦ppoq	V	–nngilaq
tallukivi¦ppoq	V	–nngilaq
taloorneqa¦rpoq	V	–nngilaq
tal¦oorpaa	V	–uunngilaa
taloorsima¦vaa	V	–nngilaa
taloqa¦rpoq	V	–nngilaq
talor¦aa	V	–inngilaa
talornar¦aa	V	–inngilaa
talorna¦rpoq	V	–nngilaq
talorsitsaa¦rpoq	V	–nngilaq
Talorsu¦aq	N	–up, –it
talorsu¦aq	N	–up, –it
taloruffig¦aa	V	–inngilaa
talorunnaqaaq	V	(no generation)
talorunna¦rpoq	V	–nngilaq
taloru¦ppaa	V	–tinngilaa
taloru¦ppoq	V	–tinngilaq
talorussa¦q	N	–p, –t
talorutt¦oq	N	–up, –ut
taloruumm¦erpoq	V	–inngilaq
talu	N	–p, –t
talueru¦ppaa	V	–tinngilaa
talueru¦ppoq	V	–tinngilaq
taluerussima¦voq	V	–nngilaq
talul¦erpaa	V	–inngilaa
talulers¦orpaa	V	–unngilaa
talulersugaa¦voq	V	–nngilaq
taluli¦voq	V	–nngilaq
talusa¦q	N	–p, –t
taluti¦ppaa	V	–nngilaa
tamaanaqqu¦ppoq	V	–tinngilaq
tamaaneralanngu¦aq	N	–up, –it
tamaanissa¦aq	V	–nngilaq
tamaannaakkuma¦vaa	V	–nngilaa
tamaannaa¦ppaa	V	–tinngilaa
tamaanna¦rpoq	V	–nngilaq
tamagula¦voq	V	–nngilaq
tamakkeerpasi¦k	N	–up, –it
tamakkeersu¦aq	N	–up, –it
tamakk¦erpaa	V	–inngilaa
tamakk¦erpoq	V	–inngilaq
tamakkersuu¦ppaa	V	–tinngilaa
tamakkii	N	–p, –t
tamakkiis¦oq	N	–up, –ut
tamakkii¦voq	V	–nngilaq
tamakkiussine¦q	N	–rup, –rit
tamakku	Pron, pl.	–a
tamakku¦a	Pron, pl.	–a
tamakujuit	N, pl.	-
tamalaa¦q	N	–p, –t
tamalaa¦rpoq	V	–nngilaq
tamalaart¦oq	N	–up, –ut
tamalaat	N, pl.	-
tamaleqisa¦ppoq	V	–nngilaq
tamalikaa¦rpoq	V	–nngilaq
tamalika¦ppoq	V	–nngilaq
tamalikatt¦oq	N	–up, –ut
tamallartitsine¦q	N	–rup, –rit
tamallatsitsine¦q	N	–rup, –rit
tamallat¦sitsineq	N	{–itsinerup, –sitsinerup}, {–itsinerit, –sitsinerit}
tamaloqisaa¦rpoq	V	–nngilaq
tamanii¦ppoq	V	–nngilaq
tamaniissinnaanngilaq	V	(no generation)
tama¦nna	Pron	{–ssuma, –tuma}, {–kku, –kkua}
tamanoort¦oq	N	–up, –ut
tama¦ppoq	V	–nngilaq
tamaqanngilaq	V	(no generation)
tamaqanngits¦oq	N	–up, –ut
tamaqqa¦voq	V	–nngilaq
tamarlisissa¦q	N	–p, –t
tamarlit	N	–ip, –it
tamarli¦voq	V	–nngilaq
tamarluinnaat	N	–ip, –it
tamarmiunngits¦oq	N	–up, –ut
tamarmius¦oq	N	–up, –ut
tamarmiu¦voq	V	–nngilaq
tamarsuar¦aa	V	–inngilaa
tamarsuu¦voq	V	–nngilaq
tamasi¦ppoq	V	–nngilaq
tamassa	Interj	(no generation)
tamassaa¦voq	V	–nngilaq
tamataajaqqissaa¦rpoq	V	–nngilaq
tamataaja¦rpaa	V	–nngilaa
tamataajarpoq	V	(no generation)
tamataarullu¦innarpoq	V	{–innanngilaq, –aannanngilaq}
tamataaru¦ppoq	V	–tinngilaq
tamataarutivi¦ppoq	V	–nngilaq
tamata¦q	N	–p, –t
tamataqanngilaq	V	(no generation)
tamataqanngits¦oq	N	–up, –ut
tamatig¦oorpoq	V	–uunngilaq
tamatigoort¦oq	N	–up, –ut
tamatigoortuune¦q	N	–rup, –rit
tamatiguussu¦seq	N	–tsip, –tsit
tamatikkarne¦q	N	–rup, –rit
tamatikka¦rpoq	V	–nngilaq
tamatikkart¦oq	N	–up, –ut
tamat¦orpoq	V	–unngilaq
tamats¦erpaa	V	–inngilaa
tamats¦erpoq	V	–inngilaq
tamatsiaa¦rpoq	V	–nngilaq
tamatsi¦ppaa	V	–nngilaa
tamaviaaraluarsima¦voq	V	–nngilaq
tamaviaarnaqaaq	V	(no generation)
tamaviaarna¦rpoq	V	–nngilaq
tamaviaarnart¦oq	N	–up, –ut
tamaviaarne¦q	N	–rup, –rit
tamaviaa¦rpoq	V	–nngilaq
tamaviaarsinnaassu¦seq	N	–tsip, –tsit
tamaviaart¦oq	N	–up, –ut
tamaviaaru¦ppaa	V	–tinngilaa
tamaviaarussinerulerne¦q	N	–rup, –rit
tamaviaarussi¦voq	V	–nngilaq
tamaviat	N, pl.	-
tammaangaja¦ppaa	V	–nngilaa
tammaa¦ppaa	V	–tinngilaa
tammaa¦q	N	–p, –t
tammaarfi¦k	N	–up, –it
tammaarfiugallart¦oq	N	–up, –ut
tammaa¦rpoq	V	–nngilaq
tammaarsimaartarfi¦k	N	–up, –it
tammaarsimaffi¦k	N	–up, –it
tammaarsimmavi¦k	N	–up, –it
tammaasa¦q	N	–p, –t
tammaassi¦voq	V	–nngilaq
tammaa¦vaa	V	–nngilaa
tammaavi¦ppaa	V	–nngilaa
tammaa¦voq	V	–nngilaq
tamma¦gaq	N	–kkap, –kkat
tammajaa¦ppoq	V	–nngilaq
tammajavallaaqaaq	V	(no generation)
tammaja¦voq	V	–nngilaq
tammajuinaa¦rpoq	V	–nngilaq
tammajuippoq	V	(no generation)
tammajuits¦oq	N	–up, –ut
tammajuitsussa¦q	N	–p, –t
tammajuitsussarsiorne¦q	N	–rup, –rit
tammajuitsussii¦voq	V	–nngilaq
tammajuitsussi¦ppaa	V	–nngilaa
tammanngisaannangajappoq	V	(no generation)
tammaraluart¦oq	N	–up, –ut
tammarnaveeqqus¦erpaa	V	–inngilaa
tammarnaveeqqu¦serpaa	V	{–sinngilaa, –tilinngilaa}
tammarnaveeqqut	N	–ip, –it
tammarne¦q	N	–rup, –rit
tammarnik¦oq	N	–up, –ut
tamma¦rpaa	V	–nngilaa
tamma¦rpoq	V	–nngilaq
tammartaanna¦rpoq	V	–nngilaq
tammartajaa¦rpoq	V	–nngilaq
tammartajaart¦oq	N	–up, –ut
tammartakajaa¦rpoq	V	–nngilaq
tammartaqattaa¦rpoq	V	–nngilaq
tammartarne¦q	N	–rup, –rit
tammarti¦ppaa	V	–nngilaa
tammartitaa¦voq	V	–nngilaq
tammartitsine¦q	N	–rup, –rit
tammartitsis¦oq	N	–up, –ut
tammart¦oq	N	–up, –ut
tammatsaali¦vaa	V	–nngilaa
tammavi¦ppoq	V	–nngilaq
tammavissima¦voq	V	–nngilaq
tammavissinnaanngilaq	V	(no generation)
tammavissinnaa¦voq	V	–nngilaq
tammig¦aa	V	–inngilaa
tammikatta¦rpoq	V	–nngilaq
tammi¦ppoq	V	–nngilaq
tammissa¦rpoq	V	–nngilaq
tammittuaanna¦rpoq	V	–nngilaq
tammiu¦ppaa	V	–tinngilaa
tammiussi¦voq	V	–nngilaq
tamm¦ooq	N	–uup, –uut
tammoorfi¦k	N	–up, –it
tammoorfiusaart¦oq	N	–up, –ut
tammoorne¦q	N	–rup, –rit
tamm¦oorpoq	V	–uunngilaq
tammuut	N, pl.	-
tamorasaa¦q	N	–p, –t
tamorasaa¦rpoq	V	–nngilaq
tamorasaart¦orpoq	V	–unngilaq
tamorasaar¦torpoq	V	{–sunngilaq, –tunngilaq}
tamorasaassa¦q	N	–p, –t
tamorasassa¦q	N	–p, –t
tamorasisa¦rpoq	V	–nngilaq
tamorasisassa¦q	N	–p, –t
tam¦orpaa	V	–unngilaa
tam¦orpoq	V	–unngilaq
tamorrarlu¦ppoq	V	–nngilaq
tamorrat	N	–ip, –it
tamorratig¦aa	V	–inngilaa
tamortua¦rpoq	V	–nngilaq
tamuaanna¦rpoq	V	–nngilaq
tamuaa¦q	N	–p, –t
tamuaaqa¦rpoq	V	–nngilaq
tamuaassa¦q	N	–p, –t
tamuaat	N	–ip, –it
tamuaat	N, pl.	-
tamuajua¦rpoq	V	–nngilaq
tamuajunnaa¦rpoq	V	–nngilaq
tamuane¦q	N	–rup, –rit
tamua¦q	N	–p, –t
tamuartort¦oq	N	–up, –ut
tamuar¦tortoq	N	{–sortup, –tortup}, {–sortut, –tortut}
tamuasassa¦q	N	–p, –t
tamuattua¦q	N	–p, –t
tamuattua¦rpoq	V	–nngilaq
tamua¦vaa	V	–nngilaa
tamua¦voq	V	–nngilaq
tamu¦gaq	N	–kkap, –kkat
tamugart¦orpoq	V	–unngilaq
tamugar¦torpoq	V	{–sunngilaq, –tunngilaq}
tamugartort¦oq	N	–up, –ut
tamugar¦tortoq	N	{–sortup, –tortup}, {–sortut, –tortut}
tamulu¦ppaa	V	–nngilaa
tamulu¦ppoq	V	–nngilaq
tamusseriartoqqu¦aa	V	–nngilaa
tamusseriartoqqusi¦voq	V	–nngilaq
tamusseriart¦orpoq	V	–unngilaq
tamusserlua¦rpoq	V	–nngilaq
tamuss¦erpaa	V	–inngilaa
tamuss¦erpoq	V	–inngilaq
tamussers¦orpoq	V	–unngilaq
tamusserulu¦ppoq	V	–nngilaq
tamussilaa¦rpoq	V	–nngilaq
tamussiukkuma¦vaa	V	–nngilaa
tamussiu¦ppaa	V	–tinngilaa
tan¦erpaa	V	–inngilaa
tan¦erpoq	V	–inngilaq
tanertaa¦voq	V	–nngilaq
tanerta¦rpaa	V	–nngilaa
tanert¦erpaa	V	–inngilaa
tanerut	N	–ip, –it
tangajorne¦q	N	–rup, –rit
tangaj¦orpoq	V	–unngilaq
tangajorsaasiu¦ppaa	V	–tinngilaa
tangajorsaa¦siuppaa	V	{–siutinngilaa, –tiliutinngilaa}
tangajorsaat	N	–ip, –it
tangajorsa¦rpoq	V	–nngilaq
tangajortuinnaa¦voq	V	–nngilaq
tangajunngunaqaaq	V	(no generation)
tangajunngu¦voq	V	–nngilaq
tangajussangana¦rpoq	V	–nngilaq
tangajussanga¦voq	V	–nngilaq
tang¦eerpaa	V	–iinngilaa
tangeersi¦voq	V	–nngilaq
tangeerti¦ppaa	V	–nngilaa
tangeerukkiart¦orpoq	V	–unngilaq
tangeeru¦ppoq	V	–tinngilaq
tange¦q	N	–rup, –rit
tangeqanngilaq	V	(no generation)
tangeqanngits¦oq	N	–up, –ut
tangeqa¦rpoq	V	–nngilaq
tangeqarti¦ppaa	V	–nngilaa
tangeqartippoq	V	(no generation)
tangeqartitsine¦q	N	–rup, –rit
tangeqartitsi¦voq	V	–nngilaq
tangeqart¦oq	N	–up, –ut
tangertal¦erpaa	V	–inngilaa
tangerta¦q	N	–p, –t
tangert¦ooq	N	–uup, –uut
tangertu¦voq	V	–nngilaq
tangiits¦oorpoq	V	–uunngilaq
tangikilli¦vaa	V	–nngilaa
tangikinaa¦rpaa	V	–nngilaa
tangiki¦ppoq	V	–nngilaq
tangikueru¦ppoq	V	–tinngilaq
tangikut	N, pl.	-
tangil¦ik	N	{–iup, –lip, –lup}, –lit
tani	Interj	(no generation)
tani¦gaq	N	–kkap, –kkat
taniine¦q	N	–rup, –rit
tanii¦voq	V	–nngilaq
tani¦ppaa	V	–nngilaa
tani¦ppoq	V	–nngilaq
tanitaa¦voq	V	–nngilaq
tanita¦q	N	–p, –t
tanitsi¦voq	V	–nngilaq
tankileris¦oq	N	–up, –ut
tannaa¦rpaa	V	–nngilaa
tannaarpallaa¦rpaa	V	–nngilaa
tannaart¦oq	N	–up, –ut
tanne¦q	N	–rup, –rit
tannermoorne¦q	N	–rup, –rit
tannerm¦oorpoq	V	–uunngilaq
ta¦nnersaat	N	{–kinersat, –nnersaat, –nnersat, –kinersaatip, –nnersaatip}, {–kinersaatit, –nnersaatit}
tannersi¦orpoq	V	–unngilaq
tanneru¦voq	V	–nngilaq
ta¦nneruvoq	V	{–kinerunngilaq, –nnerunngilaq}
tannga¦ppoq	V	–nngilaq
tanngassimaarpoq	V	(no generation)
tapaasi¦orpoq	V	–unngilaq
tapaa¦siorpoq	V	{–siunngilaq, –tiliunngilaq}
tapaat	N	–ip, –it
tapaataa¦voq	V	–nngilaq
tapaatersuut	N	–ip, –it
tapaatersuut	N, pl.	-
tapa¦ppoq	V	–nngilaq
tapari¦aq	N	–ssap, –ssat
tapariars¦orpoq	V	–unngilaq
tapariar¦sorpoq	V	{–sunngilaq, –tunngilaq}
taparne¦q	N	–rup, –rit
tapa¦rpoq	V	–nngilaq
tapartaanna¦rpoq	V	–nngilaq
taparu¦seq	N	–tsip, –tsit
tapasaari¦voq	V	–nngilaq
tapattorsuu¦voq	V	–nngilaq
tapattorsu¦uvoq	V	{–aanngilaq, –unngilaq}
tap¦eq	N	–ip, –it
taper¦aa	V	–inngilaa
taperinngilaa	V	(no generation)
taperisima¦vaa	V	–nngilaa
tapernia¦rpaa	V	–nngilaa
tap¦erpaa	V	–inngilaa
tap¦erpoq	V	–inngilaq
tapers¦erpaa	V	–inngilaa
tapersersorneqarne¦q	N	–rup, –rit
tapersers¦orpaa	V	–unngilaa
tapersersorti	N	–p, –t
tapersersortissarsiorfi¦k	N	–up, –it
tapersersuis¦oq	N	–up, –ut
tapersersui¦voq	V	–nngilaq
tapersia¦q	N	–p, –t
tapersiine¦q	N	–rup, –rit
tapersiis¦oq	N	–up, –ut
tapersii¦voq	V	–nngilaq
tapersiu¦ppaa	V	–tinngilaa
tapersiut	N	–ip, –it
tapersi¦voq	V	–nngilaq
tapertaa¦voq	V	–nngilaq
taperta¦q	N	–p, –t
tapertar¦aa	V	–inngilaa
tapert¦orpaa	V	–unngilaa
tapiiffigineqartanngits¦oq	N	–up, –ut
tapiillua¦rpoq	V	–nngilaq
tapiisa¦rpoq	V	–nngilaq
tapiissut	N	–ip, –it
tapiissuteqartariaa¦seq	N	–tsip, –tsit
tapiissuteqartarne¦q	N	–rup, –rit
tapiissutisisussaatitaas¦oq	N	–up, –ut
tapiissutit	N, pl.	-
tapii¦voq	V	–nngilaq
tapiliussa¦q	N	–p, –t
tapillu¦innarpaa	V	{–aannanngilaa, –innanngilaa}
tapinnaalli¦voq	V	–nngilaq
tapinnaa¦ppoq	V	–nngilaq
tapinnaqaaq	V	(no generation)
tapinna¦rpoq	V	–nngilaq
tapi¦ppaa	V	–nngilaa
tapisiaaru¦ppoq	V	–tinngilaq
tapisia¦q	N	–p, –t
tapisiaqa¦rpoq	V	–nngilaq
tapisiassa¦q	N	–p, –t
tapitalerii¦ppoq	V	–nngilaq
tapitaleriissi¦ppaa	V	–nngilaa
tapitalerii¦ssippaa	V	{–ssinngilaa, –tsinngilaa}
tapitaleriissitsine¦q	N	–rup, –rit
tapitalerii¦ssitsineq	N	{–ssitsinerup, –tsitsinerup}, {–ssitsinerit, –tsitsinerit}
tapitsi¦voq	V	–nngilaq
tappakku	Pron, pl.	–a
tappa¦nna	Pron	–ssuma, {–kku, –kkua}
tappas¦eq	N	–ip, –it
tappas¦erpoq	V	–inngilaq
tappava	Interj	(no generation)
tappavanersu¦aq	N	–up, –it
tappavanii¦ppoq	V	–nngilaq
tappavunnaakkuma¦vaa	V	–nngilaa
tappavunnaa¦ppaa	V	–tinngilaa
tappavunnaassi¦voq	V	–nngilaq
tappavunna¦rpoq	V	–nngilaq
tappavunnarsima¦voq	V	–nngilaq
tappavunnart¦oq	N	–up, –ut
tappiffig¦aa	V	–inngilaa
tappiikujuppoq	V	(no generation)
tappiilli¦orpaa	V	–unngilaa
tappiilli¦orpoq	V	–unngilaq
tappiilli¦voq	V	–nngilaq
tappiilluinnart¦oq	N	–up, –ut
tappiinne¦q	N	–rup, –rit
tappiippallaanngilaq	V	(no generation)
tappii¦ppoq	V	–nngilaq
tappiits¦oq	N	–up, –ut
tappika	Interj	(no generation)
tappikanii¦ppoq	V	–nngilaq
tappikannga¦rpoq	V	–nngilaq
tappikku	Pron, pl.	–a
tappikujuffig¦aa	V	–inngilaa
tappikujukkunnaarpoq	V	(no generation)
tappikujuppoq	V	(no generation)
tappikujuttunng¦orpoq	V	–unngilaq
tappikungaanna¦rpoq	V	–nngilaq
tappikungaannarsima¦voq	V	–nngilaq
tappikunnaa¦ppaa	V	–tinngilaa
tappikunnaassui¦voq	V	–nngilaq
tappikunna¦rpoq	V	–nngilaq
tappikunnarsinnaa¦voq	V	–nngilaq
tapping¦erpoq	V	–inngilaq
tappingersima¦voq	V	–nngilaq
tappingersi¦ppaa	V	–nngilaa
tappingingaja¦ppoq	V	–nngilaq
tappinnaqaaq	V	(no generation)
tappi¦nnga	Pron	–ssuma, {–kku, –kkua}
tappiorannart¦oq	N	–up, –ut
tappiorannartorsi¦orpoq	V	–unngilaq
tappiorannartulerine¦q	N	–rup, –rit
tappiorannartut	N, pl.	-
tappiora¦ppoq	V	–nngilaq
tappi¦ppoq	V	–nngilaq
tappissaat	N	–ip, –it
tappi¦ssaat	N	{–ssaatip, –ttaatip}, {–ssaatit, –ttaatit}
tappissa¦rpaa	V	–nngilaa
tappissi¦voq	V	–nngilaq
tappissu¦ppoq	V	–nngilaq
tappiut	N	–ip, –it
tappu¦ppaa	V	–tinngilaa
tappussaa¦voq	V	–nngilaq
tappussa¦q	N	–p, –t
tappussi¦voq	V	–nngilaq
tapu¦ppaa	V	–nngilaa
tapussi¦voq	V	–nngilaq
taputa¦q	N	–p, –t
taputartuu¦ppaa	V	–tinngilaa
taputartuussi¦voq	V	–nngilaq
taqaa¦raq	N	–qqap, –qqat
taqajaa¦voq	V	–nngilaq
taqaja¦k	N	–ap, –at
taqala¦k	N	–ap, –at
taqalasaa¦voq	V	–nngilaq
taqalasa¦k	N	–ap, –at
taqaleqisaa¦q	N	–p, –t
taqammisaa¦rpoq	V	–nngilaq
taqammisarfig¦aa	V	–inngilaa
taqammisa¦rpaa	V	–nngilaa
taqammi¦voq	V	–nngilaq
taqamm¦orpoq	V	–unngilaq
taqammortaqattaa¦rpoq	V	–nngilaq
taqammu¦aq	N	–ssap, –ssat
taqammu¦gaq	N	–kkap, –kkat
taqammuu¦ppaa	V	–tinngilaa
taqammuussaa¦voq	V	–nngilaq
taqamoriaa¦voq	V	–nngilaq
taqamoria¦rpaa	V	–nngilaa
taqamorlua¦rpaa	V	–nngilaa
taqam¦orpaa	V	–unngilaa
taqamui¦voq	V	–nngilaq
taqamu¦ppaa	V	–nngilaa
taqamut	N	–ip, –it
taq¦aq	N	–qap, –qat
taqarsi¦orpaa	V	–unngilaa
taqarsiorti¦ppoq	V	–nngilaq
taqarsiui¦voq	V	–nngilaq
taqarsiut	N	–ip, –it
taqarsu¦aq	N	–up, –it
taqarua¦rpoq	V	–nngilaq
taqaruartuinnaa¦voq	V	–nngilaq
taqassig¦aa	V	–inngilaa
taqassina¦rpoq	V	–nngilaq
taqassinart¦oq	N	–up, –ut
taqimaa¦ppoq	V	–nngilaq
taqimajunnaa¦rpoq	V	–nngilaq
taqimas¦oq	N	–up, –ut
taqimassu¦seq	N	–tsip, –tsit
taqima¦voq	V	–nngilaq
taqingagaju¦ppoq	V	–nngilaq
taqinga¦voq	V	–nngilaq
taqinne¦q	N	–rup, –rit
taqi¦ppoq	V	–nngilaq
taqisaa¦rpaa	V	–nngilaa
taqiss¦orpaa	V	–unngilaa
taqiss¦orpoq	V	–unngilaq
taqissu¦gaq	N	–kkap, –kkat
taqqaasa¦q	N	–p, –t
taqqaasarmiu	N	–p, –t
taqqakku	Pron, pl.	–a
taqqakku¦a	Pron, pl.	–a
taqq¦alersorpaa	V	{–alersunngilaa, –ersunngilaa}
taqqal¦ik	N	{–iup, –lip, –lup}, –lit
taqqallu¦k	N	–up, –it
taqqallu¦ppoq	V	–nngilaq
taqqallussu¦aq	N	–up, –it
taqqama	Interj	(no generation)
taqqamaa¦ppaa	V	–tinngilaa
taqqamaniikkunnaa¦rpoq	V	–nngilaq
taqqamanii¦ppoq	V	–nngilaq
taqqanii¦ppoq	V	–nngilaq
taqqa¦nna	Pron	–ssuma, {–kku, –kkua}
taqqa¦ppoq	V	–nngilaq
taqqa¦q	N	–p, –t
taqqarmi¦oq	N	–up, –ut
taqqarmiu	N	–p, –t
taqqattoornerlu¦ppoq	V	–nngilaq
taqqatt¦oorpoq	V	–uunngilaq
taqqatt¦orpoq	V	–unngilaq
taqqava	Interj	(no generation)
taqqavaneraallak	Interj	(no generation)
taqqavanersu¦aq	N	–up, –it
taqqavannga¦rpoq	V	–nngilaq
taqqers¦orpaa	V	–unngilaa
taqqi¦ppaa	V	–nngilaa
taqqiss¦orpaa	V	–unngilaa
Taqqissuivi¦k	N	{–iup, –up}, {–iit, –it}
taqqissui¦voq	V	–nngilaq
taqqissuunna¦q	N	–p, –t
taqqissuusi¦orpoq	V	–unngilaq
taqqissuu¦siorpoq	V	{–siunngilaq, –tiliunngilaq}
taqqi¦ssuusiorpoq	V	{–ssuusiunngilaq, –ssuutiliunngilaq, –ttuusiunngilaq, –ttuutiliunngilaq}
taqqissuut	N	–ip, –it
taqqi¦ssuut	N	{–ssuutip, –ttuutip}, {–ssuutit, –ttuutit}
taquaa¦voq	V	–nngilaq
taquaki¦ppoq	V	–nngilaq
taqu¦aq	N	–ssap, –ssat
taquaqaqaaq	V	(no generation)
taquaqa¦rpoq	V	–nngilaq
taquarfi¦k	N	–up, –it
taqua¦rpoq	V	–nngilaq
taquartaanna¦rpoq	V	–nngilaq
taquerulluinna¦rpoq	V	–nngilaq
taqueru¦ppoq	V	–tinngilaq
taquerutt¦oorpoq	V	–uunngilaq
taqussat	N, pl.	-
taquss¦erpaa	V	–inngilaa
taquss¦erpoq	V	–inngilaq
taqussersima¦voq	V	–nngilaq
taqussersorne¦q	N	–rup, –rit
taqussers¦orpaa	V	–unngilaa
taqussers¦orpoq	V	–unngilaq
taqussii¦voq	V	–nngilaq
taqussi¦ppaa	V	–nngilaa
taqussiukkuma¦vaa	V	–nngilaa
taqussiu¦ppaa	V	–tinngilaa
tara¦joq	N	–tsup, –tsut
tarajoqanngits¦oq	N	–up, –ut
tarajoqarneru¦voq	V	–nngilaq
tarajoqarpallaa¦rpoq	V	–nngilaq
tarajoqa¦rpoq	V	–nngilaq
tarajoqqarni¦ppoq	V	–nngilaq
tarajorni¦ppoq	V	–nngilaq
tarajornits¦oq	N	–up, –ut
tarajorni¦tsoq	N	{–ssup, –tsup, –ttup}, {–ssut, –tsut, –ttut}
taraj¦orpaa	V	–unngilaa
taraj¦orpoq	V	–unngilaq
tarajorterivi¦k	N	–up, –it
tarajorteri¦voq	V	–nngilaq
tarajort¦erpaa	V	–inngilaa
tarajorti¦gaq	N	–kkap, –kkat
taraju¦erpoq	V	–inngilaq
tarajueru¦ppoq	V	–tinngilaq
tarajuerutivi¦ppoq	V	–nngilaq
tarajuusivi¦k	N	–up, –it
taraluttuaq	Interj	(no generation)
tarats¦erivoq	V	{–erinngilaq, –iinngilaq}
tarats¦erpaa	V	–inngilaa
taratser¦suut	N	{–suutip, –tuutip}, {–suutit, –tuutit}
tarats¦iivoq	V	{–erinngilaq, –iinngilaq}
taratsut	N, pl.	-
tar¦eerpaa	V	–iinngilaa
tar¦eerpoq	V	–iinngilaq
tareersima¦voq	V	–nngilaq
tarfigaju¦ppoq	V	–nngilaq
tarfiinna¦rpoq	V	–nngilaq
tarfiinnarti¦ppaa	V	–nngilaa
tarfiinnartitaa¦voq	V	–nngilaq
tarfiinnart¦oq	N	–up, –ut
tarfis¦oq	N	–up, –ut
tarfiumatoqaaq	V	(no generation)
tarfivallaaqaaq	V	(no generation)
tarfi¦voq	V	–nngilaq
tariinnaa¦voq	V	–nngilaq
tarii¦ppoq	V	–nngilaq
tariisi¦ppaa	V	–nngilaa
tariits¦oorpoq	V	–uunngilaq
tarneeru¦ppoq	V	–tinngilaq
tarneerutinngilaq	V	(no generation)
tar¦neq	N	{–nerup, –rnup}, {–nerit, –rnit}
tarneqa¦rpoq	V	–nngilaq
tarneqartua¦rpoq	V	–nngilaq
tarners¦orpoq	V	–unngilaq
tarngu¦ppaa	V	–tinngilaa
tarngu¦ppoq	V	–tinngilaq
tarngu¦serpaa	V	{–sinngilaa, –tilinngilaa}
tarngu¦serpaa	V	–tilinngilaa
tarngu¦sersorpaa	V	{–sersunngilaa, –tilersunngilaa}
tarngusi¦orpoq	V	–unngilaq
tarngu¦siorpoq	V	{–siunngilaq, –tiliunngilaq}
tarngussi¦voq	V	–nngilaq
tarngut	N	–ip, –it
tarngut¦iinnarpoq	V	{–iinnanngilaq, –siinnanngilaq}
tarngutissa¦q	N	–p, –t
tarni	N	–p, –t
tarniia¦rpaa	V	–nngilaa
tarni¦k	N	{–ngup, –up}, {–it, –ngit}
tarnikkut	N, pl.	-
tarnil¦erpaa	V	–inngilaa
tarnil¦ik	N	{–iup, –lip, –lup}, –lit
tarniliu¦voq	V	–nngilaq
tarni¦nganiippoq	V	{–aniinngilaq, –nganiinngilaq}
tarning¦erpaa	V	–inngilaa
tarning¦erpoq	V	–inngilaq
tarningii¦voq	V	–nngilaq
tarnu¦ppaa	V	–tinngilaa
tarnu¦ppoq	V	–tinngilaq
tarnu¦serpaa	V	{–sinngilaa, –tilinngilaa}
tarnu¦serpaa	V	–tilinngilaa
tarnu¦sersorpaa	V	{–sersunngilaa, –tilersunngilaa}
tarnusi¦orpoq	V	–unngilaq
tarnu¦siorpoq	V	{–siunngilaq, –tiliunngilaq}
tarnussi¦voq	V	–nngilaq
tarnut	N	–ip, –it
tarnutiinna¦rpoq	V	–nngilaq
tarnut¦iinnarpoq	V	{–iinnanngilaq, –siinnanngilaq}
tarnutissa¦q	N	–p, –t
tarnutissia¦q	N	–p, –t
taroriartorne¦q	N	–rup, –rit
taroriart¦orpoq	V	–unngilaq
tarorne¦q	N	–rup, –rit
tar¦orpoq	V	–unngilaq
tarorsimas¦oq	N	–up, –ut
tarorsima¦voq	V	–nngilaq
tarorti¦ppaa	V	–nngilaa
tarpaa¦voq	V	–nngilaq
tarpangaanna¦rpoq	V	–nngilaq
tarpangaqut	N	–ip, –it
tarpangas¦oq	N	–up, –ut
tarpangasussa¦q	N	–p, –t
tarpangasuu¦voq	V	–nngilaq
tarpangavallaa¦rpoq	V	–nngilaq
tarpanga¦voq	V	–nngilaq
tarpaqaju¦ppoq	V	–nngilaq
tarpaqajutsi¦ppoq	V	–nngilaq
tarpaqajuttuinnaa¦voq	V	–nngilaq
tarpaqus¦erpaa	V	–inngilaa
tarpaqu¦serpaa	V	{–sinngilaa, –tilinngilaa}
tarpaqut	N	–ip, –it
tarpaqutaa¦voq	V	–nngilaq
tarparne¦q	N	–rup, –rit
tarpa¦rpaa	V	–nngilaa
tarpa¦rpoq	V	–nngilaq
tarparsa¦rpaa	V	–nngilaa
tarpartaa¦rpoq	V	–nngilaq
tarparti¦ppaa	V	–nngilaa
tarraaja¦voq	V	–nngilaq
tarraannaa¦voq	V	–nngilaq
tarraanna¦q	N	–ap, –at
tarraaru¦ppoq	V	–tinngilaq
tarraarutivi¦ppoq	V	–nngilaq
tarraasaanna¦rpoq	V	–nngilaq
tarraasaa¦rpaa	V	–nngilaa
tarraati¦ppaa	V	–nngilaa
tarraa¦voq	V	–nngilaq
tarrajaanngu¦aq	N	–up, –it
tarrajaa¦q	N	–p, –t
tarrajarsuit	N, pl.	-
tarrajarsu¦k	N	–up, –it
tarraju¦k	N	–up, –it
tarrajunnerus¦oq	N	–up, –ut
tarrajuppallaa¦rpoq	V	–nngilaq
tarraju¦ppoq	V	–nngilaq
tarrajussiart¦orpoq	V	–unngilaq
tarrajussiar¦torpoq	V	{–tunngilaq, –sunngilaq}
tarrajussivallaassa¦aq	V	–nngilaq
tarrajussi¦voq	V	–nngilaq
tarrajuttuinnaa¦voq	V	–nngilaq
tarralanitanngueru¦ppoq	V	–tinngilaq
tarraleqisaa¦q	N	–p, –t
tarral¦ik	N	{–iup, –lip, –lup}, –lit
tarralisaannguarsi	Interj	(no generation)
tarralisaa¦rpoq	V	–nngilaq
tarranillua¦rpoq	V	–nngilaq
tarrani¦ppoq	V	–nngilaq
tarra¦q	N	–p, –t
tarraqa¦rpoq	V	–nngilaq
tarraqqutsi¦voq	V	–nngilaq
tarrari¦ppoq	V	–nngilaq
tarrarsorfi¦k	N	–up, –it
tarrar¦sorfik	N	{–sorfiup, –torfiup}, {–sorfiit, –torfiit}
tarrarsorne¦q	N	–rup, –rit
tarrar¦sorneq	N	{–sornerup, –tornerup}, {–sornerit, –tornerit}
tarrars¦orpaa	V	–unngilaa
tarrars¦orpoq	V	–unngilaq
tarrar¦sorpoq	V	{–sunngilaq, –tunngilaq}
tarrarsortaanna¦rpoq	V	–nngilaq
tarrarsuine¦q	N	–rup, –rit
tarrarsuisart¦oq	N	–up, –ut
tarrarsuusi¦orpoq	V	–unngilaq
tarrarsuu¦siorpoq	V	{–siunngilaq, –tiliunngilaq}
tarrarsuussu¦aq	N	–up, –it
tarrarsuut	N	–ip, –it
tarrarsuutisi¦voq	V	–nngilaq
tarrarta¦q	N	–p, –t
tarrartassaaru¦ppoq	V	–tinngilaq
tarrar¦torpoq	V	{–sunngilaq, –tunngilaq}
tarrartuut	N	–ip, –it
tarrartuut	N, pl.	-
tarreqqi¦ppoq	V	–nngilaq
tarriffig¦aa	V	–inngilaa
tarriffi¦k	N	–up, –it
tarriffissaaru¦ppoq	V	–tinngilaq
tarriffissi¦vaa	V	–nngilaa
tarriffiu¦voq	V	–nngilaq
tarrikkiart¦orpoq	V	–unngilaq
tarri¦ppaa	V	–nngilaa
tarri¦ppoq	V	–nngilaq
tarrisima¦voq	V	–nngilaq
tarrisi¦ppaa	V	–nngilaa
tarrisi¦vaa	V	–nngilaa
tarrissaa¦rpoq	V	–nngilaq
tarrulluinna¦rpaa	V	–nngilaa
tarrullu¦innarpaa	V	{–aannanngilaa, –innanngilaa}
tarru¦ppaa	V	–tinngilaa
tarrussaa¦voq	V	–nngilaq
tarrutivi¦ppaa	V	–nngilaa
tarruttoorti¦ppoq	V	–nngilaq
tarsaanngu¦aq	N	–up, –it
tarsaa¦voq	V	–nngilaq
tarsa¦k	N	–ap, –at
tarsa¦ppoq	V	–nngilaq
tarsa¦q	N	–p, –t
tarsari¦ppoq	V	–nngilaq
tarsiallaanna¦q	N	–ap, –at
tarsiallaanna¦rpoq	V	–nngilaq
tarsialla¦ppoq	V	–nngilaq
tarsialu¦ppoq	V	–nngilaq
tarsialuttuinnaa¦voq	V	–nngilaq
tarsiinnaq	Interj	(no generation)
tarsisaa¦rpaa	V	–nngilaa
tartaa¦q	N	–p, –t
tartaarpalu¦ppoq	V	–nngilaq
tartaa¦rpoq	V	–nngilaq
tartartaa¦q	N	–p, –t
tart¦oq	N	–up, –ut
tartoqut	N	–ip, –it
tartoqutaa¦voq	V	–nngilaq
tartoqutit	N, pl.	-
tartu	N	–p, –t
tartulukkunnaa¦rpoq	V	–nngilaq
tartulunne¦q	N	–rup, –rit
tartulu¦ppoq	V	–nngilaq
tartunaki¦ppoq	V	–nngilaq
tartuna¦q	N	–p, –t
tartunartu¦voq	V	–nngilaq
tartune¦q	N	–rup, –rit
Tartupalu¦k	Prop	–up, –it
Tartutuuttut	N, pl.	-
tartutuuttut	N, pl.	-
tartuusal¦ik	N	{–iup, –lip, –lup}, –lit
tartuusa¦q	N	–p, –t
tarungajunnaa¦rpoq	V	–nngilaq
tarungatsi¦ppoq	V	–nngilaq
tarunga¦voq	V	–nngilaq
tasakku	Pron, pl.	–a
tasama	Interj	(no generation)
tasamanii¦ppoq	V	–nngilaq
tasamunnaakkuma¦vaa	V	–nngilaa
tasamunnaa¦ppaa	V	–tinngilaa
tasamunnaassi¦voq	V	–nngilaq
tasamunnaqq¦oorpoq	V	–uunngilaq
tasamunna¦rpoq	V	–nngilaq
tasamunnarti¦ppaa	V	–nngilaa
tasamuunaqqu¦ppoq	V	–tinngilaq
tasa¦nna	Pron	–ssuma, {–kku, –kkua}
ta¦seq	N	–tsip, –tsit
taseqarfi¦k	N	–up, –it
taseqq¦erpoq	V	–inngilaq
taseqqers¦orpoq	V	–unngilaq
taseraasa¦q	N	–p, –t
Taseral¦ik	N	{–iup, –lip, –lup}, –lit
tase¦raq	N	–qqap, –qqat
taserasaa¦rpoq	V	–nngilaq
taserasaar¦tuinnaavoq	V	{–tuinnaanngilaq, –suinnaanngilaq}
Tasermiut	N, pl.	-
Tasersu¦aq	N	–up, –it
tasersu¦k	N	–up, –it
tasiallanne¦q	N	–rup, –rit
tasia¦q	N	–p, –t
Tasiila¦q	N	–p, –t
Tasiila¦q	Prop	–p
tasii¦voq	V	–nngilaq
tasikkarsa¦rpaa	V	–nngilaa
tasikumia¦rpaa	V	–nngilaa
tasikumia¦rpoq	V	–nngilaq
tasikumissiu¦ppaa	V	–tinngilaa
tasilia¦q	N	–p, –t
tasinngortaasa¦q	N	–p, –t
tasinngortal¦ik	N	{–iup, –lip, –lup}, –lit
tasinngorta¦q	N	–p, –t
tasinngortarsu¦aq	N	–up, –it
tasinngu¦aq	N	–up, –it
tasi¦orpaa	V	–unngilaa
tasi¦orpoq	V	–unngilaq
tasiortaa¦voq	V	–nngilaq
tasiorti	N	–p, –t
tasiortig¦aa	V	–inngilaa
tasiorti¦ppoq	V	–nngilaq
tasiortissa¦q	N	–p, –t
tasiort¦oq	N	–up, –ut
tasipi¦gaq	N	–kkap, –kkat
tasipi¦ppaa	V	–nngilaa
tasipi¦ppoq	V	–nngilaq
tasi¦ppaa	V	–nngilaa
tasi¦ppoq	V	–nngilaq
tasisa¦q	N	–p, –t
tasisart¦oq	N	–up, –ut
tasisartussa¦q	N	–p, –t
tasis¦oorpoq	V	–uunngilaq
tasis¦oq	N	–up, –ut
tasissers¦orpaa	V	–unngilaa
tasissersortaat	N	–ip, –it
tasissersuukkuma¦vaa	V	–nngilaa
tasissersuu¦ppaa	V	–tinngilaa
tasissersuussi¦voq	V	–nngilaq
tasissiullua¦rpaa	V	–nngilaa
tasissiunnia¦rpaa	V	–nngilaa
tasissiu¦ppaa	V	–tinngilaa
tasissiussi¦voq	V	–nngilaq
tasisuaa¦rpoq	V	–nngilaq
tasisuaart¦oq	N	–up, –ut
tasisua¦voq	V	–nngilaq
tasisukkaa¦rpoq	V	–nngilaq
tasitsaa¦rpoq	V	–nngilaq
tasitsaat	N	–ip, –it
tasitsaateqa¦rpoq	V	–nngilaq
tasitsaa¦voq	V	–nngilaq
tasitsagaa¦voq	V	–nngilaq
tasitsa¦gaq	N	–kkap, –kkat
tasitsagaqa¦rpoq	V	–nngilaq
tasitsa¦rpaa	V	–nngilaa
tasitsig¦aa	V	–inngilaa
tasitsisaa¦voq	V	–nngilaq
tasitsit	N	–ip, –it
tasitsi¦voq	V	–nngilaq
tasiugaa¦voq	V	–nngilaq
tasiugal¦ik	N	{–iup, –lip, –lup}, –lit
tasiu¦gaq	N	–kkap, –kkat
tasiugassaa¦voq	V	–nngilaq
Tasiusa¦q	N	–p, –t
Tasiusa¦q	Prop	–p
tasiusa¦q	N	–p, –t
tasiusarmiu	N	–p, –t
Tasiusarsu¦aq	N	–up, –it
Tasiusarsu¦aq	Prop	–up, –it
tasiusarsu¦aq	N	–up, –it
tasi¦vaa	V	–nngilaa
tasi¦voq	V	–nngilaq
tassa	Interj	(no generation)
tassa-taava	Interj	(no generation)
tassaaginna¦rpoq	V	–nngilaq
tassaajuarpoq	V	(no generation)
tassaamisaa¦rpoq	V	–nngilaq
tassaanna¦q	N	–ap, –at
tassaarne¦q	N	–rup, –rit
tassaa¦rpoq	V	–nngilaq
tassaarsii¦vaa	V	–nngilaa
tassaas¦oq	N	–up, –ut
tassaatinneqa¦rpoq	V	–nngilaq
tassaa¦voq	V	–nngilaq
tassanii¦ppoq	V	–nngilaq
tassanngaannariartart¦oq	N	–up, –ut
tassanngaanna¦rpoq	V	–nngilaq
tassanngaannart¦oq	N	–up, –ut
tassaqa	Interj	(no generation)
tassataava	Interj	(no generation)
tassataavaanna¦q	N	–ap, –at
tassataavanngu¦aq	N	–up, –it
tassiaasa¦q	N	–p, –t
tassia¦q	N	–p, –t
tassii¦voq	V	–nngilaq
tassi¦k	N	–up, –it
tassikag¦aa	V	–inngilaa
tassika¦ppoq	V	–nngilaq
tassi¦ppaa	V	–nngilaa
tassi¦ppoq	V	–nngilaq
tassittaa¦rpoq	V	–nngilaq
tassi¦voq	V	–nngilaq
tassungarluinnaa¦voq	V	–nngilaq
tassunnaakkumanngilaa	V	(no generation)
tassunnaa¦ppaa	V	–tinngilaa
tassunnaassi¦voq	V	–nngilaq
tassunna¦rpoq	V	–nngilaq
tassunnarsima¦voq	V	–nngilaq
tassunnarti¦ppaa	V	–nngilaa
tassu¦ppaa	V	–nngilaa
tassussaa¦voq	V	–nngilaq
tassuta¦q	N	–p, –t
tassutarii¦ppoq	V	–nngilaq
tassutserfi¦k	N	–up, –it
tassuts¦erpaa	V	–inngilaa
tassuugu	Interj	(no generation)
tassuugunngort¦oq	N	–up, –ut
tassuunaanna¦q	N	–ap, –at
tassuunaqqu¦ppaa	V	–tinngilaa
tassuunaqqu¦ppoq	V	–tinngilaq
tataag¦aa	V	–inngilaa
tataaginngilaa	V	(no generation)
tataagivi¦ppaa	V	–nngilaa
tataannaqaaq	V	(no generation)
tataannar¦aa	V	–inngilaa
tataanna¦rpoq	V	–nngilaq
tataannart¦oq	N	–up, –ut
tataannartorsu¦aq	N	–up, –it
tataannartorujussu¦aq	N	–up, –it
tataannartulia¦q	N	–p, –t
tataa¦ppoq	V	–nngilaq
tataa¦rpaa	V	–nngilaa
tataa¦rpoq	V	–nngilaq
tataatsaa¦ppaa	V	–tinngilaa
tataatsangaart¦oq	N	–up, –ut
tataatsa¦ppoq	V	–nngilaq
tatami¦ppaa	V	–nngilaa
tatami¦ppoq	V	–nngilaq
tatamissut	N	–ip, –it
tatamissut	N, pl.	-
tatami¦ssut	N, pl.	{–ssut, –ttut}
tatamiti¦ppaa	V	–nngilaa
tatamittorsuu¦voq	V	–nngilaq
tatamittorsu¦uvoq	V	{–aanngilaq, –unngilaq}
tatami¦ttorsuuvoq	V	{–ssorsuaanngilaq, –ssorsuunngilaq, –ttorsuaanngilaq, –ttorsuunngilaq}
tatammut	N	–ip, –it
tatammutaa¦voq	V	–nngilaq
tatammutig¦aa	V	–inngilaa
tata¦ppoq	V	–nngilaq
tatatsikkiart¦orpoq	V	–unngilaq
tatattuinnaa¦voq	V	–nngilaq
tateqaler¦sippaa	V	{–sinngilaa, –tinngilaa}
tateqarlua¦rpoq	V	–nngilaq
tateqa¦rpoq	V	–nngilaq
tatequmi¦aq	N	–ssap, –ssat
tatequmiss¦erpaa	V	–inngilaa
tati	N	–p, –t
tatiart¦orpaa	V	–unngilaa
tatig¦aa	V	–inngilaa
tatigeqatigiinne¦q	N	–rup, –rit
tatiginanngits¦oq	N	–up, –ut
tatigina¦rpoq	V	–nngilaq
tatiginart¦oq	N	–up, –ut
tatiginassu¦seq	N	–tsip, –tsit
tatiginninne¦q	N	–rup, –rit
tatiginninnginne¦q	N	–rup, –rit
tatiginni¦ppoq	V	–nngilaq
tatigisaas¦oq	N	–up, –ut
tatigisaqa¦rpoq	V	–nngilaq
tatigisassaanngits¦oq	N	–up, –ut
tatigisassaas¦oq	N	–up, –ut
tatigisassaa¦voq	V	–nngilaq
tatigu¦ppaa	V	–tinngilaa
tatiki¦ppoq	V	–nngilaq
tatineqarne¦q	N	–rup, –rit
tatineqa¦rpoq	V	–nngilaq
tatineqart¦oq	N	–up, –ut
tatisimaa¦rpaa	V	–nngilaa
tatisi¦voq	V	–nngilaq
tatissaanngilaq	V	(no generation)
tatissa¦q	N	–p, –t
tatissar¦aa	V	–inngilaa
tatissatua¦q	N	–p, –t
tatit¦ooq	N	–uup, –uut
tatitoorsu¦aq	N	–up, –it
tatitt¦orpoq	V	–unngilaq
tatittuukkiart¦orpaa	V	–unngilaa
tatittuu¦ppaa	V	–tinngilaa
tatittuussi¦voq	V	–nngilaq
tatittuutinngilaa	V	(no generation)
tatitunersaat	N	–ip, –it
tatituneru¦voq	V	–nngilaq
tatitusaa¦rpoq	V	–nngilaq
tatitu¦voq	V	–nngilaq
tati¦vaa	V	–nngilaa
tatsiaa¦voq	V	–nngilaq
tatsiamii¦ppoq	V	–nngilaq
tatsia¦q	N	–p, –t
tatsikk¦oorpoq	V	–uunngilaq
ta¦tsikkoorpoq	V	{–sikkuunngilaq, –tsikkuunngilaq}
tatsikkoorti¦ppaa	V	–nngilaa
ta¦tsikkoortippaa	V	{–sikkoortinngilaa, –tsikkoortinngilaa}
tatsikkooru¦ppaa	V	–tinngilaa
tatsikkoorussi¦voq	V	–nngilaq
ta¦tsimiippoq	V	{–sermiinngilaq, –simiinngilaq, –tsimiinngilaq}
ta¦tsimiittarpoq	V	{–sermiittanngilaq, –simiittanngilaq, –tsimiittanngilaq}
tatsi¦orpoq	V	–unngilaq
tatsiorsinnaa¦voq	V	–nngilaq
tattaajaa¦voq	V	–nngilaq
tattaaja¦rpaa	V	–nngilaa
tattaajarti¦ppaa	V	–nngilaa
tattaasaaru¦ppoq	V	–tinngilaq
tattaasa¦q	N	–p, –t
tattaasat	N, pl.	-
tatta¦k	N	–ap, –at
tattani¦ppoq	V	–nngilaq
tattatt¦ooq	N	–uup, –uut
tattattoorsu¦aq	N	–up, –it
tattoqinne¦q	N	–rup, –rit
tattoqi¦ppaa	V	–nngilaa
tattoqi¦ppoq	V	–nngilaq
tattoqisaa¦rpoq	V	–nngilaq
tattoqisi¦ppaa	V	–nngilaa
tattoqitsi¦voq	V	–nngilaq
tattoqiu¦ppoq	V	–tinngilaq
tattoqu¦serpaa	V	{–sinngilaa, –tilinngilaa}
tattoqu¦sersorpaa	V	{–sersunngilaa, –tilersunngilaa}
tattoqut	N	–ip, –it
tattoqutaaginna¦rpoq	V	–nngilaq
tattoqutaa¦voq	V	–nngilaq
tattoqutsiu¦ppaa	V	–tinngilaa
tattoqut¦siuppaa	V	{–italiutinngilaa, –siutinngilaa}
tatt¦orpaa	V	–unngilaa
tattu¦gaq	N	–kkap, –kkat
tattui¦voq	V	–nngilaq
tattuukkaa¦rpoq	V	–nngilaq
tattuu¦ppoq	V	–tinngilaq
tattuussa¦rpoq	V	–nngilaq
tatugumits¦erpaa	V	–inngilaa
tatugumitsii¦voq	V	–nngilaq
tatugumitsiu¦ppaa	V	–tinngilaa
tatugut	N	–ip, –it
tatummia¦rpoq	V	–nngilaq
tatummiartaannarpoq	V	(no generation)
tava¦ppoq	V	–nngilaq
tavatsi¦ppaa	V	–nngilaa
tavatsitsine¦q	N	–rup, –rit
taxarne¦q	N	–rup, –rit
taxa¦rpoq	V	–nngilaq
taxartart¦oq	N	–up, –ut
taxartitsis¦oq	N	–up, –ut
tb	N	(no generation)
teeqila¦voq	V	–nngilaq
teknikkeqarfik	N	(no generation)
teknikki	N	(no generation)
teknikkilerineq	N	(no generation)
telefonerfig¦aa	V	–inngilaa
telefonerne¦q	N	–rup, –rit
telefon¦erpoq	V	–inngilaq
telefonertarfi¦k	N	–up, –it
telegramm¦erpoq	V	–inngilaq
telegrammi	N	(no generation)
teqeqq¦oq	N	–up, –ut
teqeqqoqa¦rpoq	V	–nngilaq
teqeqqorillua¦rpoq	V	–nngilaq
teqeqqori¦ppoq	V	–nngilaq
teqeqqorissaat	N	–ip, –it
teqeqqori¦ssaat	N	{–ssaatip, –ttaatip}, {–ssaatit, –ttaatit}
teqeqqorissi¦voq	V	–nngilaq
teqeqqoriss¦oq	N	–up, –ut
teqeqqori¦ssoq	N	{–ssup, –ttup}, {–ssut, –ttut}
teqeqqorl¦eq	N	–iup, –iit
teqeqqorsi¦orpoq	V	–unngilaq
teqeqqua¦rpaa	V	–nngilaa
teqeqqu¦erpaa	V	–inngilaa
teqeqquia¦rpaa	V	–nngilaa
teqeqqu¦iarpaa	V	{–ajanngilaa, –ianngilaa}
teqeqqumii¦ppoq	V	–nngilaq
teqeqqumiissima¦voq	V	–nngilaq
teqeqqussa¦q	N	–p, –t
teqeqqussavi¦k	N	–up, –it
teqig¦aa	V	–inngilaa
teqigusu¦ppoq	V	–nngilaq
teqillernaqaaq	V	(no generation)
teqill¦erpoq	V	–inngilaq
teqillersimassutig¦aa	V	–inngilaa
teqilliu¦ppaa	V	–tinngilaa
teqilliutig¦aa	V	–inngilaa
teqillu¦k	N	–up, –it
teqillu¦ppoq	V	–nngilaq
teqiss¦orpaa	V	–unngilaa
teqqajanaqaaq	V	(no generation)
teqqajana¦rpoq	V	–nngilaq
teqqajanarsi¦voq	V	–nngilaq
teqqakatta¦rpoq	V	–nngilaq
teqqakattarti¦ppaa	V	–nngilaa
teqqakattartuinnaa¦voq	V	–nngilaq
teqqalaa¦rpoq	V	–nngilaq
teqqalaartuinnaa¦voq	V	–nngilaq
teqqalanarsi¦voq	V	–nngilaq
teqqalasorsuu¦voq	V	–nngilaq
teqqalasorsu¦uvoq	V	{–aanngilaq, –unngilaq}
teqqalati¦ppaa	V	–nngilaa
teqqalatitsi¦voq	V	–nngilaq
teqqala¦voq	V	–nngilaq
teqqa¦rpoq	V	–nngilaq
teqqatta¦q	N	–p, –t
teqqatta¦rpaa	V	–nngilaa
teqqatta¦rpoq	V	–nngilaq
teqqiaki¦ppoq	V	–nngilaq
teqqial¦ik	N	{–iup, –lip, –lup}, –lit
teqqi¦aq	N	–ssap, –ssat
teqqiart¦ooq	N	–uup, –uut
teqqiassari¦ppoq	V	–nngilaq
teqqiinngaa¦voq	V	–nngilaq
teqqiinngani¦ppoq	V	–nngilaq
teqqiinnga¦q	N	–p, –t
teqqiinngari¦ppoq	V	–nngilaq
teqqiss¦erpoq	V	–inngilaq
teraa¦rpoq	V	–nngilaq
teraartunngu¦aq	N	–up, –it
teriaa¦raq	N	–qqap, –qqat
teriaasa¦q	N	–p, –t
teriani¦ppoq	V	–nngilaq
terianneernia¦rpoq	V	–nngilaq
terianngu¦aq	N	–up, –it
terianniaarnia¦rpoq	V	–nngilaq
terianniaa¦rpoq	V	–nngilaq
terianniaasa¦q	N	–p, –t
terianni¦aq	N	{–ap, –ssap}, {–at, –ssat}
terianniara¦q	N	–p, –t
terianniarnia¦q	N	–p, –t
terianniarnia¦rpoq	V	–nngilaq
teriannia¦rpoq	V	–nngilaq
teri¦aq	N	–ssap, –ssat
teriarsu¦aq	N	–up, –it
teriillisima¦voq	V	–nngilaq
terii¦ppoq	V	–nngilaq
terilli¦voq	V	–nngilaq
teri¦ppoq	V	–nngilaq
teritt¦oq	N	–up, –ut
teri¦ttoq	N	{–ssup, –ttup}, {–ssut, –ttut}
terittunngu¦aq	N	–up, –it
teri¦ttunnguaq	N	{–ssunnguup, –ttunnguup}, {–ssunnguit, –ttunnguit}
terlar¦orpoq	V	–unngilaq
terlarorsa¦rpaa	V	–nngilaa
terlarorsima¦voq	V	–nngilaq
terlarorti¦ppaa	V	–nngilaa
terlaruukkiart¦orpaa	V	–unngilaa
terlaruu¦ppaa	V	–tinngilaa
terlassii¦vaa	V	–nngilaa
terligaa¦rpoq	V	–nngilaq
terli¦k	N	{–ngup, –up}, {–it, –ngit}
terlikkajuppoq	V	(no generation)
terlinganeeri¦voq	V	{–nngilaq, –nninngilaq}
terlingan¦eerpaa	V	–iinngilaa
terli¦ppoq	V	–nngilaq
terlisaari¦voq	V	–nngilaq
terlisaa¦rpaa	V	–nngilaa
terlissu¦aq	N	–up, –it
terlitt¦oq	N	–up, –ut
terli¦ttoq	N	{–ssup, –ttup}, {–ssut, –ttut}
terpentiina	N	–p, –t
testamentili¦orpoq	V	–unngilaq
Testamentitaa¦q	N	–p, –t
testamentitaa¦q	N	–p, –t
Testamentitoqa¦q	N	–p, –t
testamentitoqa¦q	N	–p, –t
Thailandim¦eersoq	N	{–eersup, –eertup, –inngaanneersup, –inngaanneertup}, {–eersut, –eertut, –inngaanneersut, –inngaanneertut}
Thailandimioq	N	(no generation)
Thailand¦imiu	N	{–ermiup, –imiup}, {–ermiut, –imiut}
The Fast Runner	Prop	–ip
The Green Land	Prop	–ip
Thule	Prop	–p, –t
Thule¦miu	N	{–miup, –rmiup}, {–miut, –rmiut}
tiaavulu	N	–p, –t
tiakataa¦voq	V	–nngilaq
Tibetim¦eersoq	N	{–eersup, –eertup, –inngaanneersup, –inngaanneertup}, {–eersut, –eertut, –inngaanneersut, –inngaanneertut}
Tibetimioq	N	(no generation)
Tibet¦imiu	N	{–ermiup, –imiup}, {–ermiut, –imiut}
tiffaallatsi¦ppaa	V	–nngilaa
tiffaa¦ppaa	V	–tinngilaa
tiffaa¦voq	V	–nngilaq
tiffarfi¦k	N	–up, –it
tiffa¦rpaa	V	–nngilaa
tiffa¦rpoq	V	–nngilaq
tiffartaa¦rpoq	V	–nngilaq
tiffarteri¦voq	V	–nngilaq
tiffarteru¦ppaa	V	–tinngilaa
tiffas¦eq	N	–ip, –it
tiffasia¦rpoq	V	–nngilaq
tiffasinneru¦voq	V	–nngilaq
tiffasi¦ppoq	V	–nngilaq
tiffasissumii¦ppoq	V	–nngilaq
tiffasi¦ssumiippoq	V	{–ssumiinngilaq, –ttumiinngilaq}
tiffikuju¦ppoq	V	–nngilaq
tiffualla¦ppoq	V	–nngilaq
tiffua¦rpaa	V	–nngilaa
tiffu¦ppoq	V	–tinngilaq
tiffutsi¦ppaa	V	–nngilaa
tiffut¦sippaa	V	{–inngilaa, –sinngilaa}
tiffuttorsuu¦voq	V	–nngilaq
tiffuttorsu¦uvoq	V	{–aanngilaq, –unngilaq}
tiggaa¦voq	V	–nngilaq
tigga¦k	N	–ap, –at
tiggalialiorfi¦k	N	–up, –it
tiggaliamine¦q	N	–rup, –rit
tiggaliam¦ineq	N	–ernup, –ernit
tiggalia¦q	N	–p, –t
tigganni¦ppoq	V	–nngilaq
tiggorli¦orpaa	V	–unngilaa
tiggorlu¦ppaa	V	–nngilaa
tiggorluttaanna¦rpaa	V	–nngilaa
tigguallappoq	V	(no generation)
tiggueeru¦ppoq	V	–tinngilaq
tiggunne¦q	N	–rup, –rit
tiggunnerit	N, pl.	-
tiggu¦ppaa	V	{–nngilaa, –tinngilaa}
tiggu¦ppoq	V	–tinngilaq
tiggussi¦voq	V	–nngilaq
tiggu¦ssivoq	V	{–ssinngilaq, –tsinngilaq}
tigooqqaa¦voq	V	–nngilaq
tigooraaginnalerne¦q	N	–rup, –rit
tigooraas¦oq	N	–up, –ut
tigooraa¦voq	V	–nngilaq
tig¦oorpaa	V	–uunngilaa
tigoria¦rpaa	V	–nngilaa
tigorloqqus¦erpoq	V	–inngilaq
tigorloqqu¦serpoq	V	{–sinngilaq, –tilinngilaq}
tigorloqqut	N	–ip, –it
tigorloqqutaa¦rpoq	V	–nngilaq
tigorpallassavaa	V	(no generation)
tigoruloorpaa	V	(no generation)
tigorulu¦ppaa	V	–nngilaa
tigu¦aa	V	–nngilaa
tiguaajua¦rpoq	V	–nngilaq
tiguaane¦q	N	–rup, –rit
tiguaas¦oq	N	–up, –ut
tiguaasorsu¦aq	N	–up, –it
tiguaa¦voq	V	–nngilaq
tigua¦gaq	N	–kkap, –kkat
tigua¦rpaa	V	–nngilaa
tiguarterujussuarfiginninne¦q	N	–rup, –rit
tiguartinna¦rpoq	V	–nngilaq
tiguarti¦ttoq	N	{–ttup, –ssup}, {–ttut, –ssut}
tigugaluarniarpaa	V	(no generation)
tigujuma¦vaa	V	–nngilaa
tigulaa¦gaq	N	–kkap, –kkat
tigulaagaqa¦rpoq	V	–nngilaq
tigulaagassa¦q	N	–p, –t
tig¦uleq	N	{–orlup, –ulip}, {–orlit, –ulit}
tigullattaakkat	N, pl.	-
tigulloqqus¦erpaa	V	–inngilaa
tigulloqqu¦serpaa	V	{–sinngilaa, –tilinngilaa}
tigulloqqusiu¦ppaa	V	–tinngilaa
tigulloqqu¦siuppaa	V	{–siutinngilaa, –tiliutinngilaa}
tigulloqqut	N	–ip, –it
tigullua¦rpaa	V	–nngilaa
tigumasut	N, pl.	-
tigumat¦ooq	N	–uup, –uut
tigumatoorsu¦aq	N	–up, –it
tigumatuneru¦voq	V	–nngilaq
tigumatu¦voq	V	–nngilaq
tiguma¦voq	V	–nngilaq
tigumiaaru¦ppoq	V	–tinngilaq
tigumiagaa¦voq	V	–nngilaq
tigumia¦gaq	N	–kkap, –kkat
tigumiagaqa¦rpoq	V	–nngilaq
tigumia¦q	N	–p, –t
tigumiaqa¦rpoq	V	–nngilaq
tigumiaqart¦oq	N	–up, –ut
tigumiarfi¦k	N	–up, –it
tigumia¦rpaa	V	–nngilaa
tigumia¦rpoq	V	–nngilaq
tigumiarta¦gaq	N	–kkap, –kkat
tigumiart¦oq	N	–up, –ut
tigumiartuu¦voq	V	–nngilaq
tigum¦isserpaa	V	{–ialinngilaa, –issinngilaa, –missinngilaa}
tigumi¦sserpoq	V	{–alinngilaq, –ssinngilaq}
tigumi¦ssersorpaa	V	{–alersunngilaa, –ssersunngilaa}
tigumi¦ssersorpoq	V	{–alersunngilaq, –ssersunngilaq}
tigumiukkuma¦vaa	V	–nngilaa
tigumiu¦ppaa	V	–tinngilaa
tigumiussi¦voq	V	–nngilaq
tigummia¦rpaa	V	–nngilaa
tigummiarpassuaqa¦rpoq	V	–nngilaq
tigummiarta¦gaq	N	–kkap, –kkat
tigummigallagassanngortinneqarne¦q	N	–rup, –rit
tigummigallagassanngorti¦ppaa	V	–nngilaa
tigummigallagassanngortita¦q	N	–p, –t
tigummigallagassanngortitsine¦q	N	–rup, –rit
tigummigalla¦rpaa	V	–nngilaa
tigummigallassavaa	V	(no generation)
tigummineqarallassaaq	V	(no generation)
tigummisaa¦voq	V	–nngilaq
tigummisa¦q	N	–p, –t
tigummisaqalerne¦q	N	–rup, –rit
tigummisarinninne¦q	N	–rup, –rit
tigummis¦oorpaa	V	–uunngilaa
tigummiunnaa¦rpaa	V	–nngilaa
tigummi¦vaa	V	–nngilaa
tigummivigi¦ppoq	V	–nngilaq
tigummivi¦k	N	–up, –it
tigummiviki¦ppoq	V	–nngilaq
tigummivil¦erpaa	V	–inngilaa
tiguneqarne¦q	N	–rup, –rit
tiguneqa¦rpoq	V	–nngilaq
tiguniaraluarniarpaa	V	(no generation)
tigunia¦rpaa	V	–nngilaa
tigusaane¦q	N	–rup, –rit
tigusaasimane¦q	N	–rup, –rit
tigusaasimas¦oq	N	–up, –ut
tigusaasi¦orpaa	V	–unngilaa
tigusaasi¦orpoq	V	–unngilaq
tigusaa¦siorpoq	V	{–siunngilaq, –tiliunngilaq}
tigusaas¦oq	N	–up, –ut
tigusaat	N	–ip, –it
tigusaa¦voq	V	–nngilaq
tigusallaqqi¦ppoq	V	–nngilaq
tigusa¦q	N	–p, –t
tigusar¦aa	V	–inngilaa
tigusarfi¦k	N	–up, –it
tigusarineqa¦rpoq	V	–nngilaq
tigusarineqart¦oq	N	–up, –ut
tigusarinninne¦q	N	–rup, –rit
tigusa¦rpaa	V	–nngilaa
tigusiffigineqarsimas¦oq	N	–up, –ut
tigusine¦q	N	–rup, –rit
tigusiniartarne¦q	N	–rup, –rit
tigusisart¦oq	N	–up, –ut
tigusisinnaassu¦seq	N	–tsip, –tsit
tigusisinnaatitaane¦q	N	–rup, –rit
tigusisussa¦q	N	–p, –t
tigusi¦voq	V	–nngilaq
tigusor¦aaq	V	–inngilaq
tigusornarsi¦voq	V	–nngilaq
tigussaanngilaq	V	(no generation)
tigussaanngits¦oq	N	–up, –ut
tigussaas¦oq	N	–up, –ut
tigussaats¦oq	N	–up, –ut
tigussamaa¦rpaa	V	–nngilaa
tigussukarne¦q	N	–rup, –rit
tigussuka¦rpoq	V	–nngilaq
tiguti¦ppaa	V	–nngilaa
tigutsiaanna¦q	N	–ap, –at
tigutsikkuma¦vaa	V	–nngilaa
tigutsi¦ppaa	V	–tinngilaa
tigutsisil¦ik	N	{–iup, –lip, –lup}, –lit
tigutsisillit	N, pl.	-
tigutsissi¦voq	V	–nngilaq
tigutsi¦t	N	–sip, –sit
tii	N	–p, –t
tiia¦rpaa	V	–nngilaa
tiiarut	N	–ip, –it
tiiga¦rpaa	V	–nngilaa
tiigarut	N	–ip, –it
tiigereq	N	(no generation)
tiigerersuaq	N	(no generation)
tiigeri	N	(no generation)
tiigeriaraq	N	(no generation)
tiikut	N, pl.	-
Ti¦ilerilaaq	Prop	{–ilerilaap, –niteqilaap}
tiili¦orpoq	V	–unngilaq
tiiliutaasa¦rpoq	V	–nngilaq
tiiliutaa¦voq	V	–nngilaq
tiilivi¦k	N	–up, –it
tiilivittaa¦rpoq	V	–nngilaq
tiilluinna¦rpoq	V	–nngilaq
tiimi	N	–p, –t
tiingagaju¦ppoq	V	–nngilaq
tiingal¦erpoq	V	–inngilaq
tiingane¦q	N	–rup, –rit
tiinganiakujuffigineqarne¦q	N	–rup, –rit
tiingarut	N	–ip, –it
tiingat¦ooq	N	–uup, –uut
tiinga¦voq	V	–nngilaq
tiinnga¦rpoq	V	–nngilaq
tiinngart¦ooq	N	–uup, –uut
tiinngartoorsu¦aq	N	–up, –it
tiinngat	N	–ip, –it
tiinngatig¦aa	V	–inngilaa
tiipakusu¦ppoq	V	–nngilaq
tiiporti	N	–p, –t
tii¦ppoq	V	–nngilaq
tiiskorsu¦aq	N	–up, –it
tiit	N, pl.	-
ti¦it	Num, pl.	–t
tiitoqatigiiffi¦k	N	–up, –it
tiitoqatigiinne¦q	N	–rup, –rit
tiitorfi¦k	N	–up, –it
tiitorfilivi¦k	N	–up, –it
tiitorfissi¦voq	V	–nngilaq
tiit¦orpoq	V	–unngilaq
tiitortaannarpoq	V	(no generation)
tikaagulli¦k	N	–up, –it
tikaagullittassat	N, pl.	-
tikaagulliusaa¦q	N	–p, –t
tikaagulliusaarna¦q	N	–p, –t
tikaagulliusaartassat	N, pl.	-
tikaagulliusa¦q	N	–p, –t
tikaagus¦erpaa	V	–inngilaa
tikaagu¦serpaa	V	{–sinngilaa, –tilinngilaa}
tikaagut	N	–ip, –it
tikaagutil¦ik	N	{–iup, –lip, –lup}, –lit
tik¦eq	N	{–erup, –ip}, {–erit, –it}
tikeqqaa¦q	N	–p, –t
tikeqqaarliut	N	–ip, –it
tikeqqaarluusi¦orpoq	V	–unngilaq
tikeqqaarluu¦siorpoq	V	{–siunngilaq, –tiliunngilaq}
tikeqqaarluut	N	–ip, –it
tikeqqaarluut	N, pl.	-
tikeqqaa¦rpoq	V	–nngilaq
tikeqqaasi¦orpaa	V	–unngilaa
tikeqqaat	N	–ip, –it
tikeqqaat	N, pl.	-
tikeqqaataa¦voq	V	–nngilaq
tikeqqamm¦eq	N	–ip, –it
tikeqqamm¦erpoq	V	–inngilaq
tikeqqarpoq	V	(no generation)
tikeqq¦oq	N	–up, –ut
tikeraa¦q	N	–p, –t
tikeraarfig¦aa	V	–inngilaa
tikeraarne¦q	N	–rup, –rit
tikeraa¦rpaa	V	–nngilaa
tikeraa¦rpoq	V	–nngilaq
tikeraarsaa¦voq	V	–nngilaq
tikeraarsa¦rpaa	V	–nngilaa
tikeraarti	N	–p, –t
tikeraartig¦aa	V	–inngilaa
tikeraarti¦ppaa	V	–nngilaa
tikeraartitsi¦voq	V	–nngilaq
tikeraart¦oq	N	–up, –ut
tikeraartoqajui¦ppoq	V	–nngilaq
tikeraassaa¦rpoq	V	–nngilaq
tikeraassaarsima¦voq	V	–nngilaq
tikerlaa¦q	N	–p, –t
tikers¦orpaa	V	–unngilaa
tikers¦orpoq	V	–unngilaq
tiker¦sorpoq	V	{–sunngilaq, –tunngilaq}
tikersuu¦ppaa	V	–tinngilaa
tikersuussi¦voq	V	–nngilaq
tikiaallu¦voq	V	–nngilaq
tikiallappoq	V	(no generation)
tikiffi¦k	N	–up, –it
tikiffilerut	N	–ip, –it
tikikkaluttuarpaa	V	(no generation)
tikikkiartorniarpoq	V	(no generation)
tikikkiart¦orpaa	V	–unngilaa
tikikkiart¦orpoq	V	–unngilaq
tikikkiartorsimagaluarpoq	V	(no generation)
tikikkiartorsinnaassavaa	V	(no generation)
tikikkiartorunnaarpaa	V	(no generation)
tikikkiartorunnaarsinneqa¦rpoq	V	–nngilaq
tikikkiartorunnaarsi¦ppaa	V	–nngilaa
tikikkiartorusaaginnarpoq	V	(no generation)
tikikkiartorusaarpoq	V	(no generation)
tikikkiartuaarneqa¦rpoq	V	–nngilaq
tikikkiartuinnal¦erpaa	V	–inngilaa
tikikkiartuinnalersima¦voq	V	–nngilaq
tikikkiartuinnarpaa	V	(no generation)
tikikkiartulerpoq	V	(no generation)
tikikkiartulersimavoq	V	(no generation)
tikikkiartunngilaq	V	(no generation)
tikikkiartupiloorpoq	V	(no generation)
tikikkiartupiloorsimavoq	V	(no generation)
tikikkiartussanerpaa	V	(no generation)
tikikkumaarnertu¦voq	V	–nngilaq
tikikkumagaluaqaa	V	(no generation)
tikikkumagaluaqaaq	V	(no generation)
tikikkumagaluarpaa	V	(no generation)
tikikkuma¦voq	V	–nngilaq
tikikkuminaats¦oq	N	–up, –ut
tikikkuminaatsuu¦voq	V	–nngilaq
tikikkuminartuu¦voq	V	–nngilaq
tikikummi	N	–p, –t
tikilasoorne¦q	N	–rup, –rit
tikilasorsuu¦voq	V	–nngilaq
tikilasorsu¦uvoq	V	{–aanngilaq, –unngilaq}
tikila¦voq	V	–nngilaq
tikileralua¦rpoq	V	–nngilaq
tikilermioq	V	(no generation)
tikilinnguatsiarpaa	V	(no generation)
tikillaasorsuu¦voq	V	–nngilaq
tikillaasorsu¦uvoq	V	{–aanngilaq, –unngilaq}
tikillaa¦voq	V	–nngilaq
tikilluaqquaa	V	(no generation)
tikilluaqqusaa¦voq	V	–nngilaq
tikilluaqqusiart¦orpoq	V	–unngilaq
tikilluaqqusine¦q	N	–rup, –rit
tikilluaqqusi¦voq	V	–nngilaq
tikillua¦rpoq	V	–nngilaq
tikinnaveersaartarpaa	V	(no generation)
tikinne¦q	N	–rup, –rit
tikinneqarsinnaas¦oq	N	–up, –ut
tikinngitsoorpoq	V	(no generation)
tikinniarfi¦k	N	–up, –it
tiki¦ppaa	V	–nngilaa
tiki¦ppoq	V	–nngilaq
tikisa¦q	N	–p, –t
tikisart¦orpoq	V	–unngilaq
tikisar¦torpoq	V	{–sunngilaq, –tunngilaq}
tikiseqqa¦voq	V	–nngilaq
tikiseri¦voq	V	–nngilaq
tikis¦erpaa	V	–inngilaa
tikiserpallaaqaa	V	(no generation)
tikisertuarpaa	V	(no generation)
tikisikkiart¦orpoq	V	–unngilaq
tiki¦sikkiartorpoq	V	{–sikkiartunngilaq, –tikkiartunngilaq, –tsikkiartunngilaq}
tikisi¦ppoq	V	–nngilaq
tiki¦sitaq	N	{–sitap, –titap, –tsitap}, {–sitat, –titat, –tsitat}
tikitsiigaju¦ppoq	V	–nngilaq
tikitsiiua¦rpoq	V	–nngilaq
tikitsii¦vaa	V	–nngilaa
tikitsii¦voq	V	–nngilaq
tiki¦tsilluarpoq	V	{–silluanngilaq, –tilluanngilaq, –tsilluanngilaq}
tikitsisaanna¦rpoq	V	–nngilaq
tikitsi¦voq	V	–nngilaq
tikittunnguujuu¦aa	V	–nngilaa
tikiuisaa¦voq	V	–nngilaq
tikiuisaminuka¦rpoq	V	–nngilaq
tikiuisa¦q	N	–p, –t
tikiukkiart¦orpaa	V	–unngilaa
tikiukkiart¦orpoq	V	–unngilaq
tikiumisaartitsi¦voq	V	–nngilaq
tikiu¦ppaa	V	–tinngilaa
tikiu¦ppoq	V	–tinngilaq
tikiusaani¦ppoq	V	–nngilaq
tikiusaa¦q	N	–p, –t
tikiusaaqaqaaq	V	(no generation)
tikiussaa¦voq	V	–nngilaq
tikiussa¦q	N	–p, –t
tikiussine¦q	N	–rup, –rit
tikiussi¦voq	V	–nngilaq
tikiutt¦oq	N	–up, –ut
tikivi¦ppaa	V	–nngilaa
tikkeru¦ppoq	V	–tinngilaq
tikkerusa¦rpaa	V	–nngilaa
tikkivi¦k	N	–up, –it
tikkoqqissaa¦rpoq	V	–nngilaq
tikkorlua¦rpoq	V	–nngilaq
tikk¦orpoq	V	–unngilaq
tikkorti¦ppaa	V	–nngilaa
tikkuaane¦q	N	–rup, –rit
tikkuaa¦voq	V	–nngilaq
tikkuagaa¦voq	V	–nngilaq
tikkua¦gaq	N	–kkap, –kkat
tikkua¦rpaa	V	–nngilaa
tikkua¦rpoq	V	–nngilaq
tikkuarsima¦voq	V	–nngilaq
tikkuartaas¦erpoq	V	–inngilaq
tikkuartaa¦serpoq	V	{–sinngilaq, –tilinngilaq}
tikkuartaat	N	–ip, –it
tikkuartuu¦ppaa	V	–tinngilaa
tikkuartuut	N	–ip, –it
tikkuinna¦rpoq	V	–nngilaq
tikkuinnarsima¦voq	V	–nngilaq
tikkummi	N	–p, –t
tikkungavoq	V	(no generation)
tikkuullua¦rpaa	V	–nngilaa
tikkuu¦ppaa	V	–tinngilaa
tikkuussinnaa¦vaa	V	–nngilaa
tikkuussi¦voq	V	–nngilaq
tikkuuss¦orpaa	V	–unngilaa
tikkuussui¦voq	V	–nngilaq
tikkuut	N	–ip, –it
tikkuutaasa¦q	N	–p, –t
tila¦ppoq	V	–nngilaq
tili¦aq	N	–ssap, –ssat
tili¦oq	N	–up, –ut
tilior¦aa	V	–inngilaa
tiliortaa¦rpoq	V	–nngilaq
tili¦vaa	V	–nngilaa
tilleeru¦ppoq	V	–tinngilaq
tilleerutinngilaq	V	(no generation)
tilleerutta¦rpoq	V	–nngilaq
tille¦q	N	–rup, –rit
tilleqanngilaq	V	(no generation)
tilleqanngits¦oq	N	–up, –ut
tilleqa¦rpoq	V	–nngilaq
tillerne¦q	N	–rup, –rit
tillerpallaaqaaq	V	(no generation)
till¦erpoq	V	–inngilaq
tillersi¦orpaa	V	–unngilaa
tillersiui¦voq	V	–nngilaq
tillert¦oq	N	–up, –ut
tiller¦toq	N	{–sup, –tup}, {–sut, –tut}
tillerulukkunnaa¦rpoq	V	–nngilaq
tillerulu¦ppoq	V	–nngilaq
tillerulutsitsi¦voq	V	–nngilaq
tilli	N	–p, –t
tilliffig¦aa	V	–inngilaa
tilliffiginninne¦q	N	–rup, –rit
tilliffigitissimas¦oq	N	–up, –ut
tilligaa¦voq	V	–nngilaq
tilli¦gaq	N	–kkap, –kkat
tilligassarsi¦orpoq	V	–unngilaq
tilligu¦ppoq	V	–nngilaq
tillikilliart¦orpoq	V	–unngilaq
tillikilli¦voq	V	–nngilaq
tilliki¦ppoq	V	–nngilaq
tillikkaj¦ooq	N	–uup, –uut
tillikkajuppoq	V	(no generation)
tillikuju¦ppoq	V	–nngilaq
tilling¦erpoq	V	–inngilaq
tillingia¦rpaa	V	–nngilaa
tillingia¦rpoq	V	–nngilaq
tillingiart¦orpoq	V	–unngilaq
tillingiartuut	N	–ip, –it
tillini¦ppoq	V	–nngilaq
tillinne¦q	N	–rup, –rit
tillinnia¦q	N	–p, –t
tillinniarne¦q	N	–rup, –rit
tillinnia¦rpoq	V	–nngilaq
tillinniartart¦oq	N	–up, –ut
tillinniart¦oq	N	–up, –ut
tilli¦ppaa	V	–nngilaa
tilli¦ppoq	V	–nngilaq
tillisiut	N	–ip, –it
tillita¦q	N	–p, –t
tillit¦ooq	N	–uup, –uut
tillitt¦oq	N	–up, –ut
tilloria¦rpaa	V	–nngilaa
tilluaa¦voq	V	–nngilaq
tillua¦rpaa	V	–nngilaa
tilluarti¦ppoq	V	–nngilaq
tillugaa¦voq	V	–nngilaq
tillu¦gaq	N	–kkap, –kkat
tilluinert¦ooq	N	–uup, –uut
tilluiumat¦ooq	N	–uup, –uut
tillui¦voq	V	–nngilaq
tillunne¦q	N	–rup, –rit
tillu¦ppaa	V	–nngilaa
tillu¦ppoq	V	–nngilaq
tilluunne¦q	N	–rup, –rit
tilluunnersu¦aq	N	–up, –it
tilluusani¦ppoq	V	–nngilaq
tilluusa¦q	N	–p, –t
tilluusarne¦q	N	–rup, –rit
tilluusa¦rpoq	V	–nngilaq
tilluusarti¦ppaa	V	–nngilaa
tilluusart¦oq	N	–up, –ut
tilluuttart¦oq	N	–up, –ut
tilu¦ppaa	V	–nngilaa
tilu¦ppoq	V	–nngilaq
tilutt¦orpaa	V	–unngilaa
tilutt¦orpoq	V	–unngilaq
tiluttu¦gaq	N	–kkap, –kkat
tiluttui¦voq	V	–nngilaq
tiluttuus¦erpoq	V	–inngilaq
tiluttuu¦serpoq	V	{–sinngilaq, –tilinngilaq}
tiluttuut	N	–ip, –it
timaajagarsiort¦oq	N	–up, –ut
timaannaanii¦ppoq	V	–nngilaq
timaannaa¦voq	V	–nngilaq
timaanna¦q	N	–ap, –at
timaa¦ppaa	V	–tinngilaa
timaatig¦oorpoq	V	–uunngilaq
tim¦aatigoorpoq	V	{–aaguunngilaq, –aatiguunngilaq, –iatiguunngilaq}
timang¦erpaa	V	–inngilaa
timangersima¦vaa	V	–nngilaa
timangers¦orpaa	V	–unngilaa
timangersui¦voq	V	–nngilaq
timangiukkiart¦orpoq	V	–unngilaq
timangiu¦ppoq	V	–tinngilaq
timangiuter¦eerpoq	V	–iinngilaq
time	N	(no generation)
timeqanngilaq	V	(no generation)
timeqa¦rpoq	V	–nngilaq
timerl¦eq	N	–iup, –iit
timerpa¦rpoq	V	–nngilaq
timerpasi¦ppoq	V	–nngilaq
timerpasiss¦oq	N	–up, –ut
timerpasi¦ssoq	N	{–ssup, –ttup}, {–ssut, –ttut}
timersoqatigiiffiit	N, pl.	-
timersoqatigiiffi¦k	N	–up, –it
timersorne¦q	N	–rup, –rit
timers¦orpoq	V	–unngilaq
timersortarfi¦k	N	–up, –it
timersortart¦oq	N	–up, –ut
timersortartut	N, pl.	-
timersuut	N	–ip, –it
timersuut	N, pl.	-
timersuutit	N, pl.	-
timi	N	–p, –t
timigissarne¦q	N	–rup, –rit
timigi¦ssarneq	N	{–ssarnerup, –ttarnerup}, {–ssarnerit, –ttarnerit}
timigissa¦rpoq	V	–nngilaq
timigi¦ssarpoq	V	–ttanngilaq
timigissartarfi¦k	N	–up, –it
timigissartarne¦q	N	–rup, –rit
timigissartart¦oq	N	–up, –ut
timigi¦ssuuvoq	V	{–ssuunngilaq, –ttuunngilaq}
timil¦eq	N	–ip, –it
timitaaru¦ppoq	V	–tinngilaq
timital¦erpaa	V	–inngilaa
timitalii¦voq	V	–nngilaq
timital¦ik	N	{–iup, –lip, –lup}, –lit
timita¦q	N	–p, –t
timitaqanngits¦oq	N	–up, –ut
timitarsi¦vaa	V	–nngilaa
timitartaa¦rpoq	V	–nngilaq
timits¦erpaa	V	–inngilaa
timitsiu¦ppaa	V	–tinngilaa
timiusaat	N	–ip, –it
timiusaateqa¦rpoq	V	–nngilaq
timiusa¦q	N	–p, –t
timiusart¦orpoq	V	–unngilaq
timiusar¦torpoq	V	{–sunngilaq, –tunngilaq}
timiusat	N, pl.	-
timiusia¦q	N	–p, –t
timiusiassat	N, pl.	-
timiusiorfi¦k	N	–up, –it
timiu¦siorfik	N	{–siorfiup, –tiliorfiup}, {–siorfiit, –tiliorfiit}
timiusi¦orpoq	V	–unngilaq
timiu¦siorpoq	V	{–siunngilaq, –tiliunngilaq}
timiusiort¦oq	N	–up, –ut
timiu¦siortoq	N	{–siortup, –tiliortup}, {–siortut, –tiliortut}
timmeqularuju¦ppoq	V	–nngilaq
timmequla¦voq	V	–nngilaq
timmeralaa¦q	N	–p, –t
timmeralaa¦rpoq	V	–nngilaq
timmeralaartuarpoq	V	(no generation)
timmeralajua¦rpoq	V	–nngilaq
timmeralasaanna¦rpoq	V	–nngilaq
timmerala¦voq	V	–nngilaq
timmeralla¦ppoq	V	–nngilaq
timmerallatsi¦ppaa	V	–nngilaa
timmerallatta¦rpoq	V	–nngilaq
timmiaaluppassuit	N, pl.	-
timmiaaqqat	N, pl.	-
timmiaarakasi¦k	N	–up, –it
timmiaat	N	–ip, –it
timmiaatit	N, pl.	-
timmiakulu¦k	N	–up, –it
timmial¦erpoq	V	–inngilaq
timmialisaa¦rpoq	V	–nngilaq
timmiani¦ppoq	V	–nngilaq
timmianngu¦aq	N	–up, –it
timmi¦aq	N	–ssap, –ssat
timmiarsi¦ooq	N	–uup, –uut
timmiarsiut	N	–ip, –it
timmiaruj¦ooq	N	–uup, –uut
timmiarussat	N, pl.	-
timmi¦k	N	–up, –it
timminiki¦ppoq	V	–nngilaq
timminne¦q	N	–rup, –rit
timmioraa¦rpoq	V	–nngilaq
timmi¦ppoq	V	–nngilaq
timmisart¦oq	N	–up, –ut
timmisartoqarfiit	N, pl.	-
timmisartoqarfi¦k	N	–up, –it
timmisartorfig¦aa	V	–inngilaa
timmisartorne¦q	N	–rup, –rit
timmisartorniutit	N, pl.	-
timmisart¦orpoq	V	–unngilaq
timmisartorsu¦aq	N	–up, –it
timmisartortart¦oq	N	–up, –ut
timmisartortit¦seqatigiiffik	N	{–seqatigiiffiup, –eqatigiiffiup}, {–seqatigiiffiit, –eqatigiiffiit}
timmisartortit¦seqatigiit	N, pl.	{–seqatigiit, –eqatigiit}
timmisartukkoortitat	N, pl.	-
timmisartuusaarne¦q	N	–rup, –rit
timmisartuussinerit	N, pl.	-
timmisartuu¦tileqatigiiffik	N	{–seqatigiiffiup, –tileqatigiiffiup, –tsileqatigiiffiup}, {–seqatigiiffiit, –tileqatigiiffiit, –tsileqatigiiffiit}
timmisartuu¦tileqatigiiffik	N	{–tileqatigiiffiup, –seqatigiiffiup}, {–tileqatigiiffiit, –seqatigiiffiit}
timmis¦oq	N	–up, –ut
timmisornia¦rpoq	V	–nngilaq
timmis¦orpaa	V	–unngilaa
timmis¦orpoq	V	–unngilaq
timmisorta¦q	N	–p, –t
timmissat	N, pl.	-
timmissu¦ppaa	V	–tinngilaa
timmisui¦voq	V	–nngilaq
timmiua¦rpoq	V	–nngilaq
timmi¦voq	V	–nngilaq
timm¦oorpoq	V	–uunngilaq
tim¦moorpoq	V	{–imuunngilaq, –muunngilaq}
tim¦moortuarpoq	V	{–imoortuanngilaq, –moortuanngilaq}
timmukaa¦ppaa	V	–tinngilaa
tim¦mukaappaa	V	{–imukaatinngilaa, –mukaatinngilaa}
timmukaa¦rpoq	V	–nngilaq
timmukaattuarpaa	V	(no generation)
timmuka¦rpoq	V	–nngilaq
tim¦mukarpoq	V	{–imukanngilaq, –mukanngilaq}
timmukarti¦ppaa	V	–nngilaa
tim¦mukartippaa	V	{–imukartinngilaa, –mukartinngilaa}
timmukartuarsinnarpoq	V	(no generation)
tineqqajunnaarpoq	V	(no generation)
tineqqal¦erpoq	V	–inngilaq
tinerujussuarne¦q	N	–rup, –rit
tinerujussua¦rpoq	V	–nngilaq
tineruloorne¦q	N	–rup, –rit
tinerutt¦orpoq	V	–unngilaq
tineruttorsima¦voq	V	–nngilaq
tingaasat	N, pl.	-
tingaju¦k	N	–up, –it
ting¦eq	N	–ip, –it
tingeqanngilaq	V	(no generation)
tingeqqaa¦q	N	–p, –t
tingerlaa¦q	N	–p, –t
tingerlaas¦erpoq	V	–inngilaq
tingerlaa¦serpoq	V	{–sinngilaq, –tilinngilaq}
tingerlaasers¦orpoq	V	–unngilaq
tingerlaa¦sersorpoq	V	{–sersunngilaq, –tilersunngilaq}
tingerlaasiuut	N	–ip, –it
tingerlaat	N	–ip, –it
tingerlaat	N, pl.	-
tingerlaataajaa¦rpoq	V	–nngilaq
tingerlaataannal¦ik	N	{–iup, –lip, –lup}, –lit
tingerlaataa¦rpoq	V	–nngilaq
tingerlaatissia¦q	N	–p, –t
tingert¦ooq	N	–uup, –uut
tingikkallanngilaq	V	(no generation)
tinginaveeqqut	N	–ip, –it
tingine¦q	N	–rup, –rit
tinginnavianngilaa	V	(no generation)
tingi¦ppaa	V	–nngilaa
tingi¦ppoq	V	–nngilaq
tingisaanna¦rpoq	V	–nngilaq
tingisart¦oq	N	–up, –ut
tingisi¦vaa	V	–nngilaa
tingisoorti¦ppaa	V	–nngilaa
tingisuernia¦rpoq	V	–nngilaq
tingisui	N	–p, –t
tingit	N, pl.	-
tingitaasima¦voq	V	–nngilaq
tingitaavi¦ppoq	V	–nngilaq
tingitaa¦voq	V	–nngilaq
tingita¦q	N	–p, –t
tingiti¦ppaa	V	–nngilaa
tingititsi¦voq	V	–nngilaq
tingi¦voq	V	–nngilaq
tingu¦k	N	–up, –it
tingulaa¦q	N	–p, –t
tingulaat	N, pl.	-
tingulia¦q	N	–p, –t
tingutta¦k	N	–ap, –at
tingutta¦q	N	–p, –t
tingutt¦ooq	N	–uup, –uut
tingutt¦orpoq	V	–unngilaq
tinguttuuttut	N, pl.	-
tinguusaa¦q	N	–p, –t
tiniimisaa¦rpoq	V	–nngilaq
tiniimisaartorsu¦uvoq	V	{–aanngilaq, –unngilaq}
tini¦imisaartorsuuvoq	V	{–imisaartorsuaanngilaq, –imisaartorsuunngilaq, –nngaanniimisaartorsuaanngilaq, –nngaanniimisaartorsuunngilaq}
tinikkiartorlualerpoq	V	(no generation)
tinikkiartorlualersimavoq	V	(no generation)
tinikkiartornavianngilaq	V	(no generation)
tinikkiartorniarpoq	V	(no generation)
tinikkiart¦orpoq	V	–unngilaq
tinikkiartorsimavoq	V	(no generation)
tinikkiartorusaarpoq	V	(no generation)
tinikkiartunngilaq	V	(no generation)
tinikkiartupiloorpoq	V	(no generation)
tinikkiartussa¦aq	V	–nngilaq
tinil¦erpoq	V	–inngilaq
tinimukaa¦q	N	–p, –t
tinimukaa¦rpoq	V	–nngilaq
tininne¦q	N	–rup, –rit
tininnersu¦aq	N	–up, –it
tininnert¦ooq	N	–uup, –uut
tininnertu¦voq	V	–nngilaq
tininngajunnaa¦rpoq	V	–nngilaq
tininngas¦oorpoq	V	–uunngilaq
tininngavallaaqaaq	V	(no generation)
tininnga¦voq	V	–nngilaq
tini¦ppoq	V	–nngilaq
Tiniteqilaa¦q	N	–p, –t
tinnaal¦erpoq	V	–inngilaq
tinnaarne¦q	N	–rup, –rit
tinnaa¦rpoq	V	–nngilaq
tinnaart¦oq	N	–up, –ut
tinneraajua¦rpoq	V	–nngilaq
tinneraasaanna¦rpoq	V	–nngilaq
tinneraa¦voq	V	–nngilaq
tinn¦erpaa	V	–inngilaa
tinnersaa¦voq	V	–nngilaq
tinnersa¦rpaa	V	–nngilaa
tinngalla¦k	N	–ap, –at
tinngalla¦ppoq	V	–nngilaq
tinngallattaarfi¦k	N	–up, –it
tinngalla¦ttaarfik	N	{–ssaarfiup, –ttaarfiup}, {–ssaarfiit, –ttaarfiit}
tinngallattaarne¦q	N	–rup, –rit
tinngalla¦ttaarneq	N	{–ssaarnerup, –ttaarnerup}, {–ssaarnerit, –ttaarnerit}
tinngallattaa¦rpoq	V	–nngilaq
tinngallatta¦rpoq	V	–nngilaq
tinnga¦ppoq	V	–nngilaq
tinngattorsuu¦voq	V	–nngilaq
tinngattorsu¦uvoq	V	{–aanngilaq, –unngilaq}
tinngivig¦aa	V	–inngilaa
tinngu¦ppaa	V	–nngilaa
tinngussaa¦voq	V	–nngilaq
tinngussi¦voq	V	–nngilaq
tinnii¦voq	V	–nngilaq
tinnu¦ppaa	V	–tinngilaa
tinoornerasaa¦rpoq	V	–nngilaq
tin¦oorpoq	V	–uunngilaq
tinoorti¦ppaa	V	–nngilaa
tinoqqa¦vaa	V	–nngilaa
tinorlusa¦k	N	–ap, –at
tinuaa¦rpoq	V	–nngilaq
tinugukkiart¦orpaa	V	–unngilaa
tinugu¦ppaa	V	–tinngilaa
tinugu¦ppoq	V	–tinngilaq
tinugussaa¦voq	V	–nngilaq
tinukutta¦q	N	–p, –t
tinumane¦q	N	–rup, –rit
tinumasut	N, pl.	-
tinuma¦voq	V	–nngilaq
tinune¦q	N	–rup, –rit
tinupaalu¦ppoq	V	–nngilaq
tinupaa¦rpoq	V	–nngilaq
tinupanaanngu¦aq	N	–up, –it
tinupane¦q	N	–rup, –rit
tinupaqattu¦k	N	–up, –it
tinupaqattuttu¦voq	V	–nngilaq
tinupaqutsu¦k	N	–up, –it
tinupas¦oq	N	–up, –ut
tinupasua¦raq	N	–qqap, –qqat
tinupasul¦ik	N	{–iup, –lip, –lup}, –lit
tinupasut	N, pl.	-
tinupa¦voq	V	–nngilaq
tinu¦ppaa	V	–tinngilaa
tinu¦ppoq	V	–tinngilaq
tinusoorne¦q	N	–rup, –rit
tinus¦oorpoq	V	–uunngilaq
tinussaa¦voq	V	–nngilaq
tinussa¦q	N	–p, –t
tinussa¦rpoq	V	–nngilaq
tinuteqasaa¦q	N	–p, –t
tinuteqisaa¦q	N	–p, –t
tinutequsaa¦q	N	–p, –t
tinuti¦ppaa	V	–nngilaa
tinut¦ippaa	V	{–inngilaa, –sinngilaa, –itinngilaa}
tinutitikkumanngilaq	V	(no generation)
tinut¦itippoq	V	{–itsinngilaq, –sitsinngilaq, –itinngilaq, –sinngilaq}
tinutsii¦vaa	V	–nngilaa
tinutta¦gaq	N	–kkap, –kkat
tinutta¦rpaa	V	–nngilaa
tinuttart¦ooq	N	–uup, –uut
tinuuaa¦rpoq	V	–nngilaq
tinu¦voq	V	–nngilaq
tipaarsaa¦voq	V	–nngilaq
tipaarsa¦rpaa	V	–nngilaa
tipaarsarti¦ppaa	V	–nngilaa
tipaarukkiart¦orpoq	V	–unngilaq
tipaaru¦ppoq	V	–tinngilaq
tipaarusa¦rpaa	V	–nngilaa
tipaatsuffi¦k	N	–up, –it
tipaatsungaarne¦q	N	–rup, –rit
tipaatsungaart¦oq	N	–up, –ut
tipaatsunna¦rpoq	V	–nngilaq
tipaatsunnart¦oq	N	–up, –ut
tipaatsunne¦q	N	–rup, –rit
tipaatsu¦ppoq	V	–nngilaq
tipaatsussu¦seq	N	–tsip, –tsit
tipaatsutsinneqaat	N	–ip, –it
tipaatsutsi¦ppaa	V	–nngilaa
tipaatsutt¦oq	N	–up, –ut
tipaatsuttunnguu¦voq	V	–nngilaq
tipaatsuussu¦aq	N	–up, –it
tipaatsuut	N	–ip, –it
tipaatsuutig¦aa	V	–inngilaa
tipaatsuutissi¦ppaa	V	–nngilaa
tipaa¦voq	V	–nngilaq
tipa¦ppoq	V	–nngilaq
tipasaa¦rpaa	V	–nngilaa
tipattuinnaa¦voq	V	–nngilaq
tipa¦voq	V	–nngilaq
tipeqanngilaq	V	(no generation)
tipeqaqaaq	V	(no generation)
tipeqa¦rpoq	V	–nngilaq
tipeqqasutoq¦aq	N	{–qap, –ap}, {–qat, –at}
tipeqqasutoq¦aq	N	–qap, –qat
tipeqqa¦voq	V	–nngilaq
tiperrusa¦ppoq	V	–nngilaq
tipersu¦aq	N	–up, –it
tipi	N	–p, –t
tipiart¦orpoq	V	–unngilaq
tipigillu¦innarpoq	V	{–aannanngilaq, –innanngilaq}
tipigi¦ppoq	V	–nngilaq
tipigissaas¦erpoq	V	–inngilaq
tipigissaa¦serpoq	V	{–sinngilaq, –tilinngilaq}
tipigi¦ssaaserpoq	V	{–ssaasinngilaq, –ssaatilinngilaq, –ttaasinngilaq, –ttaatilinngilaq}
tipigissaat	N	–ip, –it
tipigi¦ssaat	N	{–ssaatip, –ttaatip}, {–ssaatit, –ttaatit}
tipigissaavi¦k	N	–up, –it
tipigissaa¦vik	N	{–ffiup, –viup}, {–ffiit, –viit}
tipigissa¦rpaa	V	–nngilaa
tipigissa¦rpoq	V	–nngilaq
tipigi¦ssarpoq	V	–ttanngilaq
tipigissi¦voq	V	–nngilaq
tipigiss¦oq	N	–up, –ut
tipigi¦ssoq	N	{–ssup, –ttup}, {–ssut, –ttut}
tipilaa¦rpoq	V	–nngilaq
tipilukkunnaa¦rpoq	V	–nngilaq
tipilu¦ppoq	V	–nngilaq
tipilussi¦voq	V	–nngilaq
tipipalaaqa¦rpoq	V	–nngilaq
tipippallaalaa¦rpoq	V	–nngilaq
tipi¦ppoq	V	–nngilaq
tipisarne¦q	N	–rup, –rit
tipisarn¦erpoq	V	–inngilaq
tipis¦oorpoq	V	–uunngilaq
tipis¦oq	N	–up, –ut
tipit¦ooq	N	–uup, –uut
tipitoorsu¦aq	N	–up, –it
tipitoqaaq	V	(no generation)
tipitoqis¦oq	N	–up, –ut
tipitt¦oq	N	–up, –ut
tipittorsu¦uvoq	V	{–aanngilaq, –unngilaq}
tipittuutil¦ik	N	{–iup, –lip, –lup}, –lit
tipituallaa¦rpoq	V	–nngilaq
tipitunersaa¦voq	V	–nngilaq
tipitu¦voq	V	–nngilaq
tipi¦vaa	V	–nngilaa
tipi¦voq	V	–nngilaq
tippaakkaluttuinna¦rpoq	V	–nngilaq
tippaa¦ppaa	V	–tinngilaa
tippaa¦ppoq	V	–tinngilaq
tippaattorsuu¦voq	V	–nngilaq
tippaattorsu¦uvoq	V	{–aanngilaq, –unngilaq}
tippakkaluttuinna¦rpoq	V	–nngilaq
tippappallaaqaaq	V	(no generation)
tippa¦ppoq	V	–nngilaq
tippass¦erpaa	V	–inngilaa
tippatt¦oorpoq	V	–uunngilaq
tippi¦k	N	–up, –it
tippil¦erpaa	V	–inngilaa
tippilers¦orpaa	V	–unngilaa
tippilers¦orpoq	V	–unngilaq
tippissa¦q	N	–p, –t
tippivig¦aa	V	–inngilaa
tippivigisaa¦voq	V	–nngilaq
tippivigiti¦ppoq	V	–nngilaq
tippivi¦k	N	–up, –it
tippuig¦aa	V	–inngilaa
tippui¦k	N	–up, –it
tippukkiart¦orpaa	V	–unngilaa
tippu¦ppaa	V	–nngilaa
tippussaane¦q	N	–rup, –rit
tippussaa¦voq	V	–nngilaq
tippussa¦q	N	–p, –t
tipserfissa¦q	N	–p, –t
tips¦erpoq	V	–inngilaq
tisaajuteqa¦rpoq	V	–nngilaq
tisaakka¦rpaa	V	–nngilaa
tisaanna¦rpoq	V	–nngilaq
tisaa¦q	N	–p, –t
tisaaqa¦rpoq	V	–nngilaq
tisaart¦orpoq	V	–unngilaq
tisaar¦torpoq	V	{–sunngilaq, –tunngilaq}
tisallaqqi¦ppoq	V	–nngilaq
tisa¦q	N	–p, –t
tisasa¦q	N	–p, –t
tisa¦vaa	V	–nngilaa
tisa¦voq	V	–nngilaq
tis¦orpoq	V	–unngilaq
tissaa¦ppoq	V	–nngilaq
tissaats¦oq	N	–up, –ut
tissaatsuu¦voq	V	–nngilaq
tissalukaarfig¦aa	V	–inngilaa
tissalukaa¦rpaa	V	–nngilaa
tissalukaa¦rpoq	V	–nngilaq
tissalukaartaat	N	–ip, –it
tissalukaaru¦ppaa	V	–tinngilaa
tissalukaarutig¦aa	V	–inngilaa
tissalu¦ppoq	V	–nngilaq
tissaluttaat	N	–ip, –it
tissalutt¦oq	N	–up, –ut
tissaluttulia¦q	N	–p, –t
tissanne¦q	N	–rup, –rit
tissa¦ppoq	V	–nngilaq
tissa¦q	N	–p, –t
tissaqa¦ppaa	V	–nngilaa
tissaqatsi¦voq	V	–nngilaq
tissarikkunnaa¦rpoq	V	–nngilaq
tissari¦ppoq	V	–nngilaq
tissarissi¦voq	V	–nngilaq
tissarluersa¦gaq	N	–kkap, –kkat
tissarluersa¦rpaa	V	–nngilaa
tissarlu¦k	N	–up, –it
tissarlu¦ppoq	V	–nngilaq
tissarlutta¦rpoq	V	–nngilaq
tissarluu¦voq	V	–nngilaq
tissa¦rpoq	V	–nngilaq
tissarsinnaannginne¦q	N	–rup, –rit
tissat	N	–ip, –it
tissat	N, pl.	-
tissatig¦aa	V	–inngilaa
tisserna¦q	N	–ap, –at
tiss¦erpoq	V	–inngilaq
tisseruaat	N	–ip, –it
tisseruaatig¦aa	V	–inngilaa
tisserua¦rpoq	V	–nngilaq
tisseruartaanna¦rpoq	V	–nngilaq
tissiallaqqi¦ppoq	V	–nngilaq
tissiarlua¦rpoq	V	–nngilaq
tissiarnaa¦q	N	–p, –t
tissia¦rpoq	V	–nngilaq
tissiartaat	N	–ip, –it
tissiataarna¦rpoq	V	–nngilaq
tissiataarne¦q	N	–rup, –rit
tissiataa¦rpoq	V	–nngilaq
tissiataarut	N	–ip, –it
tissig¦aa	V	–inngilaa
tissikaa¦voq	V	–nngilaq
tissika¦rpoq	V	–nngilaq
tissinaqaaq	V	(no generation)
tissina¦rpoq	V	–nngilaq
tissinart¦oq	N	–up, –ut
tissi¦ppoq	V	–nngilaq
tissisaari¦voq	V	–nngilaq
tissisaa¦rpaa	V	–nngilaa
tissisaa¦rpoq	V	–nngilaq
tissisaarut	N	–ip, –it
tissitsaa¦ppaa	V	–tinngilaa
tissitsa¦ppoq	V	–nngilaq
tissitsarujussua¦rpoq	V	–nngilaq
tissius¦erpoq	V	–inngilaq
tissi¦vaa	V	–nngilaa
tissoriart¦orpoq	V	–unngilaq
tissorne¦q	N	–rup, –rit
tiss¦orpaa	V	–unngilaa
tiss¦orpoq	V	–unngilaq
tissorsimane¦q	N	–rup, –rit
tissorsima¦voq	V	–nngilaq
tissorti¦ppaa	V	–nngilaa
tissujaqaaq	V	(no generation)
tissuja¦voq	V	–nngilaq
tissukaa¦ppaa	V	–tinngilaa
tissukaatitinne¦q	N	–rup, –rit
tissukaatit¦inneq	N	{–innerup, –sinnerup}, {–innerit, –sinnerit}
tissukaat¦itinneq	N	{–innerup, –itinnerup, –sinnerup}, {–innerit, –itinnerit, –sinnerit}
tissukaatit¦ippoq	V	–sinngilaq
tissukaat¦itippoq	V	{–itinngilaq, –sinngilaq}
tissukaatt¦oq	N	–up, –ut
tissukaattorujussuu¦aa	V	–nngilaa
tissukarne¦q	N	–rup, –rit
tissuka¦rpoq	V	–nngilaq
tissukarti¦ppaa	V	–nngilaa
tissukartua¦rpoq	V	–nngilaq
titaat	N	–ip, –it
titapi¦ppaa	V	–nngilaa
titapitsit¦erpaa	V	–inngilaa
titarne¦q	N	–rup, –rit
titarnersu¦aq	N	–up, –it
titarnertaa¦q	N	–p, –t
titarnert¦ooq	N	–uup, –uut
tita¦rpaa	V	–nngilaa
titarsi¦voq	V	–nngilaq
titartaane¦q	N	–rup, –rit
titartaasart¦oq	N	–up, –ut
titartaasi¦orpoq	V	–unngilaq
titartaa¦siorpoq	V	{–siunngilaq, –tiliunngilaq}
titartaas¦oq	N	–up, –ut
titartaat	N	–ip, –it
titartaa¦t	N	–sip, –sit
titartaavi¦k	N	–up, –it
titartaa¦vik	N	{–ffiup, –viup}, {–ffiit, –viit}
titartaa¦voq	V	–nngilaq
titarta¦gaq	N	–kkap, –kkat
titarta¦rpaa	V	–nngilaa
titeqilaanna¦rpoq	V	–nngilaq
titeqila¦voq	V	–nngilaq
titeqq¦orpoq	V	–unngilaq
titeqqullari¦ppoq	V	–nngilaq
titeqqulunne¦q	N	–rup, –rit
titeqqulu¦ppoq	V	–nngilaq
titsii¦ppoq	V	–nngilaq
titsiissu¦seq	N	–tsip, –tsit
titsiits¦oq	N	–up, –ut
titsii¦tsoq	N	{–ssup, –tsup, –ttup}, {–ssut, –tsut, –ttut}
titsuli¦ppoq	V	–nngilaq
tittaa¦voq	V	–nngilaq
titta¦q	N	–ap, –at
tittuli¦ppoq	V	–nngilaq
tivagaju¦ppoq	V	–nngilaq
tivane¦q	N	–rup, –rit
tivarrula¦voq	V	–nngilaq
tivasa¦rpoq	V	–nngilaq
tivasinnaa¦voq	V	–nngilaq
tiva¦voq	V	–nngilaq
tivitsa¦ppoq	V	–nngilaq
Tjekkiam¦eersoq	N	{–eersup, –eertup, –inngaanneersup, –inngaanneertup}, {–eersut, –eertut, –inngaanneersut, –inngaanneertut}
Tjekkiamioq	N	(no generation)
Tjekkiamiu	N	–p, –t
Tjetjeniam¦eersoq	N	{–eersup, –eertup, –inngaanneersup, –inngaanneertup}, {–eersut, –eertut, –inngaanneersut, –inngaanneertut}
Tjetjeniamioq	N	(no generation)
Tjetjeniamiu	N	–p, –t
t¦ooq	N	–uup, –uut
tooriag¦aa	V	–inngilaa
tooriassig¦aa	V	–inngilaa
tooriassi¦voq	V	–nngilaq
toorlag¦aa	V	–inngilaa
toorla¦ppoq	V	–nngilaq
toorlatt¦oq	N	–up, –ut
Toornaarsu¦k	N	–up, –it
toornaarsu¦k	N	–up, –it
toornaaru¦ppoq	V	–tinngilaq
toornaarutivi¦ppoq	V	–nngilaq
toornagaa¦voq	V	–nngilaq
toornannaa¦q	N	–p, –t
toornannaar¦aa	V	–inngilaa
toorna¦ppaa	V	–nngilaa
toorna¦q	N	–p, –t
toornaqal¦erpoq	V	–inngilaq
toornaqa¦rpoq	V	–nngilaq
toorna¦rpaa	V	–nngilaa
toornarpaaloqa¦rpoq	V	–nngilaq
toornartaa¦rpoq	V	–nngilaq
toornarti¦ppaa	V	–nngilaa
toornati¦ppaa	V	–nngilaa
toornat¦ippaa	V	–sinngilaa
toornaviarsua¦raq	N	–qqap, –qqat
toornaviarsu¦k	N	–up, –it
toorne¦q	N	–rup, –rit
toornert¦ooq	N	–uup, –uut
toorngaarsu¦k	N	–up, –it
toorngaaru¦ppoq	V	–tinngilaq
toorngaarutivi¦ppoq	V	–nngilaq
toorngannaa¦q	N	–p, –t
toorngannaar¦aa	V	–inngilaa
toornga¦ppaa	V	–nngilaa
toornga¦q	N	–p, –t
toorngaqa¦rpoq	V	–nngilaq
toorngarpaaloqa¦rpoq	V	–nngilaq
toorngartaa¦rpoq	V	–nngilaq
toorngaviarsua¦raq	N	–qqap, –qqat
toorngaviarsu¦k	N	–up, –it
toorngisart¦oq	N	–up, –ut
toorngissaa¦rpoq	V	–nngilaq
toorngi¦voq	V	–nngilaq
toornil¦ik	N	{–iup, –lip, –lup}, –lit
toorninngu¦aq	N	–up, –it
toornisart¦oq	N	–up, –ut
toornissaa¦rpoq	V	–nngilaq
toorni¦voq	V	–nngilaq
t¦oorpaa	V	–uunngilaa
t¦oorpoq	V	–uunngilaq
toorsine¦q	N	–rup, –rit
toorsi¦voq	V	–nngilaq
toorsu¦aq	N	–up, –it
toortaas¦oq	N	–up, –ut
toortaat	N	–ip, –it
toortaat	N, pl.	-
toortari¦aq	N	{–ssap, –ap}, {–ssat, –at}
toortarnert¦ooq	N	–uup, –uut
toortarnil¦ik	N	{–iup, –lip, –lup}, –lit
toortassia¦q	N	–p, –t
toorti¦ppoq	V	–nngilaq
toort¦oorpoq	V	–uunngilaq
tooruj¦oorpaa	V	–uunngilaa
tooruju¦ppaa	V	–nngilaa
toorumisali¦orpoq	V	–unngilaq
toorumisa¦q	N	–p, –t
toorumisartaa¦rpoq	V	–nngilaq
toorut	N	–ip, –it
toorutaaja¦rpoq	V	–nngilaq
tooruta¦q	N	–p, –t
toorutaqa¦rpoq	V	–nngilaq
toorutissa¦q	N	–p, –t
tooruts¦erpaa	V	–inngilaa
toorut¦serpaa	V	{–italinngilaa, –sinngilaa}
toqoqqajaavoq	V	(no generation)
toqoqqamm¦erpoq	V	–inngilaq
toqoqqu¦aa	V	–nngilaa
toqoqqusissut	N	–ip, –it
toqoqqusissutaa¦voq	V	–nngilaq
toqoqqussut	N	–ip, –it
toqoraagaju¦ppoq	V	–nngilaq
toqoraane¦q	N	–rup, –rit
toqoraasa¦rpoq	V	–nngilaq
toqoraasart¦oq	N	–up, –ut
toqoraas¦oq	N	–up, –ut
toqoraataa¦voq	V	–nngilaq
toqoraavi¦k	N	–up, –it
toqoraa¦voq	V	–nngilaq
toqorarne¦q	N	–rup, –rit
toqoreersima¦voq	V	–nngilaq
toqorlaaju¦voq	V	–nngilaq
toqorlaa¦q	N	–p, –t
toqornit	N, pl.	-
toqorsu¦aq	N	–up, –it
toqoruserne¦q	N	–rup, –rit
toqorus¦erpoq	V	–inngilaq
toqorusersima¦voq	V	–nngilaq
toqqaal¦erpoq	V	–inngilaq
toqqaane¦q	N	–rup, –rit
toqqaannanngits¦oq	N	–up, –ut
toqqaannart¦oq	N	–up, –ut
toqqaa¦ppaa	V	–tinngilaa
toqqaari¦ppoq	V	–nngilaq
toqqaasoqanngilaq	V	(no generation)
toqqaa¦voq	V	–nngilaq
toqqallua¦rpoq	V	–nngilaq
toqqammavig¦aa	V	–inngilaa
toqqammavigi¦ppoq	V	–nngilaq
toqqammavigisassa¦q	N	–p, –t
toqqammavi¦k	N	–up, –it
toqqammavissa¦q	N	–p, –t
toqqammavissaqqi¦ppoq	V	–nngilaq
toqqammavius¦oq	N	–up, –ut
t¦oqqaniippoq	V	{–oqqaniinngilaq, –upianiinngilaq}
toqqanngilaa	V	(no generation)
toqqarlua¦rpaa	V	–nngilaa
toqqarneqarne¦q	N	–rup, –rit
toqqa¦rpaa	V	–nngilaa
toqqartaari¦voq	V	–nngilaq
toqqart¦orpaa	V	–unngilaa
toqqaseri¦ppoq	V	–nngilaq
toqqaserlu¦ppoq	V	–nngilaq
toqqavi¦k	N	–up, –it
toqqaviki¦ppoq	V	–nngilaq
toqqavissaqqi¦ppoq	V	–nngilaq
toqqavissi¦ppaa	V	–nngilaa
toqqa¦voq	V	–nngilaq
toqqinne¦q	N	–rup, –rit
toqqi¦ppoq	V	–nngilaq
toqqisa¦rpoq	V	–nngilaq
toqqissaane¦q	N	–rup, –rit
toqqissaa¦voq	V	–nngilaq
toqqissa¦rpaa	V	–nngilaa
toqqissisimananngilaq	V	(no generation)
toqqissisimana¦rpoq	V	–nngilaq
toqqi¦ssisimanarpoq	V	{–ssisimananngilaq, –tsisimananngilaq}
toqqissisimanart¦oq	N	–up, –ut
toqqi¦ssisimanartoq	N	{–ssisimanartup, –tsisimanartup}, {–ssisimanartut, –tsisimanartut}
toqqissisimane¦q	N	–rup, –rit
toqqi¦ssisimaneq	N	{–ssisimanerup, –tsisimanerup}, {–ssisimanerit, –tsisimanerit}
toqqissisimannginne¦q	N	–rup, –rit
toqqi¦ssisimannginneq	N	{–ssisimannginnerup, –tsisimannginnerup}, {–ssisimannginnerit, –tsisimannginnerit}
toqqissisimas¦oq	N	–up, –ut
toqqi¦ssisimasoq	N	{–ssisimasup, –tsisimasup}, {–ssisimasut, –tsisimasut}
toqqissisimatitsine¦q	N	–rup, –rit
toqqi¦ssisimatitsineq	N	{–ssisimatitsinerup, –tsisimatitsinerup}, {–ssisimatitsinerit, –tsisimatitsinerit}
toqqissisi¦ppaa	V	–nngilaa
toqqissi¦voq	V	–nngilaq
toqqi¦ssoq	N	{–ssup, –ttup}, {–ssut, –ttut}
toqqissort¦ooq	N	–uup, –uut
toqqi¦ssortooq	N	{–ssortuup, –ttortuup}, {–ssortuut, –ttortuut}
toqqi¦ssunngorpoq	V	{–ssunngunngilaq, –ttunngunngilaq}
toqqi¦ssuuvoq	V	{–ssuunngilaq, –ttuunngilaq}
toqqoqqajaavoq	V	(no generation)
toqqorfi¦k	N	–up, –it
toqqorlua¦rpaa	V	–nngilaa
toqq¦orpaa	V	–unngilaa
toqq¦orpoq	V	–unngilaq
toqqorsimas¦oq	N	–up, –ut
toqqorsine¦q	N	–rup, –rit
toqqorsi¦veqarneq	N	{–ffeqarnerup, –veqarnerup}, {–ffeqarnerit, –veqarnerit}
toqqorsi¦vik	N	{–ffiup, –viup}, {–ffiit, –viit}
toqqorsi¦vimmiititat	N, pl.	{–ffimmiisitat, –ffimmiititat, –ffimmiitsitat, –vimmiisitat, –vimmiititat, –vimmiitsitat}
toqqorsi¦voq	V	–nngilaq
toqqortaa¦voq	V	–nngilaq
toqq¦ortaavoq	V	{–ortaanngilaq, –ugaanngilaq}
toqq¦ortaq	N	{–ortap, –ukkap}, {–ortat, –ukkat}
toqqortarigallassavaa	V	(no generation)
toqq¦ortat	N, pl.	{–ortat, –ukkat}
toqqorterine¦q	N	–rup, –rit
toqqorterivi¦k	N	–up, –it
toqqorteriviut	N	–ip, –it
toqqugaa¦voq	V	–nngilaq
toqq¦ugaavoq	V	{–ortaanngilaq, –ugaanngilaq}
toqqu¦gaq	N	–kkap, –kkat
toqq¦ugaq	N	{–ortap, –ukkap}, {–ortat, –ukkat}
toqqugassa¦q	N	–p, –t
toqq¦ugassaq	N	{–ortassap, –ugassap}, {–ortassat, –ugassat}
toqqui¦k	N	–up, –it
toqquissa¦q	N	–p, –t
toqqusaanngu¦voq	V	–nngilaq
toqqusaa¦q	N	–p, –t
toqqusaarlunne¦q	N	–rup, –rit
toqqusaarlu¦ppoq	V	–nngilaq
toqqusa¦ppoq	V	–nngilaq
Toqqusa¦q	N	–p, –t
toqqusassii¦voq	V	–nngilaq
toqqusassi¦vaa	V	–nngilaa
toqqusinaa¦rpoq	V	–nngilaq
toqqusi¦ppoq	V	–nngilaq
toqqut	N	–ip, –it
toqqutaa¦voq	V	–nngilaq
toqqutig¦aa	V	–inngilaa
toqquukkuma¦vaa	V	–nngilaa
toqquu¦ppaa	V	–tinngilaa
toqquussi¦voq	V	–nngilaq
toqu	N	–p, –t
toquararna¦rpoq	V	–nngilaq
toquara¦rpoq	V	–nngilaq
toquararsa¦rpaa	V	–nngilaa
toquarartarne¦q	N	–rup, –rit
toquararti¦ppaa	V	–nngilaa
toquffi¦k	N	–up, –it
toquillarpoq	V	(no generation)
toqujaanga¦voq	V	–nngilaq
toqujaanngu¦voq	V	–nngilaq
toqujaa¦ppoq	V	–nngilaq
toqujaa¦rpoq	V	–nngilaq
toqujanngu¦voq	V	–nngilaq
toqujart¦orpoq	V	–unngilaq
toquja¦voq	V	–nngilaq
toqujoruus¦erpoq	V	–inngilaq
toqujuits¦oq	N	–up, –ut
toqukata¦ppoq	V	–nngilaq
toqukka¦rpaa	V	–nngilaa
toqul¦erpoq	V	–inngilaq
toquler¦soq	N	{–sup, –tup}, {–sut, –tut}
toqulia¦voq	V	–nngilaq
toqulingajunnaa¦rpoq	V	–nngilaq
toqulingaqaaq	V	(no generation)
toqulinga¦voq	V	–nngilaq
toquli¦orpoq	V	–unngilaq
toquliorsima¦voq	V	–nngilaq
toquliort¦oq	N	–up, –ut
toquliunga¦voq	V	–nngilaq
toqulluanngilaq	V	(no generation)
toqullua¦rpaa	V	–nngilaa
toqullua¦rpoq	V	–nngilaq
toqullu¦ppoq	V	–nngilaq
toquna¦rpoq	V	–nngilaq
toqunart¦oq	N	–up, –ut
toqunartoqalerne¦q	N	–rup, –rit
toqunartortorti¦ppaa	V	–nngilaa
toqunartor¦tortippaa	V	{–sortinngilaa, –tortinngilaa}
toqunartortortitsi¦voq	V	–nngilaq
toqunartor¦tortitsivoq	V	{–sortitsinngilaq, –tortitsinngilaq}
toqunartu¦iaaneq	N	{–ajaanerup, –iaanerup}, {–ajaanerit, –iaanerit}
toqunartu¦iarpaa	V	{–ajanngilaa, –ianngilaa}
toqunartul¦ik	N	{–iup, –lip, –lup}, –lit
toqunartuninne¦q	N	–rup, –rit
toqunassu¦seq	N	–tsip, –tsit
toqune¦q	N	–rup, –rit
toq¦uneq	N	–ornup, –ornit
toqunertaat	N	–ip, –it
toqunertaat	N, pl.	-
toqunerta¦rpoq	V	–nngilaq
toqungajappoq	V	(no generation)
toqungane¦q	N	–rup, –rit
toqungas¦oq	N	–up, –ut
toqunga¦voq	V	–nngilaq
toqunik¦oq	N	–up, –ut
toquninng¦orpoq	V	–unngilaq
toqunngarm¦eerpoq	V	–iinngilaq
toqunngarmeersimaqqooqaaq	V	(no generation)
toqunnga¦seq	N	–tsip, –tsit
toqunngaseqa¦rpoq	V	–nngilaq
toqunngasig¦aa	V	–inngilaa
toqunngat	N	–ip, –it
toqunngatit	N, pl.	-
toqunngatsit	N, pl.	-
toqunngulaa¦rpoq	V	–nngilaq
toqunngulaartitsi¦voq	V	–nngilaq
toqunnia¦rpaa	V	–nngilaa
toqu¦ppaa	V	–nngilaa
toquppoq	V	(no generation)
toqusaa¦voq	V	–nngilaq
toqusarne¦q	N	–rup, –rit
toqusa¦rpaa	V	–nngilaa
toqusa¦rpoq	V	–nngilaq
toqusimas¦oq	N	–up, –ut
toqusi¦orpoq	V	–unngilaq
toqus¦oorpoq	V	–uunngilaq
toqus¦oq	N	–up, –ut
toqusoqakulane¦q	N	–rup, –rit
toqusoqa¦rpoq	V	–nngilaq
toqusoqartarne¦q	N	–rup, –rit
toqusortaat	N	–ip, –it
toqu¦sortaat	N	{–sortaat, –sortaatip, –tortaatip}, {–sortaatit, –tortaatit}
toqusortaa¦voq	V	–nngilaq
toqussaanngilaq	V	(no generation)
toqussaanngivi¦ppoq	V	–nngilaq
toqussaa¦voq	V	–nngilaq
toqussa¦q	N	–p, –t
toqussig¦aa	V	–inngilaa
toqussinaqaaq	V	(no generation)
toqussut	N	–ip, –it
toqussutaasinnaas¦oq	N	–up, –ut
toqussutaa¦voq	V	–nngilaq
toqussutig¦aa	V	–inngilaa
toqusussaanngilaq	V	(no generation)
toqusussaa¦voq	V	–nngilaq
toqusussa¦q	N	–p, –t
toqusuusaa¦rpoq	V	–nngilaq
toqutaas¦oq	N	–up, –ut
toqutaa¦voq	V	–nngilaq
toquta¦q	N	–p, –t
toqutar¦aa	V	–inngilaa
toqutassaati¦ppaa	V	–nngilaa
toqutassaa¦voq	V	–nngilaq
toqutassa¦q	N	–p, –t
toquteqqu¦aa	V	–nngilaa
toquti¦ppaa	V	–nngilaa
toqut¦ippaa	V	–sinngilaa
toqutseriarne¦q	N	–rup, –rit
toquts¦eriarneq	N	{–eriarnerup, –iperiarnerup}, {–eriarnerit, –iperiarnerit}
toquts¦erpaa	V	–inngilaa
toqutserusu¦ppoq	V	–nngilaq
toqutsigaju¦ppoq	V	–nngilaq
toqutsiler¦aaq	V	–inngilaq
toqutsine¦q	N	–rup, –rit
toqutsisimas¦oq	N	–up, –ut
toqutsis¦oq	N	–up, –ut
toqutsissutaasimas¦oq	N	–up, –ut
toqutsisuusimas¦oq	N	–up, –ut
toqutsiumat¦ooq	N	–uup, –uut
toqutsi¦voq	V	–nngilaq
toquusa¦rpoq	V	–nngilaq
toqu¦voq	V	–nngilaq
toraa¦gaq	N	–kkap, –kkat
toraajui¦ppoq	V	–nngilaq
toraajusaa¦rpoq	V	–nngilaq
toraajus¦ooq	N	–uup, –uut
toraajutsi¦ppoq	V	–nngilaq
toraaju¦voq	V	–nngilaq
toraarfeqatigiinne¦q	N	–rup, –rit
toraarfeqatigiinnginne¦q	N	–rup, –rit
toraarluinna¦rpaa	V	–nngilaa
toraarlu¦innarpaa	V	{–aannanngilaa, –innanngilaa}
toraa¦rpaa	V	–nngilaa
toraa¦rpoq	V	–nngilaq
toraarti¦ppaa	V	–nngilaa
toraartisima¦vaa	V	–nngilaa
toratsi¦ppoq	V	–nngilaq
toratsisima¦voq	V	–nngilaq
torerluinnaqaaq	V	(no generation)
tor¦erpoq	V	–inngilaq
torersaane¦q	N	–rup, –rit
torersaarluartuune¦q	N	–rup, –rit
torersaa¦rpoq	V	–nngilaq
torersaa¦voq	V	–nngilaq
torersa¦rpaa	V	–nngilaa
torersi¦voq	V	–nngilaq
torer¦soq	N	{–sup, –tup}, {–sut, –tut}
toriikkunnaa¦rpoq	V	–nngilaq
toriilli¦voq	V	–nngilaq
torii¦ppoq	V	–nngilaq
torinngitsuli¦orpoq	V	–unngilaq
torloraat	N	–ip, –it
torlora¦rpaa	V	–nngilaa
torlorfig¦aa	V	–inngilaa
torlorfiginni¦ppoq	V	–nngilaq
torl¦orpaa	V	–unngilaa
torl¦orpoq	V	–unngilaq
torlorsorne¦q	N	–rup, –rit
torlortaa¦voq	V	–nngilaq
torlua¦q	N	–p, –t
torlua¦rpoq	V	–nngilaq
torlu¦k	N	–up, –it
torlulaarfig¦aa	V	–inngilaa
torlulaa¦rpaa	V	–nngilaa
torlulaarpallatta¦rpoq	V	–nngilaq
torlulaa¦rpallattarpoq	V	{–pallattanngilaq, –rpallattanngilaq}
torlulaa¦rpoq	V	–nngilaq
torlulaartaat	N	–ip, –it
torlulaarti¦ppaa	V	–nngilaa
torlulaffig¦aa	V	–inngilaa
torlula¦voq	V	–nngilaq
torlummii¦ppoq	V	–nngilaq
torluss¦erpoq	V	–inngilaq
torluttal¦erpoq	V	–inngilaq
torlutta¦q	N	–p, –t
torluus¦erpaa	V	–inngilaa
torluu¦serpaa	V	{–sinngilaa, –tilinngilaa}
torluut	N	–ip, –it
torluutaa¦rpaa	V	–nngilaa
torluutig¦aa	V	–inngilaa
tormi	N	–p, –t
t¦ornit	N, pl.	{–ornit, –unerit}
torrak	Interj	(no generation)
torrallaa¦voq	V	–nngilaq
torralla¦ppaa	V	–nngilaa
torru¦ppaa	V	–tinngilaa
torru¦ppoq	V	–nngilaq
torrussaa¦ppaa	V	–tinngilaa
torrussi¦voq	V	–nngilaq
torrutaaja¦rpoq	V	–nngilaq
torruta¦q	N	–p, –t
torrutartu¦voq	V	–nngilaq
tors¦ooq	N	–uup, –uut
torsormiuta¦q	N	–p, –t
torsuallaanngilaq	V	(no generation)
Torsukatta¦k	N	–ap, –at
torsukattammi¦oq	N	–up, –ut
torsummiuta¦q	N	–p, –t
torsune¦q	N	–rup, –rit
torsus¦ooq	N	–uup, –uut
torsusoorsu¦aq	N	–up, –it
torsutsi¦ppoq	V	–nngilaq
torsuu¦k	N	{–jup, –p}, –it
torsuusa¦q	N	–p, –t
torsuusartaa¦rpoq	V	–nngilaq
torsuut	N, pl.	-
torsu¦voq	V	–nngilaq
toruffi	N	–p, –t
trikinit	N, pl.	-
tuaa¦voq	V	–nngilaq
tualil¦erpaa	V	–inngilaa
tualisa¦rpaa	V	–nngilaa
tualisi¦ppaa	V	–nngilaa
tuali¦voq	V	–nngilaq
tuapaalussuit	N, pl.	-
tuapaalutta¦rpoq	V	–nngilaq
tuapaat	N	–ip, –it
tuapaatsiaaqa¦rpoq	V	–nngilaq
tuapaatsia¦k	N	–ap, –at
tuapaa¦voq	V	–nngilaq
tuapa¦k	N	–ap, –at
tuapannii¦ppoq	V	–nngilaq
tuapa¦ppaa	V	–nngilaa
tuappi¦k	N	–up, –it
tua¦ppoq	V	–nngilaq
tua¦q	N	–p, –t
tuaqaaq	V	(no generation)
tuar¦orpoq	V	–unngilaq
tuatt¦oq	N	–up, –ut
tuattuararsu¦aq	N	–up, –it
tuattukuj¦ooq	N	–uup, –uut
tuattunngu¦aq	N	–up, –it
tuavers¦orpaa	V	–unngilaa
tuaversui¦voq	V	–nngilaq
tuavi	Interj	(no generation)
tuaviinnaq	Interj	(no generation)
tuaviinnavi¦k	N	–up, –it
tuavii¦ppoq	V	–nngilaq
tuaviornanngilaq	V	(no generation)
tuaviornaqaaq	V	(no generation)
tuaviorna¦rpoq	V	–nngilaq
tuaviorne¦q	N	–rup, –rit
tuaviornia¦rpoq	V	–nngilaq
tuavi¦orpoq	V	–unngilaq
tuaviorsinnaanngilaq	V	(no generation)
tuaviortorujussu¦uvoq	V	{–aanngilaq, –unngilaq}
tuavisaarine¦q	N	–rup, –rit
tuavisaari¦voq	V	–nngilaq
tuavisaa¦rpaa	V	–nngilaa
tuavitsaatig¦aa	V	–inngilaa
tuavitsaatigivi¦ppaa	V	–nngilaa
tuavitsakkiart¦orpoq	V	–unngilaq
tuavitsalluinna¦rpoq	V	–nngilaq
tuavitsa¦ppoq	V	–nngilaq
tuaviukkaa¦rpoq	V	–nngilaq
tuaviupilunne¦q	N	–rup, –rit
tuavi¦upilunneq	N	{–oripilunnerup, –upilunnerup}, {–oripilunnerit, –upilunnerit}
tuaviusukaa¦rpoq	V	–nngilaq
tuaviuu¦ppaa	V	–tinngilaa
tuaviuuppallaa¦gaq	N	–kkap, –kkat
tuaviuussa¦q	N	–p, –t
tuaviuussassaas¦oq	N	–up, –ut
tuaviuussassat	N, pl.	-
tuaviuussi¦voq	V	–nngilaq
tuaviuuteqanngilaq	V	(no generation)
tuaviuutig¦aa	V	–inngilaa
tuaviuutissaanngilaq	V	(no generation)
tuert¦ooq	N	–uup, –uut
tuertu¦voq	V	–nngilaq
tufferi¦voq	V	–nngilaq
tuffig¦aa	V	–inngilaa
tuffigillua¦rpaa	V	–nngilaa
tuffi¦k	N	–up, –it
tuffil¦erpaa	V	–inngilaa
tuffilers¦orpaa	V	–unngilaa
tuffissaanngilaq	V	(no generation)
tuffissa¦q	N	–p, –t
tuffissarfi¦k	N	–up, –it
tuggaa¦q	N	–p, –t
tuggaaqarlua¦rpoq	V	–nngilaq
tuggaaqarnertu¦voq	V	–nngilaq
tuggaaqa¦rpoq	V	–nngilaq
tuggaassu¦aq	N	–up, –it
tuggaat	N	–ip, –it
tuggaat	N, pl.	-
tuggaavi¦k	N	–up, –it
tuggaa¦vik	N	{–ffiup, –viup}, {–ffiit, –viit}
tuggaa¦voq	V	–nngilaq
tuggarfig¦aa	V	–inngilaa
tuggarfi¦k	N	–up, –it
tuggari¦k	N	–up, –it
tugga¦rpaa	V	–nngilaa
tugga¦rpoq	V	–nngilaq
tuggert¦ooq	N	–uup, –uut
tugg¦oq	N	–up, –ut
tuggort¦ooq	N	–uup, –uut
tuggort¦oorpaa	V	–uunngilaa
tuggortoorsu¦aq	N	–up, –it
tugoqattaa¦rpoq	V	–nngilaq
tui	N	–p, –t
tuiia¦rpoq	V	–nngilaq
tuiiarsima¦voq	V	–nngilaq
tuiits¦oq	N	–up, –ut
tuil¦ik	N	{–iup, –lip, –lup}, –lit
tuilittaa¦rpoq	V	–nngilaq
tuill¦erpoq	V	–inngilaq
tuillillaqqi¦ppoq	V	–nngilaq
tuillisa¦rpoq	V	–nngilaq
tuilli¦voq	V	–nngilaq
tuimioqa¦rpoq	V	–nngilaq
tuimiortaa¦rpoq	V	–nngilaq
tuimiu	N	–p, –t
tuinngu¦aq	N	–up, –it
tuiusaanii¦ppoq	V	–nngilaq
tujoqattaa¦rpoq	V	–nngilaq
tujormia¦q	N	–p, –t
tujormiar¦aa	V	–inngilaa
tujormig¦aa	V	–inngilaa
tujorminaa¦ppoq	V	–nngilaq
tujorminaqaaq	V	(no generation)
tujormina¦rpoq	V	–nngilaq
tujormisi¦ppaa	V	–nngilaa
tujormisitsi¦voq	V	–nngilaq
tujormiunnaa¦rpoq	V	–nngilaq
tujormi¦voq	V	–nngilaq
tuj¦orpaa	V	–unngilaa
tuju¦ppoq	V	–nngilaq
tu¦juuluaraq	N	{–juuluaqqap, –luujuaqqap}, {–juuluaqqat, –luujuaqqat}
tujuulu¦k	N	–up, –it
tujuulussu¦aq	N	–up, –it
tukaalaa¦rpoq	V	–nngilaq
tukaalaarti¦ppaa	V	–nngilaa
tukaalaartuinnaa¦voq	V	–nngilaq
tukaalasuinnaa¦voq	V	–nngilaq
tukaala¦voq	V	–nngilaq
tukaallaannakkat	N, pl.	-
tukaalla¦ppoq	V	–nngilaq
tukaallassaa¦voq	V	–nngilaq
tukaallassa¦rpaa	V	–nngilaa
tukaffaaj¦ooq	N	–uup, –uut
tukanne¦q	N	–rup, –rit
tukappallaarsor¦aa	V	–inngilaa
tuka¦ppoq	V	–nngilaq
tukassa¦rpaa	V	–nngilaa
tukatsi¦ppoq	V	–nngilaq
tukatt¦oq	N	–up, –ut
tukattuinnaa¦voq	V	–nngilaq
tukerfig¦aa	V	–inngilaa
tukerfi¦k	N	–up, –it
tukerlaa¦q	N	–p, –t
tukerne¦q	N	–rup, –rit
tukern¦erpoq	V	–inngilaq
tukerners¦orpoq	V	–unngilaq
tukerningas¦oq	N	–up, –ut
tuk¦erpaa	V	–inngilaa
tuk¦erpoq	V	–inngilaq
tukersima¦vaa	V	–nngilaa
tukersima¦voq	V	–nngilaq
tukersinnaal¦erpoq	V	–inngilaq
tukertari¦aq	N	{–ssap, –ap}, {–ssat, –at}
tukertari¦aq	N	–ssap, –ssat
tukerumiaa¦voq	V	–nngilaq
tukerumi¦aq	N	–ssap, –ssat
tukerumiaqa¦rpoq	V	–nngilaq
tukerumits¦erpaa	V	–inngilaa
tukiffig¦aa	V	–inngilaa
tukiinna¦rpaa	V	–nngilaa
tuki¦k	N	{–ngup, –up}, {–it, –ngit}
tukikkiart¦orpoq	V	–unngilaq
tukim¦oorpaa	V	–uunngilaa
tukimoorti¦ppaa	V	–nngilaa
tukimuka¦rpoq	V	–nngilaq
tukimukart¦oq	N	–up, –ut
tukingas¦oorpoq	V	–uunngilaq
tukingas¦oq	N	–up, –ut
tukingasul¦ik	N	{–iup, –lip, –lup}, –lit
tukinga¦voq	V	–nngilaq
tukinngaa¦rpaa	V	–nngilaa
tukinngaa¦rpoq	V	–nngilaq
tuki¦ppoq	V	–nngilaq
tukisi¦ppaa	V	–nngilaa
tukiti¦ppaa	V	–nngilaa
tukkaas¦oq	N	–up, –ut
tukkaasuu¦voq	V	–nngilaq
tukkaavi¦k	N	–up, –it
tukkaa¦vik	N	{–ffiup, –viup}, {–ffiit, –viit}
tukkaa¦voq	V	–nngilaq
tukkagaa¦voq	V	–nngilaq
tukka¦gaq	N	–kkap, –kkat
tukkari¦aq	N	–ssap, –ssat
tukka¦rpaa	V	–nngilaa
tukka¦rpoq	V	–nngilaq
tukkarsa¦rpoq	V	–nngilaq
tukkars¦orpoq	V	–unngilaq
tukkarsortarfi¦k	N	–up, –it
tukkart¦orpoq	V	–unngilaq
tukkartuu¦ppaa	V	–tinngilaa
tukkiart¦orpoq	V	–unngilaq
tukk¦orpoq	V	–unngilaq
tukkortorsu¦uvoq	V	{–aanngilaq, –unngilaq}
tukkugaju¦ppoq	V	–nngilaq
tukkuig¦aa	V	–inngilaa
tukkuilli¦voq	V	–nngilaq
tukkui¦ppoq	V	–nngilaq
tukkuissu¦seq	N	–tsip, –tsit
tukkuitsuu¦voq	V	–nngilaq
tukkuivi¦ppoq	V	–nngilaq
tukkujart¦orpoq	V	–unngilaq
tukkusaanna¦rpoq	V	–nngilaq
tukkusaa¦rpoq	V	–nngilaq
tukku¦sooq	N	{–suup, –tuup}, {–suut, –tuut}
tukkutsi¦ppoq	V	–nngilaq
tukku¦voq	V	–nngilaq
tukumaa¦ppoq	V	–nngilaq
tukumaavi¦ppoq	V	–nngilaq
tukumaqaaq	V	(no generation)
tukumas¦oq	N	–up, –ut
tukuma¦voq	V	–nngilaq
tukummaallaatig¦aa	V	–inngilaa
tukummaalla¦ppoq	V	–nngilaq
tukummaarilluinna¦rpoq	V	–nngilaq
tukummaari¦ppoq	V	–nngilaq
tukummaarissi¦voq	V	–nngilaq
tukummaariss¦oq	N	–up, –ut
tukummaari¦ssoq	N	{–ssup, –ttup}, {–ssut, –ttut}
tukummaarissu¦seq	N	–tsip, –tsit
tukummaa¦vaa	V	–nngilaa
tukumma¦ppoq	V	–nngilaq
tukummari¦ppoq	V	–nngilaq
tulaakkiart¦orpaa	V	–unngilaa
tulaa¦ppaa	V	–tinngilaa
tulaassine¦q	N	–rup, –rit
tulaassivi¦k	N	–up, –it
tulaassi¦vik	N	{–ffiup, –viup}, {–ffiit, –viit}
tulaassi¦voq	V	–nngilaq
tulaaveqanngilaq	V	(no generation)
tulaavig¦aa	V	–inngilaa
tulaavi¦k	N	–up, –it
tulaaviki¦ppoq	V	–nngilaq
tulaffi¦k	N	–up, –it
tulagiaa¦voq	V	–nngilaq
tulagia¦q	N	–p, –t
tulagiaqanngilaq	V	(no generation)
tulajaaginnaa¦voq	V	–nngilaq
tulajaa¦q	N	–p, –t
tulakkiart¦orpoq	V	–unngilaq
tulanne¦q	N	–rup, –rit
tula¦ppoq	V	–nngilaq
tulassiivoq	V	(no generation)
tulatsi¦ppaa	V	–nngilaa
tulattarfi¦k	N	–up, –it
tulattarfilia¦q	N	–p, –t
tulimaa¦q	N	–p, –t
tulimaavia¦rpoq	V	–nngilaq
tulimassiua¦rpoq	V	–nngilaq
tullaa¦ppaa	V	–tinngilaa
tullaa¦q	N	–p, –t
tullaar¦aa	V	–inngilaa
tullaariinna¦rpaa	V	–nngilaa
tullaariumanngilaa	V	(no generation)
tullaatinngilaa	V	(no generation)
tullarnertuallaaqaaq	V	(no generation)
tulla¦rpaa	V	–nngilaa
tulla¦rpoq	V	–nngilaq
tull¦eerpoq	V	–iinngilaq
tull¦eq	N	–iup, –iit
tulleqqat	N, pl.	-
tulle¦qqerpoq	V	{–qqinngilaq, –ralinngilaq}
tulle¦qqersorpaa	V	{–qqersunngilaa, –ralersunngilaa}
tulle¦qqiorpoq	V	{–qqiunngilaq, –raliunngilaq}
tulleqqiortaannarpoq	V	(no generation)
tulle¦qqiortarpoq	V	{–qqiortanngilaq, –raliortanngilaq}
tulleqqiu¦ppaa	V	–tinngilaa
tuller¦aa	V	–inngilaa
tulle¦raq	N	–qqap, –qqat
tulleraqa¦rpoq	V	–nngilaq
tullerartaa¦rpoq	V	–nngilaq
tulleriiaarine¦q	N	–rup, –rit
tulleriinnilersuine¦q	N	–rup, –rit
tulleriinniliine¦q	N	–rup, –rit
tulleriinnissa¦q	N	–p, –t
tulleriissaarine¦q	N	–rup, –rit
tuller¦orpaa	V	–unngilaa
tullers¦orpaa	V	–unngilaa
tullersorti	N	–p, –t
tullersui¦voq	V	–nngilaq
tullerunnaa¦raq	N	–qqap, –qqat
tullerunnakkulu¦k	N	–up, –it
tullerunna¦q	N	–p, –t
tullerus¦erpoq	V	–inngilaq
tulleru¦serpoq	V	{–sinngilaq, –tilinngilaq}
tullerut	N	–ip, –it
tullil¦erpaa	V	–inngilaa
tullinnguu¦ppoq	V	–tinngilaq
tullinnguutil¦erpoq	V	–inngilaq
tullinngu¦voq	V	–nngilaq
tulliu¦ppoq	V	–tinngilaq
tulliusaanna¦rpoq	V	–nngilaq
tulliusussaa¦voq	V	–nngilaq
tulliutt¦oq	N	–up, –ut
tulliu¦voq	V	–nngilaq
tullivallaaqaaq	V	(no generation)
tulli¦voq	V	–nngilaq
tull¦oq	N	–up, –ut
tulluar¦aa	V	–inngilaa
tulluarinngilaa	V	(no generation)
tullua¦rpoq	V	–nngilaq
tulluarsaari¦voq	V	–nngilaq
tulluarsa¦rpaa	V	–nngilaa
tulluart¦oq	N	–up, –ut
tulluassu¦seq	N	–tsip, –tsit
tulluavi¦ppoq	V	–nngilaq
tullut	N, pl.	-
tulluulluart¦oq	N	–up, –ut
tulluummissutig¦aa	V	–inngilaa
tulluummi¦voq	V	–nngilaq
tulluunnaqaaq	V	(no generation)
tulluunna¦rpoq	V	–nngilaq
tulluu¦ppoq	V	–tinngilaq
tulluusimaarne¦q	N	–rup, –rit
tulluus¦imaarneq	N	{–imaarnerup, –simaarnerup}, {–imaarnerit, –simaarnerit}
tulluusimaarpoq	V	(no generation)
tulluusimaart¦oq	N	–up, –ut
tulluus¦imaartoq	N	{–imaartup, –simaartup}, {–imaartut, –simaartut}
tulluussutig¦aa	V	–inngilaa
tulluutt¦oq	N	–up, –ut
tulluuttorujussuus¦oq	N	–up, –ut
tulluuttorujussu¦usoq	N	{–aasup, –usup}, {–aasut, –usut}
tuloriaki¦ppoq	V	–nngilaq
tulori¦aq	N	–ssap, –ssat
tuloriart¦ooq	N	–uup, –uut
tul¦orpaa	V	–unngilaa
tul¦orpoq	V	–unngilaq
tulorsima¦voq	V	–nngilaq
tulorta¦gaq	N	–kkap, –kkat
tulorta¦rpaa	V	–nngilaa
tuloru¦seq	N	–tsip, –tsit
tulorutsit	N, pl.	-
tulua¦q	N	–p, –t
tuluarna¦q	N	–p, –t
tuluarnits¦oq	N	–up, –ut
tuluarsu¦aq	N	–up, –it
tuluatsiaa¦voq	V	–nngilaq
tuluatsia¦q	N	–ap, –at
tuluffi	N	–p, –t
tulu¦gaq	N	–kkap, –kkat
tulugarna¦q	N	{–ap, –p}, {–at, –t}
tulugarsu¦aq	N	–up, –it
tulugatsiaa¦raq	N	–qqap, –qqat
tulugatsiaa¦voq	V	–nngilaq
tulugatsia¦q	N	–ap, –at
tuluit	N, pl.	-
tulu¦k	N	–up, –it
tulukkaa¦q	N	–p, –t
tulukkaarsu¦aq	N	–up, –it
tulukkaasa¦q	N	–p, –t
tulukkarnits¦oq	N	–up, –ut
tulukk¦orpoq	V	–unngilaq
tulussi¦voq	V	–nngilaq
tulutt¦oorpoq	V	–uunngilaq
tulutt¦oorpoq	V	–uunngilaq, –uunngilaq
tuluttoortitsine¦q	N	–rup, –rit
tuluttuut	N, pl.	-
tuluujua¦raq	N	–qqap, –qqat
tu¦luujuaraq	N	{–juuluaqqap, –luujuaqqap}, {–juuluaqqat, –luujuaqqat}
tu¦luujuk	N	{–juulup, –luujup, –luujuup}, {–juulut, –luujuit, –luujut}
tuluujussu¦aq	N	–up, –it
tu¦luujussuaq	N	{–juulorsuup, –luujorsuup, –luujussuup}, {–juulorsuit, –luujorsuit, –luujussuit}
tuluusaa¦raq	N	–qqap, –qqat
tuluusaa¦rpoq	V	–nngilaq
tuluusa¦q	N	–p, –t
tumaarpallanne¦q	N	–rup, –rit
tum¦aarpallanneq	N	{–aapallannerup, –aarpallannerup, –iorpallannerup, –iupallannerup}, {–aapallannerit, –aarpallannerit, –iorpallannerit, –iupallannerit}
tumaarpalla¦ppoq	V	–nngilaq
tum¦aarpallappoq	V	{–aapallanngilaq, –aarpallanngilaq, –iorpallanngilaq, –iupallanngilaq}
tumaarpallatta¦rpoq	V	–nngilaq
tum¦aarpallattarpoq	V	{–aapallattanngilaq, –aarpallattanngilaq, –iorpallattanngilaq, –iupallattanngilaq}
tumaarpalu¦k	N	–up, –it
tum¦aarpaluk	N	{–aarpaluup, –iorpaluup}, {–aarpaluit, –iorpaluit}
tumaarpalulaa¦rpoq	V	–nngilaq
tumaarpalunne¦q	N	–rup, –rit
tum¦aarpalunneq	N	{–aarpalunnerup, –iorpalunnerup}, {–aarpalunnerit, –iorpalunnerit}
tumaarpalunnersu¦aq	N	–up, –it
tum¦aarpalunnersuaq	N	{–aarpalunnersuup, –iorpalunnersuup}, {–aarpalunnersuit, –iorpalunnersuit}
tumaarpalu¦ppoq	V	–nngilaq
tum¦aarpaluppoq	V	{–aarpalunngilaq, –iorpalunngilaq}
tumaarpalussu¦aq	N	–up, –it
tum¦aarpalussuaq	N	{–aarpalussuup, –iorpalussuup}, {–aarpalussuit, –iorpalussuit}
tumaaru¦ppoq	V	–tinngilaq
tumaarussi¦vaa	V	–nngilaa
tumaasaa¦raq	N	–qqap, –qqat
tumaasaa¦voq	V	–nngilaq
tumaasa¦q	N	–p, –t
tumaasarsu¦aq	N	–up, –it
tumangatu¦voq	V	–nngilaq
tumannguerna¦rpoq	V	–nngilaq
tumanngu¦erpoq	V	–inngilaq
tumannguersaat	N	–ip, –it
tumannguer¦saat	N	{–saatip, –taatip}, {–saatit, –taatit}
tumannguersa¦rpaa	V	–nngilaa
tumannguersa¦rpoq	V	–nngilaq
tumannguersartarfi¦k	N	–up, –it
tumanngunaqaaq	V	(no generation)
tumannguna¦rpoq	V	–nngilaq
tumanngus¦oq	N	–up, –ut
tumanngu¦voq	V	–nngilaq
tumarnaveeqqus¦erpaa	V	–inngilaa
tumarnaveeqqu¦serpaa	V	{–sinngilaa, –tilinngilaa}
tumarnaveeqqut	N	–ip, –it
tumarnik¦oq	N	–up, –ut
tuma¦rpaa	V	–nngilaa
tuma¦rpoq	V	–nngilaq
tumarsa¦rpoq	V	–nngilaq
tumarsimas¦oq	N	–up, –ut
tumarsima¦voq	V	–nngilaq
tumartorne¦q	N	–rup, –rit
tumart¦orpoq	V	–unngilaq
tumartorsimas¦oq	N	–up, –ut
tumartorsima¦voq	V	–nngilaq
tumerparpaa¦q	N	–p, –t
tumerparpaa¦rpoq	V	–nngilaq
tumerparpaarsinnaa¦voq	V	–nngilaq
tumerparpaart¦oq	N	–up, –ut
tumerparpaartuu¦voq	V	–nngilaq
tumersu¦aq	N	–up, –it
tumi	N	–p, –t
tumili¦ppoq	V	–nngilaq
tumisia¦q	N	–p, –t
tumisiaqa¦rpoq	V	–nngilaq
tumisiar¦aa	V	–inngilaa
tumisioqqissaa¦rpaa	V	–nngilaa
tumisi¦orpaa	V	–unngilaa
tumisiui¦voq	V	–nngilaq
tumisiunngilaa	V	(no generation)
tumisi¦voq	V	–nngilaq
tummaa¦ppaa	V	–tinngilaa
tummaa¦q	N	–p, –t
tummaar¦aa	V	–inngilaa
tummaarisaa¦voq	V	–nngilaq
tummaarisassaanngilaq	V	(no generation)
tummaassa¦q	N	–p, –t
tummaat	N	–ip, –it
tummaat	N, pl.	-
tummaatig¦aa	V	–inngilaa
tummagaa¦voq	V	–nngilaq
tumma¦gaq	N	–kkap, –kkat
tummagassa¦q	N	–p, –t
tummarfi¦k	N	–up, –it
tummarnerlu¦ppoq	V	–nngilaq
tumma¦rpaa	V	–nngilaa
tumma¦rpoq	V	–nngilaq
tummartorpaa	V	(no generation)
tummeqqat	N, pl.	-
tumme¦qqerpaa	V	{–qqinngilaa, –ralinngilaa}
tumme¦qqerpoq	V	{–qqinngilaq, –ralinngilaq}
tumme¦qqersorpaa	V	{–qqersunngilaa, –ralersunngilaa}
tumme¦qqersorpoq	V	{–qqersunngilaq, –ralersunngilaq}
tumme¦qqiuppaa	V	{–qqiutinngilaa, –raliutinngilaa}
tumme¦ralerpaa	V	{–qqinngilaa, –ralinngilaa}
tumme¦raq	N	–qqap, –qqat
tummeraqarfi¦k	N	–up, –it
tummerartaa¦rpoq	V	–nngilaq
tummerlukkajuppoq	V	(no generation)
tummerlu¦ppoq	V	–nngilaq
tummisal¦erpaa	V	–inngilaa
tummisa¦q	N	–p, –t
tummivig¦aa	V	–inngilaa
tummi¦voq	V	–nngilaq
tunaar¦aa	V	–inngilaa
tunaariua¦rpaa	V	–nngilaa
tunaarl¦erpoq	V	–inngilaq
tunaarlersi¦ppaa	V	–nngilaa
tunaarliu¦ppaa	V	–tinngilaa
tunaarliussaa¦voq	V	–nngilaq
tunaartar¦aa	V	–inngilaa
tunaartassia¦q	N	–p, –t
t¦uneq	N	{–ornup, –unerup}, {–ornit, –unerit}
tuneqqi¦ppaa	V	–nngilaa
tuneqqusaa¦rpoq	V	–nngilaq
tunersuit	N, pl.	-
tunersu¦k	N	–up, –it
tunersummii¦ppoq	V	–nngilaq
tungaakkiart¦orpaa	V	–unngilaa
tungaakku¦serpaa	V	{–sinngilaa, –talinngilaa}
tungaakku¦serpaa	V	{–sinngilaa, –tilinngilaa}
tungaakku¦sersimavaa	V	{–sersimanngilaa, –talersimanngilaa}
tungaakku¦sersimavaa	V	{–sersimanngilaa, –tilersimanngilaa}
tungaakku¦sersorpaa	V	{–sersunngilaa, –talersunngilaa}
tungaakku¦sersorpaa	V	{–sersunngilaa, –tilersunngilaa}
tungaakkut	N	–ip, –it
tungaakkutaa¦voq	V	–nngilaq
tungaakkutar¦aa	V	–inngilaa
tungaalii¦voq	V	–nngilaq
tungaali¦ppaa	V	–nngilaa
tungaa¦ppaa	V	–tinngilaa
tungaasi¦orpaa	V	–unngilaa
tungaasiui¦voq	V	–nngilaq
tungaatt¦oorpaa	V	–uunngilaa
tung¦e	N	–ip, –it
tung¦eq	N	–ip, –it
tungerl¦eq	N	{–erup, –iup}, {–erit, –iit}
tungertaa¦rpoq	V	–nngilaq
tungi¦orpaa	V	–unngilaa
tungissia¦q	N	–p, –t
tungitsia¦rpoq	V	–nngilaq
tungiuine¦q	N	–rup, –rit
tungoqqi¦k	N	–up, –it
tung¦orpoq	V	–unngilaq
tungortikkiart¦orpoq	V	–unngilaq
tungorti¦ppoq	V	–nngilaq
tungortuinnaa¦voq	V	–nngilaq
tungor¦tuinnaavoq	V	{–tuinnaanngilaq, –suinnaanngilaq}
tungu	N	–p, –t
tunguarni	N	–p, –t
tunguarnillua¦rpoq	V	–nngilaq
tunguarni¦ppoq	V	–nngilaq
tunguarnits¦oq	N	–up, –ut
tunguarni¦tsoq	N	{–ssup, –tsup, –ttup}, {–ssut, –tsut, –ttut}
tungueru¦ppoq	V	–tinngilaq
tunguerussima¦voq	V	–nngilaq
tunguiaaffi¦k	N	–up, –it
tungu¦iaaffik	N	{–ajaaffiup, –iaaffiup}, {–ajaaffiit, –iaaffiit}
tunguiaa¦vik	N	{–ffiup, –viup}, {–ffiit, –viit}
tungu¦iaavik	N	{–ajaaffiup, –ajaaviup, –iaaffiup, –iaaviup}, {–ajaaffiit, –ajaaviit, –iaaffiit, –iaaviit}
tunguia¦rpaa	V	–nngilaa
tungu¦iarpaa	V	{–ajanngilaa, –ianngilaa}
tunguinnaa¦voq	V	–nngilaq
tunguj¦orpoq	V	–unngilaq
tungujorsaat	N	–ip, –it
tungujorsa¦rpaa	V	–nngilaa
tungujorsia¦q	N	–p, –t
tungujorsi¦voq	V	–nngilaq
tungujortinne¦q	N	–rup, –rit
tungujort¦oq	N	–up, –ut
tungujortunngu¦aq	N	–up, –it
tungujortunnguit	N, pl.	-
tungujoruusa¦ppoq	V	–nngilaq
tungujoruusa¦rpoq	V	–nngilaq
tungujualaa¦rpoq	V	–nngilaq
tungujua¦rpoq	V	–nngilaq
tungujuart¦oq	N	–up, –ut
tungu¦juartoq	N	{–juartup, –tuartup}, {–juartut, –tuartut}
tungujukuluppoq	V	(no generation)
tungujulaa¦rpoq	V	–nngilaq
tunguliorfi¦k	N	–up, –it
tunguli¦orpoq	V	–unngilaq
tunguliorta¦rpoq	V	–nngilaq
tungungalaa¦rpoq	V	–nngilaq
tungungaruju¦ppoq	V	–nngilaq
tungungavi¦ppoq	V	–nngilaq
tungunga¦voq	V	–nngilaq
tungu¦ppaa	V	–tinngilaa
tungu¦ppoq	V	–tinngilaq
tungusaat	N	–ip, –it
tungusaatig¦aa	V	–inngilaa
tungussalu¦ppoq	V	–nngilaq
tungusunnialaa¦rpoq	V	–nngilaq
tungusunnippallaaqaaq	V	(no generation)
tungusunni¦ppoq	V	–nngilaq
tungusunnits¦oq	N	–up, –ut
tungusunnit¦soq	N	{–sup, –tup}, {–sut, –tut}
tungusunnitsuusi¦orpoq	V	–unngilaq
tungusunnitsuu¦siorpoq	V	{–siunngilaq, –tiliunngilaq}
tungusunnit¦suusiorpoq	V	{–suusiunngilaq, –suutiliunngilaq, –tuusiunngilaq, –tuutiliunngilaq}
tungusunnitsuut	N	–ip, –it
tungusunnit¦suut	N	{–suutip, –tuutip}, {–suutit, –tuutit}
tungutsi¦ppoq	V	–nngilaq
tungut¦sippoq	V	{–itinngilaq, –sinngilaq}
tungutsi¦voq	V	–nngilaq
tungutsorilluinna¦rpoq	V	–nngilaq
tungutsori¦ppoq	V	–nngilaq
tungutsorissi¦voq	V	–nngilaq
tunguusaas¦oq	N	–up, –ut
tunguusaa¦voq	V	–nngilaq
tunguusa¦q	N	–p, –t
tunguusat	N, pl.	-
tunguusi¦voq	V	–nngilaq
tungu¦voq	V	–nngilaq
tunillaakkiart¦orpoq	V	–unngilaq
tunillaa¦ppoq	V	–tinngilaq
tunilla¦asinnaasoq	N	{–asinnaasup, –tsisinnaasup}, {–asinnaasut, –tsisinnaasut}
tunilla¦asinnaavoq	V	{–asinnaanngilaq, –tsisinnaanngilaq}
tunillaass¦orpoq	V	–unngilaq
tunillaassort¦oq	N	–up, –ut
Tunillaassortunik Nappaalanersuaqarneranut Ataatsimiititaliarsu¦aq	Prop	–up
tunillaassuerulutt¦oq	N	–up, –ut
tunillaassuu¦ppoq	V	–tinngilaq
tunillaassuu¦tipallanneq	N	{–ppallannerup, –tipallannerup, –tippallannerup, –tsipallannerup, –tsippallannerup}, {–ppallannerit, –tipallannerit, –tippallannerit, –tsipallannerit, –tsippallannerit}
tunillaasuu¦voq	V	–nngilaq
tunilla¦asuuvoq	V	{–asuunngilaq, –tsisuunngilaq}
tunilla¦avoq	V	{–anngilaq, –tsinngilaq}
tunillagassaanngits¦oq	N	–up, –ut
tunillanna¦rpoq	V	–nngilaq
tunillannart¦oq	N	–up, –ut
tunillannartoqalersimas¦oq	N	–up, –ut
tunillannartu¦iaaneq	N	{–ajaanerup, –iaanerup}, {–ajaanerit, –iaanerit}
tunillannartuiaat	N	–ip, –it
tunillannartu¦iaavoq	V	{–ajaanngilaq, –iaanngilaq}
tunillannartu¦iarneq	N	{–ajarnerup, –iarnerup}, {–ajarnerit, –iarnerit}
tunillannartu¦iarpaa	V	{–ajanngilaa, –ianngilaa}
tunillanneqarsinnaanngissu¦seq	N	–tsip, –tsit
tunillanneqarsinnaanngits¦oq	N	–up, –ut
tunillanneqart¦oq	N	–up, –ut
tunilla¦ppaa	V	–nngilaa
tunillassaanngissu¦seq	N	–tsip, –tsit
tunillassima¦vaa	V	–nngilaa
tunilla¦tsiasut	N, pl.	{–iasut, –tsiasut}
tunillatsinne¦q	N	–rup, –rit
tunillatsinnerit	N, pl.	-
tunillatsis¦simasoq	N	{–simasup, –imasup}, {–simasut, –imasut}
tunillatsissinnaane¦q	N	–rup, –rit
tunillatsitt¦oq	N	–up, –ut
tunillatsi¦ttoq	N	{–ttup, –ssup}, {–ttut, –ssut}
tuniluuffius¦oq	N	–up, –ut
tuniluu¦ppoq	V	–tinngilaq
tunineqarsinnaas¦oq	N	–up, –ut
tuniniaaffi¦k	N	–up, –it
tunini¦aaffik	N	{–aaffiup, –niaaffiup}, {–aaffiit, –niaaffiit}
tuniniaallamma¦k	N	–ap, –at
tunini¦aallammak	N	{–aallammaap, –niaallammaap}, {–aallammaat, –niaallammaat}
tuniniaane¦q	N	–rup, –rit
tuniniaasarne¦q	N	–rup, –rit
tuniniaasart¦oq	N	–up, –ut
tuniniaas¦oq	N	–up, –ut
tuniniaa¦vik	N	{–ffiup, –viup}, {–ffiit, –viit}
tuniniaa¦voq	V	–nngilaq
tuninia¦gaq	N	–kkap, –kkat
tuninia¦rpaa	V	–nngilaa
tuninia¦rpoq	V	–nngilaq
tuninngitsoorpaa	V	(no generation)
tunioraane¦q	N	–rup, –rit
tunioraa¦voq	V	–nngilaq
tuniorarpaa	V	(no generation)
tuni¦orpaa	V	–unngilaa
tunisa¦q	N	–p, –t
tunisassia¦q	N	–p, –t
tunisassiat	N, pl.	-
tunisassiorfi¦k	N	–up, –it
tunisass¦iorfik	N	{–aliorfiup, –iorfiup}, {–aliorfiit, –iorfiit}
tunisass¦ioriaaseq	N	{–alioriaatsip, –ioriaatsip}, {–alioriaatsit, –ioriaatsit}
tunisass¦iorneq	N	{–aliornerup, –iornerup}, {–aliornerit, –iornerit}
tunisass¦iorsinnaassuseq	N	{–aliorsinnaassutsip, –iorsinnaassutsip}, {–aliorsinnaassutsit, –iorsinnaassutsit}
tunisass¦iortoq	N	{–aliortup, –iortup}, {–aliortut, –iortut}
tunisat	N, pl.	-
tuniseqataas¦oq	N	–up, –ut
tuni¦seqataasoq	N	{–seqataasup, –teqataasup}, {–seqataasut, –teqataasut}
tuniseqqu¦aa	V	–nngilaa
tunisigaju¦ppoq	V	–nngilaq
tunisine¦q	N	–rup, –rit
tunisis¦oq	N	–up, –ut
tunisiumatuvoq	V	(no generation)
tunisivig¦aa	V	–inngilaa
tunisivi¦k	N	–up, –it
tunisi¦voq	V	–nngilaq
tunisorsuu¦voq	V	–nngilaq
tunisorsu¦uvoq	V	{–aanngilaq, –unngilaq}
tunissut	N	–ip, –it
tunissutaa¦voq	V	–nngilaq
tunissuteqarfig¦aa	V	–inngilaa
tunissuteqarne¦q	N	–rup, –rit
tunissutig¦aa	V	–inngilaa
tunissutigeqqita¦q	N	–p, –t
tunissutisia¦q	N	–p, –t
tunitsivi¦k	N	–up, –it
tunitsivissa¦q	N	–p, –t
tunitsiviusinnaas¦oq	N	–up, –ut
tuniuaanna¦rpoq	V	–nngilaq
tuniumanngilaa	V	(no generation)
tuniunnaa¦rpoq	V	–nngilaq
tuniusa¦rpoq	V	–nngilaq
tuni¦vaa	V	–nngilaa
tunivoq	V	(no generation)
tunne¦q	N	–rup, –rit
tunnerlu¦ppoq	V	–nngilaq
tunnert¦ooq	N	–uup, –uut
tunnertu¦voq	V	–nngilaq
tunnerusaa¦q	N	–p, –t
tunngallua¦rpoq	V	–nngilaq
tunngasa¦rpaa	V	–nngilaa
tunngas¦oq	N	–up, –ut
tunngati¦ppaa	V	–nngilaa
tunngavallaa¦rpoq	V	–nngilaq
tunngaveqanngits¦oq	N	–up, –ut
tunngaveqarluart¦oq	N	–up, –ut
tunngaveqarluassu¦seq	N	–tsip, –tsit
tunngaveqa¦rpoq	V	–nngilaq
tunngaveqarti¦ppaa	V	–nngilaa
tunngaveqart¦oq	N	–up, –ut
tunngaveqarumannginne¦q	N	–rup, –rit
tunngavig¦aa	V	–inngilaa
tunngavigisa¦q	N	–p, –t
tunngaviit	N, pl.	-
tunngavi¦k	N	–up, –it
tunngaviki¦ppoq	V	–nngilaq
tunngavil¦erpaa	V	–inngilaa
tunngavil¦erpoq	V	–inngilaq
tunngavilersugaalluart¦oq	N	–up, –ut
tunngavilersuine¦q	N	–rup, –rit
tunngaviler¦suut	N	{–suutip, –tuutip}, {–suutit, –tuutit}
tunngaviliis¦oq	N	–up, –ut
tunngavilii¦vik	N	{–ffiup, –viup}, {–ffiit, –viit}
tunngavilii¦voq	V	–nngilaq
tunngavissaarut¦sippaa	V	{–inngilaa, –sinngilaa, –itinngilaa}
tunngavissa¦q	N	–p, –t
tunngavissaqal¦erpoq	V	–inngilaq
tunngavissaqanngilluinnarpoq	V	(no generation)
tunngavissaqart¦oq	N	–up, –ut
tunngaviss¦iortoq	N	{–iortup, –aliortup}, {–iortut, –aliortut}
tunngavissi¦ppaa	V	–nngilaa
tunngavius¦oq	N	–up, –ut
tunngaviusut	N, pl.	-
tunngaviu¦voq	V	–nngilaq
tunnga¦voq	V	–nngilaq
tunngu¦voq	V	–nngilaq
tunni	N	–p, –t
tunnia¦rpoq	V	–nngilaq
tunniukkiart¦orpaa	V	–unngilaa
tunniulluinna¦rpoq	V	–nngilaq
tunniullu¦innarpoq	V	{–aannanngilaq, –innanngilaq}
tunniunneqarsinnaanngits¦oq	N	–up, –ut
tunniunneqarta¦rpoq	V	–nngilaq
tunniu¦ppaa	V	–tinngilaa
tunniu¦ppoq	V	–tinngilaq
tunniusimaannarpoq	V	(no generation)
tunniusimane¦q	N	–rup, –rit
tunniusimas¦oq	N	–up, –ut
tunniussaa¦voq	V	–nngilaq
tunniussa¦q	N	–p, –t
tunniussaralu¦aq	N	–up, –it
tunniussine¦q	N	–rup, –rit
tunniussinerlunne¦q	N	–rup, –rit
tunniussinissa¦q	N	–p, –t
tunniussisarfi¦k	N	–up, –it
tunniussisussaatitaane¦q	N	–rup, –rit
tunniussi¦voq	V	–nngilaq
tunniuteqqunngilaa	V	(no generation)
tunniutiinnajanngits¦oq	N	–up, –ut
tunniutiinnarfig¦aa	V	–inngilaa
tunniut¦iinnarfigaa	V	{–iinnarfiginngilaa, –siinnarfiginngilaa}
tunniutiinnarne¦q	N	–rup, –rit
tunniut¦iinnarneq	N	{–iinnarnerup, –siinnarnerup}, {–iinnarnerit, –siinnarnerit}
tunniutiinna¦rpoq	V	–nngilaq
tunn¦oq	N	–up, –ut
tunnoqqort¦ooq	N	–uup, –uut
tunnorne¦q	N	–rup, –rit
tunn¦orpoq	V	–unngilaq
tunnort¦orpoq	V	–unngilaq
tunnor¦torpoq	V	{–sunngilaq, –tunngilaq}
tunnul¦ik	N	{–iup, –lip, –lup}, –lit
tunnulissu¦aq	N	–up, –it
tunnul¦issuaq	N	{–ersuup, –issuup}, {–ersuit, –issuit}
tunnull¦erpoq	V	–inngilaq
tunnuninne¦q	N	–rup, –rit
tunnuusaa¦voq	V	–nngilaq
tunnuusa¦q	N	–p, –t
tunooria¦rpoq	V	–nngilaq
tunoqqu¦ppaa	V	{–nngilaa, –tinngilaa}
tunoqqusaa¦q	N	–p, –t
tunoqqu¦tsivoq	V	{–ssinngilaq, –tsinngilaq}
tun¦oriarpoq	V	{–orianngilaq, –uterianngilaq}
tunorl¦eq	N	{–erup, –iup}, {–erit, –iit}
Tunu	N	–p, –t
Tunu	Prop	–p
tunu	N	–p, –t
tunuaanna¦rpoq	V	–nngilaq
tunuaa¦voq	V	–nngilaq
tunua¦goorpoq	V	{–guunngilaq, –tiguunngilaq}
tunualer¦soq	N	{–sup, –tup}, {–sut, –tut}
tunuaniikannerpoq	V	(no generation)
tunuanii¦ppoq	V	–nngilaq
tunuaria¦rpoq	V	–nngilaq
tunuarne¦q	N	–rup, –rit
tunuarniarne¦q	N	–rup, –rit
tunuarniut	N	–ip, –it
tunuarniuteqarne¦q	N	–rup, –rit
tunua¦rpoq	V	–nngilaq
tunuarsimaarne¦q	N	–rup, –rit
tunuarsimaa¦rpoq	V	–nngilaq
tunuarsimaart¦oq	N	–up, –ut
tunuarsimajunnaarne¦q	N	–rup, –rit
tunuarsimane¦q	N	–rup, –rit
tunuarsimaniarpoq	V	(no generation)
tunuarsimaniart¦oq	N	–up, –ut
tunuarsimasussaane¦q	N	–rup, –rit
tunuarsimasussaa¦voq	V	–nngilaq
tunuarsima¦voq	V	–nngilaq
tunuart¦erpoq	V	–inngilaq
tunuartert¦oq	N	–up, –ut
tunuarter¦toq	N	{–sup, –tup}, {–sut, –tut}
tunuarti¦ppaa	V	–nngilaa
tunuartitaagallarne¦q	N	–rup, –rit
tunuartitsi¦voq	V	–nngilaq
tunuatig¦oorpoq	V	–uunngilaq
tunua¦tigoorpoq	V	{–tiguunngilaq, –guunngilaq}
tunukkasuarpaa	V	(no generation)
tunukkiart¦orpoq	V	–unngilaq
tunule¦q	N	–rup, –rit
tunulequt	N	–ip, –it
tunulequta¦q	N	–p, –t
tunuliaqu¦siisoq	N	{–siisup, –tiliisup}, {–siisut, –tiliisut}
tunuliaqu¦siissut	N	{–siissutip, –tiliissutip}, {–siissutit, –tiliissutit}
tunuliaqu¦siortoq	N	{–siortup, –tiliortup}, {–siortut, –tiliortut}
tunuliaqut	N	–ip, –it
tunuliaqut¦serpaa	V	{–italinngilaa, –sinngilaa}
tunull¦eq	N	–iup, –iit
tun¦ullerpaaq	N	{–orlerpaap, –ullerpaap}, {–orlerpaat, –ullerpaat}
tunullersaa¦voq	V	–nngilaq
Tunulliarfi¦k	N	–up, –it
tunulliu¦ppaa	V	–tinngilaa
tunulliussaa¦voq	V	–nngilaq
tunulliussine¦q	N	–rup, –rit
tunulliussi¦voq	V	–nngilaq
tunum¦eersoq	N	{–eersup, –eertup, –inngaanneersup, –inngaanneertup}, {–eersut, –eertut, –inngaanneersut, –inngaanneertut}
tunumi¦oq	N	–up, –ut
Tunumiu	N	–p, –t
Tun¦umiu	N	{–ormiup, –umiup}, {–ormiut, –umiut}
tunumiu	N	–p, –t
tunumiuliu¦ppaa	V	–tinngilaa
tunummukaanna¦rpoq	V	–nngilaq
tunummukaa¦ppaa	V	–tinngilaa
tunummukaassi¦voq	V	–nngilaq
tunummukaassui¦voq	V	–nngilaq
tunummuka¦rpoq	V	–nngilaq
tunummukartuarsinnarpoq	V	(no generation)
tunumors¦orpoq	V	–unngilaq
tunumorsuu¦ppaa	V	–tinngilaa
tunumuka¦rpoq	V	–nngilaq
tununngasa¦rpoq	V	–nngilaq
tununngati¦ppaa	V	–nngilaa
tununngavallaa¦rpoq	V	–nngilaq
tununnga¦voq	V	–nngilaq
tununnii¦ppoq	V	–nngilaq
tunupors¦orpoq	V	–unngilaq
tunuporsorti¦ppaa	V	–nngilaa
tunuporsortua¦rpoq	V	–nngilaq
tunuporsuu¦ppaa	V	–tinngilaa
tunuporsuussa¦q	N	–p, –t
tunuporsuussi¦voq	V	–nngilaq
tunu¦ppaa	V	{–nngilaa, –tinngilaa}
tunu¦ppoq	V	–nngilaq
tunusia¦rpoq	V	–nngilaq
tunusi¦ppoq	V	–nngilaq
tunusissumii¦ppoq	V	–nngilaq
tunusi¦ssumiippoq	V	{–ssumiinngilaq, –ttumiinngilaq}
tunussima¦voq	V	–nngilaq
tunussis¦oq	N	–up, –ut
tunu¦ssisoq	N	{–ssisup, –tsisup}, {–ssisut, –tsisut}
tunussi¦voq	V	–nngilaq
tunu¦ssivoq	V	{–ssinngilaq, –tsinngilaq}
tunussutig¦aa	V	–inngilaa
tunusu¦k	N	–up, –it
tunusummii¦ppoq	V	–nngilaq
tunusummi¦oq	N	–up, –ut
tunusummi¦ppaa	V	–nngilaa
tunusummi¦ppoq	V	–nngilaq
tunutaaginna¦rpaa	V	–nngilaa
tunutaaginna¦rpoq	V	–nngilaq
tunu¦taaginnarpoq	V	{–taaginnanngilaq, –ssaaginnanngilaq}
tunutaa¦rpoq	V	–nngilaq
tunutikkumanngilaa	V	(no generation)
tunuti¦ppaa	V	–nngilaa
tunut¦ippaa	V	{–itinngilaa, –sinngilaa}
tunutsi¦ppaa	V	–nngilaa
tunut¦sippaa	V	{–sinngilaa, –itinngilaa}
tunuumisaarpoq	V	(no generation)
tupa	N	–p, –t
tupaallaat	N	–ip, –it
tupaallaataaqaaq	V	(no generation)
tupaallaataa¦voq	V	–nngilaq
tupaallaatig¦aa	V	–inngilaa
tupaallaatigisa¦q	N	–p, –t
tupaallannaqaaq	V	(no generation)
tupaallanne¦q	N	–rup, –rit
tupaallappoq	V	(no generation)
tupaallassimaqaaq	V	(no generation)
tupaallatseqaa	V	(no generation)
tupaallatsitsi¦voq	V	–nngilaq
tupaallatt¦oq	N	–up, –ut
tupaamm¦erpoq	V	–inngilaq
tupaammisaa¦rpoq	V	–nngilaq
tupaammisi¦ppaa	V	–nngilaa
tupaammi¦voq	V	–nngilaq
tupaarisuu¦voq	V	–nngilaq
tupaari¦voq	V	–nngilaq
tupaarnali¦orpoq	V	–unngilaq
tupaarna¦q	N	–p, –t
tupaarnarta¦rpoq	V	–nngilaq
tupaarngali¦orpoq	V	–unngilaq
tupaarnga¦q	N	–p, –t
tupaarngarta¦rpoq	V	–nngilaq
tupaa¦rpaa	V	–nngilaa
tupaarpoq	V	(no generation)
tupaarsu¦k	N	–up, –it
tupaarsummii¦ppoq	V	–nngilaq
tupaarsu¦ppoq	V	–nngilaq
tupaarti¦ppaa	V	–nngilaa
tupaarulluinna¦rpoq	V	–nngilaq
tupaarullu¦innarpoq	V	{–innanngilaq, –aannanngilaq}
tupaaru¦ppoq	V	–tinngilaq
tupaarutivi¦ppoq	V	–nngilaq
tupaasali¦orpoq	V	–unngilaq
tupaasa¦q	N	–p, –t
tupaasivi¦k	N	–up, –it
tupaat	N	–ip, –it
tupaataaru¦ppoq	V	–tinngilaq
tupaateqa¦rpoq	V	–nngilaq
tupaatigineqaraluaqis¦oq	N	–up, –ut
tupaat¦orpoq	V	–unngilaq
tupaatortorujussu¦uvoq	V	{–aanngilaq, –unngilaq}
tupaatuut	N	–ip, –it
tupaatuut	N, pl.	-
tupaatuutig¦aa	V	–inngilaa
tupagii¦ppoq	V	–nngilaq
tupagu¦ppaa	V	–nngilaa
tupagu¦ppoq	V	–nngilaq
tupagussi¦voq	V	–nngilaq
tupakata¦ppoq	V	–nngilaq
tupal¦erpaa	V	–inngilaa
tupaluati¦ppaa	V	–nngilaa
tupalua¦voq	V	–nngilaq
tupannangaart¦oq	N	–up, –ut
tupanngerpallaa¦rpoq	V	–nngilaq
tupanng¦erpoq	V	–inngilaq
tupa¦ppoq	V	–nngilaq
tupaq	N	(no generation)
tupartorta¦rpoq	V	–nngilaq
tuparujussuarne¦q	N	–rup, –rit
tuparu¦ppoq	V	–tinngilaq
tupasi¦voq	V	–nngilaq
tupassaanga¦voq	V	–nngilaq
tupassaari¦voq	V	–nngilaq
tupassaa¦rpaa	V	–nngilaa
tupassivi¦k	N	–up, –it
tupasunni	N	–p, –t
tupasunni¦ppoq	V	–nngilaq
tupatorne¦q	N	–rup, –rit
tupa¦torneq	N	{–sornerup, –tornerup}, {–sornerit, –tornerit}
tupat¦orpoq	V	–unngilaq
tupa¦torpoq	V	{–sunngilaq, –tunngilaq}
tupatorta¦rpoq	V	–nngilaq
tupa¦tortarpoq	V	{–sortanngilaq, –tortanngilaq}
tupatsi¦ppaa	V	–nngilaa
tupatsitsi¦voq	V	–nngilaq
tupatt¦oq	N	–up, –ut
tupattorujussuu¦voq	V	–nngilaq
tupattorujussu¦uvoq	V	{–aanngilaq, –unngilaq}
tupatuuma¦voq	V	–nngilaq
t¦upeq	N	{–oqqip, –oqqup, –upip}, –oqqit
tupeqarfi¦k	N	–up, –it
tupeqarfik¦oq	N	–up, –ut
tupeqqana¦rpoq	V	–nngilaq
tupeqqannaqaaq	V	(no generation)
tupeqqanna¦rpoq	V	–nngilaq
tupeqqannart¦oq	N	–up, –ut
tupeqqatitaa¦rpoq	V	–nngilaq
tupeqqa¦voq	V	–nngilaq
tupermiu¦voq	V	–nngilaq
tup¦erpoq	V	–inngilaq
tupersimaffi¦k	N	–up, –it
tupersima¦voq	V	–nngilaq
tupersu¦aq	N	–up, –it
tupersuaqarfiit	N, pl.	-
tupertaa¦rpoq	V	–nngilaq
tupig¦aa	V	–inngilaa
tupiginni¦ppoq	V	–nngilaq
tupigivi¦ppaa	V	–nngilaa
tupigusoriili¦ppoq	V	–nngilaq
tupigusunnaqaaq	V	(no generation)
tupigusunna¦rpoq	V	–nngilaq
tupigusunne¦q	N	–rup, –rit
tupigusu¦ppoq	V	–nngilaq
tupigusutsi¦ppaa	V	–nngilaa
tupigusutsitsi¦voq	V	–nngilaq
tupigusutt¦oq	N	–up, –ut
tupigusuutig¦aa	V	–inngilaa
tupigusuutiginninne¦q	N	–rup, –rit
tupigutsaamminarne¦q	N	–rup, –rit
tupigutsaamminart¦oq	N	–up, –ut
tupigutsaa¦ppaa	V	–tinngilaa
tupigutsaatig¦aa	V	–inngilaa
tupigutsa¦ppoq	V	–nngilaq
tupigutsasaa¦rpoq	V	–nngilaq
tupilaa¦voq	V	–nngilaq
tupila¦k	N	–ap, –at
tupila¦ppaa	V	–nngilaa
tupil¦erpoq	V	–inngilaq
tupilli¦vaa	V	–nngilaa
tupilli¦voq	V	–nngilaq
tupinnaqaaq	V	(no generation)
tupinnar¦aa	V	–inngilaa
tupinnarluinnart¦oq	N	–up, –ut
tupinna¦rpoq	V	–nngilaq
tupinnarsilat	Interj	(no generation)
tupinnart¦oq	N	–up, –ut
tupinnartulersaarut	N	–ip, –it
tupinnartulersaarutit	N, pl.	-
tupinnartulia¦q	N	–p, –t
tupinnartuli¦orpoq	V	–unngilaq
tupinnartut	N, pl.	-
tupinnavi¦ppoq	V	–nngilaq
tupinne¦q	N	–rup, –rit
tupi¦ppoq	V	–nngilaq
tupissut	N	–ip, –it
tupi¦ssut	N, pl.	{–ssut, –ttut}
tupiti¦ppaa	V	–nngilaa
tupititsinia¦rpoq	V	–nngilaq
tupititsiniut	N	–ip, –it
tupititsissut	N	–ip, –it
tu¦ppaa	V	–nngilaa
tuppalla¦ppoq	V	–nngilaq
tup¦pallappoq	V	{–allanngilaq, –pallanngilaq}
tuppall¦erpoq	V	–inngilaq
tuppallersaas¦erpaa	V	–inngilaa
tuppallersaa¦serpaa	V	{–sinngilaa, –tilinngilaa}
tuppaller¦saaserpaa	V	{–saasinngilaa, –saatilinngilaa, –taasinngilaa, –taatilinngilaa}
tuppallersaat	N	–ip, –it
tuppaller¦saat	N	{–saatip, –taatip}, {–saatit, –taatit}
tuppallersaat¦aannaasoq	N	{–aannaasup, –iinnaasup}, {–aannaasut, –iinnaasut}
tuppaller¦saataannaasoq	N	{–saataannaasup, –saatiinnaasup, –taataannaasup, –taatiinnaasup}, {–saataannaasut, –saatiinnaasut, –taataannaasut, –taatiinnaasut}
tuppallersaatig¦aa	V	–inngilaa
tuppaller¦saatigaa	V	{–saatiginngilaa, –taatiginngilaa}
tuppallersaatiginia¦rpaa	V	–nngilaa
tuppaller¦saatiginiarpaa	V	{–saatiginianngilaa, –taatiginianngilaa}
tuppallersaa¦voq	V	–nngilaq
tuppallersa¦rpaa	V	–nngilaa
tuppallersi¦ppaa	V	–nngilaa
tuppalliu¦ppaa	V	–tinngilaa
tuppalliut	N	–ip, –it
tuppalliutig¦aa	V	–inngilaa
tuppalliutivi¦ppaa	V	–nngilaa
tupparikkunnaa¦rpoq	V	–nngilaq
tuppari¦ppoq	V	–nngilaq
tupparissi¦voq	V	–nngilaq
tuppat	N	–ip, –it
tuppatig¦aa	V	–inngilaa
tuppi¦orpoq	V	–unngilaq
tuppiort¦oq	N	–up, –ut
tuppisaat	N	–ip, –it
tuppisaataa¦voq	V	–nngilaq
tuppisaatig¦aa	V	–inngilaa
tuppisa¦rpoq	V	–nngilaq
tuppisartaanna¦rpoq	V	–nngilaq
tu¦ppoq	V	–nngilaq
tupput	N	–ip, –it
tupputaa¦voq	V	–nngilaq
tuputa¦q	N	–p, –t
tusaaginna¦rpaa	V	–nngilaa
tusaaginna¦rpoq	V	–nngilaq
tusaajumasa¦rpaa	V	–nngilaa
tusaallua¦rpaa	V	–nngilaa
tusaallua¦rpoq	V	–nngilaq
tusaamana¦rpoq	V	–nngilaq
tusaamasaane¦q	N	–rup, –rit
tusaamasaas¦oq	N	–up, –ut
tusaamasaa¦voq	V	–nngilaq
tusaamasa¦q	N	–p, –t
tusaamasars¦orpoq	V	–unngilaq
tusaamasar¦sorpoq	V	{–sunngilaq, –tunngilaq}
tusaama¦vaa	V	–nngilaa
tusaama¦voq	V	–nngilaq
tusaammasiinnars¦orpoq	V	–unngilaq
tusaaneqannginnguatsiavippoq	V	(no generation)
tusaanngilaq	V	(no generation)
tusaanngisa¦q	N	–p, –t
tusaanngitsoorpaa	V	(no generation)
tusaanngitsoorpoq	V	(no generation)
tusaaqqissaarne¦q	N	–rup, –rit
tusaasaaru¦ppoq	V	–tinngilaq
tusaasa¦q	N	–p, –t
tusaasinnaane¦q	N	–rup, –rit
tusaasinnaassu¦seq	N	–tsip, –tsit
tusaas¦oorpaa	V	–uunngilaa
tusaassut	N	–ip, –it
tusaassutitaa¦rpoq	V	–nngilaq
tusaasuui¦voq	V	–nngilaq
tusaasuu¦voq	V	–nngilaq
tusaati¦ppaa	V	–nngilaa
tusaatissa¦q	N	–p, –t
tusaa¦vaa	V	–nngilaa
tusaa¦voq	V	–nngilaq
tusagaa¦voq	V	–nngilaq
tusagaluu¦voq	V	–nngilaq
tusa¦gaq	N	–kkap, –kkat
tusagaqa¦rpoq	V	–nngilaq
tusagassa¦q	N	–p, –t
tusagasseerpalaart¦oq	N	–up, –ut
tusagassia¦q	N	–p, –t
tusagassii¦vik	N	{–ffiup, –viup}, {–ffiit, –viit}
tusagass¦iorfiit	N, pl.	{–aliorfiit, –iorfiit}
tusagass¦iorfik	N	{–aliorfiup, –iorfiup}, {–aliorfiit, –iorfiit}
tusagass¦ioriaaseq	N	{–alioriaatsip, –ioriaatsip}, {–alioriaatsit, –ioriaatsit}
tusagass¦iorneq	N	{–aliornerup, –iornerup}, {–aliornerit, –iornerit}
Tusagassiornermut Immikkoortorta¦q	Prop	–p
tusagass¦iortoq	N	{–aliortup, –iortup}, {–aliortut, –iortut}
tusagass¦iortut	N, pl.	{–aliortut, –iortut}
tusagass¦iortuuneq	N	{–aliortuunerup, –iortuunerup}, {–aliortuunerit, –iortuunerit}
tusagassiuine¦q	N	–rup, –rit
tusagassiu¦tilerineq	N	{–serinerup, –tilerinerup, –userinerup, –utilerinerup}, {–serinerit, –tilerinerit, –userinerit, –utilerinerit}
tusagassiu¦tit	N, pl.	{–tit, –utit}
tusagassiu¦ut	N	{–tip, –utip}, {–tit, –utit}
tusagassiu¦uteqarfik	N	{–teqarfiup, –uteqarfiup}, {–teqarfiit, –uteqarfiit}
tusagassiu¦uteqarneq	N	{–teqarnerup, –uteqarnerup}, {–teqarnerit, –uteqarnerit}
tusagassiu¦utilerineq	N	{–serinerup, –tilerinerup, –userinerup, –utilerinerup}, {–serinerit, –tilerinerit, –userinerit, –utilerinerit}
tusagassiu¦utit	N, pl.	{–tit, –utit}
tusajaanngilaa	V	(no generation)
tusajaa¦rpaa	V	–nngilaa
tusajaa¦rpoq	V	–nngilaq
tusajarsui¦voq	V	–nngilaq
tusajarsu¦ppaa	V	–nngilaa
tusajuananngilaq	V	(no generation)
tusajuananngivi¦ppoq	V	–nngilaq
tusakatannaqaaq	V	(no generation)
tusakata¦ppaa	V	–nngilaa
tusakulu¦ppoq	V	–nngilaq
tusakulutsi¦ppaa	V	–nngilaa
tusakulutsitsi¦voq	V	–nngilaq
tusakulut¦sitsivoq	V	{–sitsinngilaq, –itsinngilaq}
tusaner¦aaq	V	–inngilaq
tusanerisoqaqaaq	V	(no generation)
tusangiasaarine¦q	N	–rup, –rit
tusangiasaari¦voq	V	–nngilaq
tusangiasaa¦rpaa	V	–nngilaa
tusangiasaarti¦ppoq	V	–nngilaq
tusangiatsaa¦ppaa	V	–tinngilaa
tusangiatsajas¦oq	N	–up, –ut
tusangiatsa¦ppoq	V	–nngilaq
tusanngisaanna¦rpaa	V	–nngilaa
tusanngisaanna¦rpoq	V	–nngilaq
tusanngitsoorpaa	V	(no generation)
tusanngug¦aa	V	–inngilaa
tusannguna¦rpoq	V	–nngilaq
tusannguu¦ppaa	V	–tinngilaa
tusannguussi¦voq	V	–nngilaq
tusannguutivi¦ppaa	V	–nngilaa
tusanngu¦voq	V	–nngilaq
tusaqqajarpaa	V	(no generation)
tusaqqaja¦rpoq	V	–nngilaq
tusaqqammerpaa	V	(no generation)
tusaqqarpaa	V	(no generation)
tusaqqoornart¦oq	N	–up, –ut
tusaqq¦oorpaa	V	–uunngilaa
tusaqq¦oorpoq	V	–uunngilaq
tusaqqusaa¦rpoq	V	–nngilaq
tusaqquui¦voq	V	–nngilaq
tusarajuppaa	V	(no generation)
tusarfig¦aa	V	–inngilaa
tusarfigiti¦ppoq	V	–nngilaq
tusarfi¦k	N	–up, –it
tusariat	N, pl.	-
tusarlerneqarne¦q	N	–rup, –rit
tusarl¦erpaa	V	–inngilaa
tusarlersig¦aa	V	–inngilaa
tusarliisig¦aa	V	–inngilaa
tusarlii¦sigaa	V	–tiginngilaa
tusarliis¦oq	N	–up, –ut
Tusarliivi¦k	N	{–iup, –up}, {–iit, –it}
Tusarliivi¦k	N	–up, –it
tusarlii¦voq	V	–nngilaq
tusarlinngilaa	V	(no generation)
tusarliu¦ppaa	V	–tinngilaa
tusarliu¦ppoq	V	–tinngilaq
tusarliussa¦q	N	–p, –t
tusarliussine¦q	N	–rup, –rit
tusarliuteqqusaanngits¦oq	N	–up, –ut
tusarliut¦eqqusaanngitsoq	N	{–eqqusaanngitsup, –seqqusaanngitsup}, {–eqqusaanngitsut, –seqqusaanngitsut}
tusarliutig¦aa	V	–inngilaa
tusarlua¦rpaa	V	–nngilaa
tusarlua¦rpoq	V	–nngilaq
tusarnaagassia¦q	N	–p, –t
tusarnaariart¦orpaa	V	–unngilaa
tusarnaarluarti¦ppaa	V	–nngilaa
tusarnaarneqa¦rpoq	V	–nngilaq
tusarnaa¦rpaa	V	–nngilaa
tusarnaa¦rpoq	V	–nngilaq
tusarnaartitsine¦q	N	–rup, –rit
tusarnaartitsissutigineqartussat	N, pl.	-
tusarnaart¦oq	N	–up, –ut
tusarnaartut	N, pl.	-
tusarnaarumallaaraaq	V	(no generation)
tusarnaarut	N	–ip, –it
tusarnar¦aa	V	–inngilaa
tusarna¦rpaa	V	–nngilaa
tusarnarta¦q	N	–p, –t
tusarneqis¦oq	N	–up, –ut
tusarnerlu¦ppoq	V	–nngilaq
tusarn¦erpoq	V	–inngilaq
tusarners¦oq	N	–up, –ut
tusarner¦soq	N	{–sup, –tup}, {–sut, –tut}
tusarnertoqaaq	V	(no generation)
tusarnga¦rpaa	V	–nngilaa
tusarngarta¦q	N	–p, –t
tusarniaane¦q	N	–rup, –rit
tusarniaassut	N	–ip, –it
tusarniaasussaatitaane¦q	N	–rup, –rit
tusarniig¦aa	V	–inngilaa
tusarnii¦ppoq	V	–nngilaq
tusarniissu¦seq	N	–tsip, –tsit
tusarniits¦oq	N	–up, –ut
tusarnissu¦seq	N	–tsip, –tsit
tusa¦rpaa	V	–nngilaa
tusa¦rpoq	V	–nngilaq
tusarsaajunnaa¦rpoq	V	–nngilaq
tusarsaas¦oq	N	–up, –ut
tusarsaa¦voq	V	–nngilaq
tusarsinnaa¦vaa	V	–nngilaa
tusartaat	N	–ip, –it
tusartaa¦tilerineq	N	{–serinerup, –tilerinerup}, {–serinerit, –tilerinerit}
tusarti	N	–p, –t
tusartuarpaa	V	(no generation)
tusasaarpoq	V	(no generation)
tusassaa¦rpaa	V	–nngilaa
tusassaa¦rpoq	V	–nngilaq
tusassaa¦voq	V	–nngilaq
tusassarl¦erpoq	V	–inngilaq
tusatsia¦gaq	N	–kkap, –kkat
tusatsiarpoq	V	(no generation)
tusialaa¦rpoq	V	–nngilaq
tusiapillaa¦voq	V	–nngilaq
tusia¦ppoq	V	–nngilaq
tusilarluinnart¦oq	N	–up, –ut
tusilarne¦q	N	–rup, –rit
tusila¦rpoq	V	–nngilaq
tusilartaanna¦rpoq	V	–nngilaq
tusilart¦oq	N	–up, –ut
tusilartoqarfi¦k	N	–up, –it
tusilartuiu¦voq	V	–nngilaq
tusillaatig¦aa	V	–inngilaa
tusillakkiart¦orpoq	V	–unngilaq
tusillannart¦oq	N	–up, –ut
tusilla¦ppoq	V	–nngilaq
tusilla¦rpoq	V	–nngilaq
tusind	Num	{–it, –ip}, –it
tusindilikkaat	N, pl.	-
tusinnaa¦voq	V	–nngilaq
tusinna¦q	N	–p, –t
tusinti	Num	(no generation)
tussaallaqqi¦ppoq	V	–nngilaq
Tussaa¦q	N	–p, –t
Tussaa¦q	Prop	–p
Tussa¦aq	V	–nngilaq
tussaa¦rpoq	V	–nngilaq
tussaa¦voq	V	–nngilaq
tussamisaa¦rpaa	V	–nngilaa
tussapinna¦rpoq	V	–nngilaq
tussapi¦ppoq	V	–nngilaq
tussa¦rpaa	V	–nngilaa
tuss¦erpaa	V	–inngilaa
tussiaasi¦orpoq	V	–unngilaq
tussiaa¦siorpoq	V	{–siunngilaq, –tiliunngilaq}
tussiaasiort¦oq	N	–up, –ut
tussiaa¦siortoq	N	{–siortup, –tiliortup}, {–siortut, –tiliortut}
tussiaat	N	–ip, –it
tussiaatig¦aa	V	–inngilaa
Tussiaatit	N, pl.	-
tussiaqattaa¦rpoq	V	–nngilaq
tussiaqattaartut	N, pl.	-
tussiaqattaarutit	N, pl.	-
tussiarfig¦aa	V	–inngilaa
tussiarfissu¦aq	N	–up, –it
tussia¦rpoq	V	–nngilaq
tussiarumatoqaaq	V	(no generation)
tussiataa¦rpoq	V	–nngilaq
tussi¦k	N	–up, –it
tussiu¦ppaa	V	–tinngilaa
tussiu¦siorneq	N	{–siornerup, –tiliornerup}, {–siornerit, –tiliornerit}
tussiussis¦oq	N	–up, –ut
tussiussi¦voq	V	–nngilaq
tussiut	N	–ip, –it
tussiutaarut	N	–ip, –it
tussiutaasat	N, pl.	-
tussiutaa¦voq	V	–nngilaq
tussiutig¦aa	V	–inngilaa
tussiutit	N, pl.	-
tussiutitaa¦rpoq	V	–nngilaq
tussiuttuinna¦rpaa	V	–nngilaa
tussuninna¦rpoq	V	–nngilaq
tussuni¦ppoq	V	–nngilaq
tussunngunart¦oq	N	–up, –ut
tussunngus¦oq	N	–up, –ut
tussunngu¦voq	V	–nngilaq
tussut	N	–ip, –it
tussutissa¦q	N	–p, –t
tussutit	N, pl.	-
tusug¦aa	V	–inngilaa
tusunert¦ooq	N	–uup, –uut
tusunngu¦voq	V	–nngilaq
tusu¦voq	V	–nngilaq
tute¦raq	N	–qqap, –qqat
tuteri¦aq	N	–ssap, –ssat
tutinerlu¦ppoq	V	–nngilaq
tutinertu¦voq	V	–nngilaq
tutinne¦q	N	–rup, –rit
tuti¦ppaa	V	–nngilaa
tutisi¦voq	V	–nngilaq
tutis¦oorpaa	V	–uunngilaa
tuti¦vaa	V	–nngilaa
tuti¦voq	V	–nngilaq
tutoqa¦rpoq	V	–nngilaq
tutsa¦q	N	–p, –t
tutsaqanngilaq	V	(no generation)
tutsarii¦ppoq	V	–nngilaq
tutsari¦ppoq	V	–nngilaq
tutsarissi¦voq	V	–nngilaq
tutsarli¦orpaa	V	–unngilaa
tutsarli¦orpoq	V	–unngilaq
tutsarlui¦voq	V	–nngilaq
tutsarlunne¦q	N	–rup, –rit
tutsarlu¦ppaa	V	–nngilaa
tutsarlu¦ppoq	V	–nngilaq
tutsarlutt¦oq	N	–up, –ut
tutsi¦ppaa	V	–nngilaa
tutsiukkalua¦rpoq	V	–nngilaq
tutsiullua¦rpoq	V	–nngilaq
tutsiunnerlu¦ppoq	V	–nngilaq
tutsiu¦ppaa	V	–tinngilaa
tutsiu¦ppoq	V	–tinngilaq
tutsiveeru¦ppoq	V	–tinngilaq
tutsuig¦aa	V	–inngilaa
tutsuiginaqaaq	V	(no generation)
tutsuigina¦rpoq	V	–nngilaq
tutsuiginart¦oq	N	–up, –ut
tutsuiginassu¦seq	N	–tsip, –tsit
tutsuiginngilaa	V	(no generation)
tutsuiginninnginne¦q	N	–rup, –rit
tutsut	N	–ip, –it
tutsutig¦aa	V	–inngilaa
tutsutiginngilaa	V	(no generation)
tuttorsuali¦ppaa	V	–nngilaa
tuttorsu¦aq	N	–up, –it
tuttorujussu¦aq	N	–up, –it
Tuttu	N	–p, –t
tuttu	N	–p, –t
tuttuaraa¦voq	V	–nngilaq
tuttua¦raq	N	–qqap, –qqat
tuttuara¦rpoq	V	–nngilaq
tuttua¦voq	V	–nngilaq
tuttunngu¦aq	N	–up, –it
tuttunnialersaarpoq	V	(no generation)
tuttunnia¦q	N	–p, –t
tuttunniarajuppoq	V	(no generation)
tuttunniarfi¦k	N	–up, –it
tuttunniarfimmii¦ppoq	V	–nngilaq
tuttunniarne¦q	N	–rup, –rit
tuttunniarpassuit	N, pl.	-
tuttunnia¦rpoq	V	–nngilaq
tuttu¦ppoq	V	–nngilaq
tuttusinia¦rpoq	V	–nngilaq
tuttusisinnaanngilaq	V	(no generation)
tuttusi¦voq	V	–nngilaq
tuttussassiissutit	N, pl.	-
tuttusunnialaa¦q	N	–p, –t
tuttut	N, pl.	-
tuttuta¦q	N	–p, –t
tuttutar¦aa	V	–inngilaa
tuttutarpassuaqa¦rpoq	V	–nngilaq
tuttut¦ooq	N	–uup, –uut
tuttutsuilli¦voq	V	–nngilaq
tuttutsui¦ppoq	V	–nngilaq
tuttuttaanna¦rpoq	V	–nngilaq
tuttuusa¦q	N	–p, –t
tuttuuteqarfi¦k	N	–up, –it
tuttuuteqarne¦q	N	–rup, –rit
tuttuutil¦ik	N	{–iup, –lip, –lup}, –lit
tutu¦k	N	–up, –it
tutukkunnaa¦rpoq	V	–nngilaq
tutunnguukkiart¦orpoq	V	–unngilaq
tutunnguu¦ppoq	V	–tinngilaq
tutunnguussinnaa¦voq	V	–nngilaq
tutu¦ppoq	V	–nngilaq
tutussu¦aq	N	–up, –it
tuuaaki¦ppoq	V	–nngilaq
tuuaakivi¦ppoq	V	–nngilaq
tuuaal¦ik	N	{–iup, –lip, –lup}, –lit
tuuaali¦ppoq	V	–nngilaq
tuuaalissu¦aq	N	–up, –it
tuuaal¦issuaq	N	{–ersuup, –issuup}, {–ersuit, –issuit}
tuuaa¦q	N	–p, –t
tuualla¦ppoq	V	–nngilaq
tuuffi¦k	N	–up, –it
tuuffilers¦orpaa	V	–unngilaa
tuugaaki¦ppoq	V	–nngilaq
tuugaakivi¦ppoq	V	–nngilaq
tuugaal¦ik	N	{–iup, –lip, –lup}, –lit
tuugaali¦ppoq	V	–nngilaq
tuugaalissu¦aq	N	–up, –it
tuugaal¦issuaq	N	{–ersuup, –issuup}, {–ersuit, –issuit}
tuugaa¦q	N	–p, –t
tuugaarmi¦ppoq	V	–nngilaq
tuuju¦k	N	–up, –it
tuuju¦ppaa	V	–nngilaa
tuukkaaja¦rpoq	V	–nngilaq
tuukkaal¦ik	N	{–iup, –lip, –lup}, –lit
tuukkaars¦erpoq	V	–inngilaq
tuukkal¦erpoq	V	–inngilaq
tuukkal¦ik	N	{–iup, –lip, –lup}, –lit
tuukka¦q	N	–p, –t
tuukkarsual¦ik	N	{–iup, –lip, –lup}, –lit
tuukkartaa¦rpoq	V	–nngilaq
tuukk¦erpaa	V	–inngilaa
tuukk¦erpoq	V	–inngilaq
tuulli¦k	N	–up, –it
tuullingusaa¦q	N	–p, –t
tuullinnia¦rpoq	V	–nngilaq
tuulli¦ppoq	V	–nngilaq
tuumialla¦ppoq	V	–nngilaq
tuumi¦voq	V	–nngilaq
tuummassi¦voq	V	–nngilaq
tuummissutig¦aa	V	–inngilaa
t¦uummissutigaa	V	{–ooVCummissutiginngilaa, –uujummissutiginngilaa, –uummissutiginngilaa}
tuummi¦voq	V	–nngilaq
tuunngusa¦q	N	–p, –t
tuunngusa¦rpaa	V	–nngilaa
tuu¦ppaa	V	–tinngilaa
tuu¦ppoq	V	–tinngilaq
tuusaa¦q	N	–p, –t
tuusaa¦voq	V	–nngilaq
tuusa¦k	N	–ap, –at
tuusa¦q	N	–p, –t
tuusassu¦aq	N	–up, –it
tuusinti	Num	(no generation)
tuusintillit	N	(no generation)
tuussa¦q	N	–p, –t
tuussaqqi¦ppoq	V	–nngilaq
tuussarsi¦voq	V	–nngilaq
tuussassia¦q	N	–p, –t
tuussia¦q	N	–p, –t
tuussi¦voq	V	–nngilaq
tuussut	N	–ip, –it
tuussutaa¦voq	V	–nngilaq
tuutsine¦q	N	–rup, –rit
tuutsinert¦ooq	N	–uup, –uut
tuutsinn¦erpoq	V	–inngilaq
tuutsi¦voq	V	–nngilaq
tv-qarfi¦k	N	–up, –it
Tyrkiam¦eersoq	N	{–eersup, –eertup, –inngaanneersup, –inngaanneertup}, {–eersut, –eertut, –inngaanneersut, –inngaanneertut}
Tyrkiamioq	N	(no generation)
Tyrkiamiu	N	–p, –t
tysk¦eq	N	–ip, –it
tyskit	N, pl.	-
