Lexeme	WC	Flexion
A-vitamini	N	–p, –t
abbed	N	–ip, –it
aborr¦e	N	–ip, {–er, –it}
abrikos	N	–ip, –it
abrikosi	N	–p, –t
AC-fuldmægtig	N	–ip, –it
accelerator	N	–ip, –it
adjunkti	N	–p, –t
administrationi	N	–p, –t
admiral	N	–ip, –it
admirali	N	–p, –t
adrenalini	N	–p, –t
adress¦e	N	–ip, {–er, –it}
adresseqanngits¦oq	N	–up, –ut
adress¦i	N	–ip, {–er, –it}
adventi	N	–p, –t
adventisiort¦oq	N	–up, –ut
adventisiortuune¦q	N	–rup, –rit
adventisti	N	–p, –t
advokati	N	–p, –t
aerobicerta¦rpoq	V	–nngilaq
afghaneri	N	–p, –t
aftenskol¦e	N	–ip, {–er, –it}
aftenskol¦erpoq	V	–inngilaq
aftenskol¦i	N	–ip, {–er, –it}
agati	N	–p, –t
agurki	N	–p, –t
aids	N	–ip, –it
airbus	N	–ip, –it
akademiingeniør	N	–ip, –it
akelej¦e	N	–ip, {–er, –it}
akkumulatori	N	–p, –t
akseli	N	–p, –t
aktantmodeli	N	–p, –t
aktia	N	–p, –t
aktiaagallart¦oq	N	–up, –ut
aktiaatil¦ik	N	{–iup, –lip, –lup}, –lit
aktiasine¦q	N	–rup, –rit
aktieselskabi	N	–p, –t
akut	N	–ip, –it
aleers¦erpoq	V	–inngilaq
aleni	N	–p, –t
alersaannaa¦voq	V	–nngilaq
alfabet	N	–ip, –it
algebra	N	–p, –t
alig¦aa	V	–inngilaa
alinnassu¦seq	N	–tsip, –tsit
alissa¦q	N	–p, –t
aliss¦iorpoq	V	{–aliunngilaq, –iunngilaq}
alittoorne¦q	N	–rup, –rit
allanit	N	–ip, –it
allerne¦q	N	–rup, –rit
allerpalaa¦q	N	–p, –t
all¦erpoq	V	–inngilaq
alliallanne¦q	N	–rup, –rit
allianii¦ppoq	V	–nngilaq
alligatori	N	–p, –t
allilerine¦q	N	–rup, –rit
alliliine¦q	N	–rup, –rit
allinngorti¦ppaa	V	–nngilaa
alliut	N	–ip, –it
alliuti¦ppaa	V	–nngilaa
alliu¦voq	V	–nngilaq
altani	N	–p, –t
amatøri	N	–p, –t
ambassad¦e	N	–ip, {–er, –it}
ambassadeqarfi¦k	N	–up, –it
ambassad¦i	N	–ip, {–er, –it}
ambassadøri	N	–p, –t
ambulanc¦e	N	–ip, {–er, –it}
amen	N	–ip, –it
amper¦e	N	–ip, {–er, –it}
amteqarfi¦k	N	–up, –it
ananas¦si	N	{–-ip, –sip}, {–-it, –sit}
anatomi	N	{–ip, –p}, {–it, –t}
anatomi	N	–p, –t
aneeru¦ppaa	V	–tinngilaa
aneqqu¦aa	V	–nngilaa
aneqqusaajunnaarallarfi¦k	N	–up, –it
aneqqusaajunnaarallarne¦q	N	–rup, –rit
aneqqusaajunnaarallart¦oq	N	–up, –ut
anerlaaju¦voq	V	–nngilaq
anerlaa¦q	N	–p, –t
anerneeru¦ppoq	V	–tinngilaq
anerne¦q	N	–rup, –rit
anerneqarfiit	N, pl.	-
anerneri¦ssaasiorpoq	V	{–ssaasiunngilaq, –ssaatiliunngilaq, –ttaasiunngilaq, –ttaatiliunngilaq}
anerneri¦ssaat	N	{–ssaatip, –ttaatip}, {–ssaatit, –ttaatit}
anernikilliorne¦q	N	–rup, –rit
anernikilliortarne¦q	N	–rup, –rit
anernil¦ik	N	{–iup, –lip, –lup}, –lit
anernilu¦ppoq	V	–nngilaq
anernipilu¦k	N	–up, –it
anerpallassa¦aq	V	–nngilaq
anerpalu¦ppoq	V	–nngilaq
anersaamissutig¦aa	V	–inngilaa
anersaarfig¦aa	V	–inngilaa
anersaa¦rpoq	V	–nngilaq
anersaartorfig¦aa	V	–inngilaa
anersaartorfi¦k	N	–up, –it
anersaartorne¦q	N	–rup, –rit
anersaartuut	N	–ip, –it
anersa¦rpaa	V	–nngilaa
anerteqine¦q	N	–rup, –rit
an¦i	N	–ip, {–er, –it}
anilaarfi¦k	N	–up, –it
anilaarfittaa¦rpoq	V	–nngilaq
anilaa¦rpoq	V	–nngilaq
anileralua¦rpoq	V	–nngilaq
aniler¦eerpoq	V	–iinngilaq
anileruna¦rpoq	V	–nngilaq
anillanne¦q	N	–rup, –rit
anillannerit	N, pl.	-
anillatsi¦ppaa	V	–nngilaa
anillatsita¦q	N	–p, –t
animation	N	–ip, –it
animi¦oq	N	–up, –ut
aningaasaasivi¦k	N	–up, –it
aningaasartuut	N	–ip, –it
aningaasartuutaasart¦oq	N	–up, –ut
aningaasartuuteqarfi¦k	N	–up, –it
aningaasartuutit	N, pl.	-
aningaasartuutitaqangaatsiart¦oq	N	–up, –ut
aningaasartuutitaqanngits¦oq	N	–up, –ut
aningaaserisarfi¦k	N	–up, –it
aningaaseris¦oq	N	–up, –ut
aningaasivi¦k	N	–up, –it
aningaasivili¦orpoq	V	–unngilaq
aningaasivimmii¦ppoq	V	–nngilaq
aninngil¦erpoq	V	–inngilaq
an¦ipallappoq	V	{–erpallanngilaq, –ipallanngilaq}
an¦ipallattarpoq	V	{–erpallattanngilaq, –ipallattanngilaq}
aniserfig¦aa	V	–inngilaa
aniserfi¦k	N	–up, –it
anis¦erpoq	V	–inngilaq
anisersimaffi¦k	N	–up, –it
anisitaane¦q	N	–rup, –rit
anisitaa¦voq	V	–nngilaq
anisi¦voq	V	–nngilaq
anissaa¦rpoq	V	–nngilaq
anissangati¦ppaa	V	–nngilaa
anissanga¦voq	V	–nngilaq
anita¦q	N	–p, –t
anitsiarfi¦k	N	–up, –it
an¦ituarpoq	V	–ertuanngilaq
annonc¦e	N	–ip, {–er, –it}
annukull¦erpoq	V	–inngilaq
annuleria¦taarpoq	V	{–saanngilaq, –taanngilaq}
anoreksi¦i	N	{–ip, –p}, {–it, –t}
antabus¦si	N	{–-ip, –sip}, {–-it, –sit}
antabus¦sitorpoq	V	{–-isunngilaq, –-itunngilaq, –sisunngilaq, –situnngilaq}
antenn¦e	N	–ip, {–er, –it}
antenn¦i	N	–ip, {–er, –it}
antologi	N	–ip, –it
antologi	N	–p, –t
antropologi	N	–ip, –it
antropologi	N	–p, –t
antropologii	N	–p, –t
anusig¦aa	V	–inngilaa
anusinng¦orpoq	V	–unngilaq
anusinngorsa¦rpaa	V	–nngilaa
anusinngujuissu¦seq	N	–tsip, –tsit
anusinngujuits¦oq	N	–up, –ut
anusinnguu¦ppaa	V	–tinngilaa
arabereqarfi¦k	N	–up, –it
arbejdsmarkedskonsulenti	N	–p, –t
areali	N	–p, –t
arki	N	–p, –t
arkitekti	N	–p, –t
arkivi	N	–p, –t
arn¦i	N	–ip, {–er, –it}
arveprinsi	N	–p, –t
asbesti	N	–p, –t
aserne¦q	N	–rup, –rit
aserniki¦ppoq	V	–nngilaq
aserpasi¦ppoq	V	–nngilaq
asfalti	N	–p, –t
asialui¦ppoq	V	–nngilaq
asialu¦ppoq	V	–nngilaq
Asiamiu	N	–p, –t
asiaqatig¦aa	V	–inngilaa
asiarne¦q	N	–rup, –rit
asia¦rpoq	V	–nngilaq
asiarsima¦voq	V	–nngilaq
assistenti	N	–p, –t
astrologi	N	–ip, –it
astrologi	N	–p, –t
atlas¦si	N	{–-ip, –sip}, {–-it, –sit}
atombombit	N, pl.	-
atomi	N	–p, –t
atomi¦tortoq	N	{–sortup, –tortup}, {–sortut, –tortut}
attesti	N	–p, –t
ATV	N	–-t
autism¦e	N	–ip, {–er, –it}
autisti	N	–p, –t
autistiu¦voq	V	–nngilaq
automati	N	–p, –t
avil¦erpoq	V	–inngilaq
avilia¦q	N	–p, –t
avissaarne¦q	N	–rup, –rit
avissaa¦rpoq	V	–nngilaq
avissaartuune¦q	N	–rup, –rit
avissaavinne¦q	N	–rup, –rit
avissaa¦voq	V	–nngilaq
avitaane¦q	N	–rup, –rit
avita¦q	N	–p, –t
avitt¦oorpoq	V	–uunngilaq
aviutitsi¦voq	V	–nngilaq
aviu¦voq	V	–nngilaq
B-vitamini	N	–p, –t
bachelor	N	–ip, –it
bachelori	N	–p, –t
bachelorinngorniarne¦q	N	–rup, –rit
backi	N	–p, –t
baconi	N	–p, –t
badmintoni	N	–p, –t
bagepapiri	N	–p, –t
bajeri	N	–p, –t
bakk¦e	N	–ip, {–er, –it}
bakk¦i	N	–ip, {–er, –it}
bakteria	N	–p, –t
bakteriaajaat	N	–ip, –it
bakteriaqanngits¦oq	N	–up, –ut
bakteriat	N, pl.	-
ballad¦e	N	–ip, {–er, –it}
ballasti	N	–p, –t
ballet	N	–ip, –it
bams¦e	N	–ip, {–er, –it}
bams¦i	N	–ip, {–er, –it}
banani	N	–p, –t
banegårdi	N	–p, –t
banj¦o	N	–up, –ut
bankassistenti	N	–p, –t
bankbogi	N	–p, –t
banki	N	–p, –t
bank¦o	N	–up, –ut
bankorne¦q	N	–rup, –rit
baptisti	N	–p, –t
bartenderi	N	–p, –t
basalti	N	–p, –t
basareqa¦rpoq	V	–nngilaq
bas¦e	N	–ip, {–er, –it}
bastioni	N	–p, –t
batteri	N	{–ip, –p}, {–it, –t}
batteri¦i	N	{–ip, –p}, {–it, –t}
batteri¦ilersorpaa	V	{–ilersunngilaa, –lersunngilaa}
batteri¦ilersorpoq	V	{–ilersunngilaq, –lersunngilaq}
baviani	N	–p, –t
beduini	N	–p, –t
begrebi	N	–p, –t
behaviorism¦i	N	–ip, {–er, –it}
benvarmeri	N	–p, –t
benzin	N	–ip, –it
bestyrels¦e	N	–ip, {–er, –it}
bestyrels¦i	N	–ip, {–er, –it}
bibliografi	N	{–ip, –p}, {–it, –t}
bibliotekari	N	–p, –t
biblioteki	N	–p, –t
bilagi	N	–p, –t
billard	N	–ip, –it
billarderne¦q	N	–rup, –rit
billardi	N	–p, –t
billet	N	–ip, –it
billetileris¦oq	N	–up, –ut
billion	N	–ip, –it
billioni	N	–p, –t
bing¦o	N	–up, –ut
bing¦orpoq	V	–unngilaq
biografi	N	{–ip, –p}, {–it, –t}
biografi	N	–p, –t
biografi¦i	N	{–ip, –p}, {–it, –t}
biolog	N	–ip, –it
biologi	N	–ip, –it
biologi	N	–p, –t
biologii	N	–p, –t
biopsi	N	{–ip, –p}, {–it, –t}
bioteknologi	N	–ip, –it
bioteknologi	N	–p, –t
birkesi	N	–p, –t
biskop	N	–ip, –it
biskopi	N	–p, –t
bismeri	N	–p, –t
blanket	N	–ip, –it
blok	N	–ip, –it
blokfløjt¦e	N	–ip, {–er, –it}
blokfløjt¦i	N	–ip, {–er, –it}
bloktilskudi	N	–p, –t
blomkål	N	–ip, –it
blomkåli	N	–p, –t
boksi	N	–p, –t
bonus¦si	N	{–-ip, –sip}, {–-it, –sit}
borgmester	N	–ip, –it
borgmesteri	N	–p, –t
borgmesteriune¦q	N	–rup, –rit
borgmesteriusimas¦oq	N	–up, –ut
bowlingerne¦q	N	–rup, –rit
brainstorming	N	–ip, –it
bredbånd	N	–ip, –it
bridg¦e	N	–ip, {–er, –it}
brint	N	–ip, –it
brinti	N	–p, –t
bronz¦e	N	–ip, {–er, –it}
bronzinnanniunne¦q	N	–rup, –rit
bronzinna¦ppoq	V	–nngilaq
Brugseni	N	–p, –t
brugseni	N	–p, –t
brugsforeningit	N, pl.	-
brugsi	N	–p, –t
brøki	N	–p, –t
bulimi¦i	N	{–ip, –p}, {–it, –t}
bulldozer	N	–ip, –it
bulldozeri	N	–p, –t
bundgarnersorne¦q	N	–rup, –rit
bundgarnit	N, pl.	-
bungalowi	N	–p, –t
busserne¦q	N	–rup, –rit
bus¦si	N	{–-ip, –sip}, {–-it, –sit}
bus¦sit	N, pl.	{–-it, –sit}
bus¦siutileqatigiiffik	N	{–-iutileqatigiiffiup, –siutileqatigiiffiup, –-iuseqatigiiffiup, –siuseqatigiiffiup}, {–-iutileqatigiiffiit, –siutileqatigiiffiit, –-iuseqatigiiffiit, –siuseqatigiiffiit}
bygderåd	N	–ip, –it
bygderådi	N	–p, –t
byggelederi	N	–p, –t
bånd	N	–ip, –it
båndi	N	–p, –t
båndoptager	N	–ip, –it
båndoptageri	N	–p, –t
børnehav¦e	N	–ip, {–er, –it}
børst¦e	N	–ip, {–er, –it}
børste¦rpaa	V	–nngilaa
børstiliort¦oq	N	–up, –ut
børstit	N, pl.	-
C-vitamini	N	–p, –t
cadmium	N	–ip, –it
campeqarfi¦k	N	–up, –it
cand. mag.	N	–ip, –it
cannabis	N	–ip, –it
cell¦e	N	–ip, {–er, –it}
cell¦o	N	–up, –ut
cellofan	N	–ip, –it
cellofani	N	–p, –t
celsius	N	–ip, –it
celsiusi	N	–p, –t
cement	N	–ip, –it
cementi	N	–p, –t
cementili¦orpoq	V	–unngilaq
censori	N	–p, –t
centeri	N	–p, –t
centiliteri	N	–p, –t
centrifug¦e	N	–ip, {–er, –it}
champagn¦e	N	–ip, {–er, –it}
champignoni	N	–p, –t
chatte¦rpoq	V	–nngilaq
chauffør	N	–ip, –it
chaufføri	N	–p, –t
check	N	–ip, –it
checki	N	–p, –t
chimpans¦e	N	–ip, {–er, –it}
cigaret	N	–ip, –it
cikori¦e	N	–ap, –at
cirkel	N	–ip, –it
cirkeli	N	–p, –t
cirkus	N	–ip, –it
cirkusi	N	–p, –t
citron	N	–ip, –it
citroni	N	–p, –t
civilingeniøri	N	–p, –t
cm	N	–ip, –it
collag¦e	N	–ip, {–er, –it}
computeri	N	–p, –t
container	N	–ip, –it
containereqarfi¦k	N	–up, –it
coronavirus	N	–ip, –it
crem¦e	N	–ip, {–er, –it}
cykel	N	–ip, –it
cykel¦erpoq	V	–inngilaq
cykeli	N	–p, –t
cykl¦erpoq	V	{–enngilaq, –inngilaq}
cyklert¦oq	N	–up, –ut
cylinder	N	–ip, –it
cylinderi	N	–p, –t
cypres	N	–ip, –it
D-vitamini	N	–p, –t
daddeli	N	–p, –t
danskit	N, pl.	-
datamat	N	–ip, –it
datamati	N	–p, –t
deciliter	N	–ip, –it
deciliteri	N	–p, –t
decimalbrøk	N	–ip, –it
decimalbrøki	N	–p, –t
decimalsystemi	N	–p, –t
decimeter	N	–ip, –it
demokrat	N	–ip, –it
demokrati	N	{–ip, –p}, {–it, –t}
demokrati	N	–p, –t
demokrati¦i	N	{–ip, –p}, {–it, –t}
demokratit	N, pl.	-
demokrati¦t	N, pl.	{–it, –t}
departementeqarfi¦k	N	–up, –it
departementschef	N	–ip, –it
departementschefi	N	–p, –t
diagonali	N	–p, –t
diakoni	N	–p, –t
diamanteqarfi¦k	N	–up, –it
diamanti	N	–p, –t
diameteri	N	–p, –t
dieseli¦tortoq	N	{–sortup, –tortup}, {–sortut, –tortut}
difteritisi	N	–p, –t
digitalinngorti¦ppaa	V	–nngilaa
digitalinngortita¦q	N	–p, –t
digitalinngortitsine¦q	N	–rup, –rit
digitalius¦oq	N	–up, –ut
diktati	N	–p, –t
dinosaur	N	–ip, –it
dinosaurus	N	–ip, –it
dioxin	N	–ip, –it
diplomingeniøri	N	–p, –t
direktion	N	–ip, –it
direktioni	N	–p, –t
direktøri	N	–p, –t
diskos	N	–ip, –it
diskosi	N	–p, –t
diskoteki	N	–p, –t
dividend¦e	N	–ip, {–er, –it}
division	N	–ip, –it
divisioni	N	–p, –t
dl	N	–ip, –it
doble¦rpaa	V	–nngilaa
doktori	N	–p, –t
doktorinngorniarne¦q	N	–rup, –rit
doktorinngornia¦rpoq	V	–nngilaq
doktorinngorniart¦oq	N	–up, –ut
doktorinngorniut	N	–ip, –it
doktorinng¦orpoq	V	–unngilaq
doktorinngorti¦ppaa	V	–nngilaa
dollari	N	–p, –t
dommeri	N	–p, –t
Dorsetkulturi	N	–p, –t
dronningi	N	–p, –t
dunki	N	–p, –t
duplikatori	N	–p, –t
dusøri	N	–p, –t
dvd	N	–ip, –it
døgni	N	–p, –t
e-mail	N	–ip, –it
e-maili	N	–p, –t
E-vitamini	N	–p, –t
efterskol¦e	N	–ip, {–er, –it}
efterskoleqarfi¦k	N	–up, –it
efterskolerne¦q	N	–rup, –rit
efterskol¦erpoq	V	–inngilaq
efterskolert¦oq	N	–up, –ut
efterskolit	N, pl.	-
elektricitet	N	–ip, –it
elektriciteti	N	–p, –t
elektricitetiliorfi¦k	N	–up, –it
elevator	N	–ip, –it
elevatori	N	–p, –t
elværki	N	–p, –t
email	N	–ip, –it
emblem	N	–ip, –it
emblemi	N	–p, –t
eskimologi	N	–ip, –it
eskimologi	N	–p, –t
essay	N	–p, –t
etnologi	N	–ip, –it
etnologi	N	–p, –t
fagi	N	–p, –t
faglærer	N	–ip, –it
faglæreri	N	–p, –t
fars	N	–ip, –it
farsi	N	–p, –t
feberi	N	–p, –t
feeder	N	–ip, –it
feederbåd	N	–ip, –it
feeria	N	–p, –t
feeriaqarnersiut	N	–ip, –it
feria¦rpoq	V	–nngilaq
fernisi	N	–p, –t
fersken	N	–ip, –it
ferskeni	N	–p, –t
fest¦erpoq	V	–inngilaq
festertorsu¦uvoq	V	{–aanngilaq, –unngilaq}
festivali	N	–p, –t
fili	N	–p, –t
filisteri	N	–p, –t
filisterit	N, pl.	-
film	N	–ip, –it
film¦eeraliaq	N	{–eeraliap, –iaraliap}, {–eeraliat, –iaraliat}
filmeria¦rpoq	V	–nngilaq
film¦erpoq	V	–inngilaq
filmertarfi¦k	N	–up, –it
filmfestivali	N	–p, –t
filmi	N	–p, –t
filmiliaritittart¦oq	N	–up, –ut
filmiliorfi¦k	N	–up, –it
filmili¦orpoq	V	–unngilaq
filmiliortart¦oq	N	–up, –ut
filmiliort¦oq	N	–up, –ut
filosof	N	–ip, –it
filosofi	N	{–ip, –p}, {–it, –t}
filosofi	N	–p, –t
filosofi¦i	N	{–ip, –p}, {–it, –t}
firma	N	–p, –t
fiskeskipper	N	–ip, –it
fiskeskipperi	N	–p, –t
fjernsyn	N	–ip, –it
fjernsyni	N	–p, –t
flygeli	N	–p, –t
flødeboll¦e	N	–ip, {–er, –it}
fodsi	N	–t
folkeregister	N	–ip, –it
folkeregisteri	N	–p, –t
Folketing	N	–ip, –it
folketing	N	–ip, –it
Folketingi	N	–p, –t
folketingi	N	–p, –t
fondi	N	–p, –t
fonem	N	–ip, –it
fonemilerine¦q	N	–rup, –rit
formandi	N	–p, –t
formel	N	–ip, –it
formeli	N	–p, –t
forstander	N	–ip, –it
forstanderi	N	–p, –t
frekvens	N	–ip, –it
frikadell¦e	N	–ip, {–er, –it}
frikadell¦i	N	–ip, {–er, –it}
frimærk¦e	N	–ip, {–er, –it}
frimærkil¦erpaa	V	–inngilaa
frimærkiliine¦q	N	–rup, –rit
frimærkilii¦voq	V	–nngilaq
frimærkit	N, pl.	-
friskolit	N, pl.	-
frokost	N	–ip, –it
frokost¦erpoq	V	–inngilaq
frokosti	N	–p, –t
fuldmægtig	N	–ip, –it
fuldmægtigi	N	–p, –t
futsal	N	–ip, –it
futsali	N	–p, –t
fyrst¦e	N	–ip, {–er, –it}
fyrsteqarfi¦k	N	–up, –it
fyrst¦erpalaartoq	N	{–erpalaartup, –ipalaartup}, {–erpalaartut, –ipalaartut}
fyrsvamp	N	–ip, –it
fysik	N	–ip, –it
fysiker	N	–ip, –it
fysikeri	N	–p, –t
fysiologi	N	–ip, –it
fysiologi	N	–p, –t
galeas¦e	N	–ip, {–er, –it}
galoch¦e	N	–ip, {–er, –it}
galochit	N, pl.	-
gas	N	{–-ip, –sip}, {–-it, –sit}
gas¦seqarfik	N	{–-eqarfiup, –seqarfiup}, {–-eqarfiit, –seqarfiit}
gas¦si	N	{–-ip, –sip}, {–-it, –sit}
gas¦siliorfissuaq	N	{–-iliorfissuup, –siliorfissuup}, {–-iliorfissuit, –siliorfissuit}
gas¦sisunni	N	{–-isunnip, –sisunnip}, {–-isunnit, –sisunnit}
gas¦siusivik	N	{–-iisiviup, –-iusiviup, –siisiviup, –siusiviup}, {–-iisiviit, –-iusiviit, –siisiviit, –siusiviit}
general	N	–ip, –it
generaldirektør	N	–ip, –it
generaldirektøri	N	–p, –t
generalforsamling	N	–ip, –it
generalforsamlingi	N	–p, –t
generali	N	–p, –t
generator	N	–ip, –it
generatoreqarfi¦k	N	–up, –it
generatori	N	–p, –t
genus	N	–ip, –it
geodæt	N	–ip, –it
geodæti	N	–p, –t
geolog	N	–ip, –it
geologi	N	–ip, –it
geologi	N	–p, –t
geologii	N	–p, –t
geometri	N	{–ip, –p}, {–it, –t}
geometri¦i	N	{–ip, –p}, {–it, –t}
gesandt	N	–ip, –it
gesandti	N	–p, –t
giffel	N	–ip, –it
giffeli	N	–p, –t
gigti	N	–p, –t
gigtipalaa¦q	N	–p, –t
gipsi	N	–p, –t
girokort	N	–ip, –it
girokorti	N	–p, –t
glos¦e	N	–ip, {–er, –it}
gluten	N	–ip, –it
gongongi	N	–p, –t
gonorré	N	{–-p, –p}, {–-t, –t}
gradi	N	–p, –t
gram	N	–ip, –it
grammatik	N	–ip, –it
granit	N	–ip, –it
grev¦e	N	–ip, {–er, –it}
grev¦erpalaartoq	N	{–erpalaartup, –ipalaartup}, {–erpalaartut, –ipalaartut}
grågås	N	–ip, –it
grækeri	N	–p, –t
grækerit	N, pl.	-
grønkål	N	–ip, –it
grønkåli	N	–p, –t
grønlandsrull¦e	N	–ip, {–er, –it}
grønlandsrullit	N, pl.	-
grønlangkål	N	–ip, –it
grønlangkåli	N	–p, –t
grøntsag	N	–ip, –it
grøntsagi	N	–p, –t
grøntsagit	N, pl.	-
guitar	N	–ip, –it
guitarertart¦oq	N	–up, –ut
guitari	N	–p, –t
gummi	N	{–ip, –p}, {–it, –t}
gummi¦t	N, pl.	{–it, –t}
gummi¦usaq	N	{–iusap, –usap}, {–iusat, –usat}
halogeni	N	–p, –t
halogenit	N, pl.	-
Handeli	N	–p, –t
hangari	N	–p, –t
hash	N	–ip, –it
hashi	N	–p, –t
hashi¦torpoq	V	{–sunngilaq, –tunngilaq}
heksehyl	N	–ip, –it
hektoliteri	N	–p, –t
helikopter	N	–ip, –it
helikopteri	N	–p, –t
heliport	N	–ip, –it
heliporti	N	–p, –t
heroini	N	–p, –t
hertugi	N	–p, –t
hest¦erpoq	V	–inngilaq
hesti	N	–p, –t
HF	N	–ip, –it
hiistil¦ik	N	{–iup, –lip, –lup}, –lit
hiistiusa¦q	N	–p, –t
hindbær	N	–ip, –it
hindbæri	N	–p, –t
hindbærit	N, pl.	-
historia	N	–p, –t
hjemmestyrekommissioni	N	–p, –t
hjerteri	N	–p, –t
hormoni	N	–p, –t
horsegøg	N	–ip, –it
hoteli	N	–p, –t
hvidkål	N	–ip, –it
hvidkåli	N	–p, –t
hvidløgi	N	–p, –t
håndboldi	N	–p, –t
hækkeløbi	N	–p, –t
højskol¦e	N	–ip, {–er, –it}
højskolit	N, pl.	-
højtaleri	N	–p, –t
høvding	N	–ip, –it
høvdingi	N	–p, –t
ilti	N	–p, –t
ilti¦isivik	N	{–isiviup, –usiviup}, {–isiviit, –usiviit}
iltikilliorne¦q	N	–rup, –rit
inderigsministeri	N	–p, –t
indiane¦reqarfik	N	{–qarfiup, –reqarfiup}, {–qarfiit, –reqarfiit}
indian¦eri	N	{–erip, –ip}, {–erit, –it}
indian¦erit	N, pl.	{–erit, –it}
industre¦eqarfik	N	{–eqarfiup, –qarfiup}, {–eqarfiit, –qarfiit}
industri¦i	N	{–ip, –p}, {–it, –t}
ingeniøri	N	–p, –t
ingeniørit	N, pl.	-
inspektøri	N	–p, –t
interneteqarne¦q	N	–rup, –rit
ironman	N	–ip, –it
jaguar	N	–ip, –it
jaguari	N	–p, –t
jakk¦e	N	–ip, {–er, –it}
jakk¦i	N	–ip, {–er, –it}
jazz	N	–ip, –it
jazzi	N	–p, –t
jazzilerit¦ooq	N	–uup, –uut
jod	N	–ip, –it
jodi	N	–p, –t
jordbær	N	–ip, –it
jordbæri	N	–p, –t
journali	N	–p, –t
journalisti	N	–p, –t
julemærk¦e	N	–ip, {–er, –it}
julemærk¦i	N	–ip, {–er, –it}
jurist	N	–ip, –it
juristi	N	–p, –t
jævnstrøm	N	–ip, –it
K-vitamini	N	–p, –t
kabal¦i	N	–ip, {–er, –it}
kabeleqanngits¦oq	N	–up, –ut
kabeli	N	–p, –t
kabelilersuine¦q	N	–rup, –rit
kabelilersuisart¦oq	N	–up, –ut
kaff¦i	N	–ip, {–er, –it}
kaffilaa¦q	N	–p, –t
kaffilaat	N, pl.	-
kaffili¦orpoq	V	–unngilaq
kaffillerne¦q	N	–rup, –rit
kaffill¦erpoq	V	–inngilaq
kaffinng¦erpoq	V	–inngilaq
kaffipaju¦k	N	–up, –it
kaffisi¦voq	V	–nngilaq
kaffi¦soqatigiinnersuaq	N	{–soqatigiinnersuup, –toqatigiinnersuup}, {–soqatigiinnersuit, –toqatigiinnersuit}
kaffi¦sorfik	N	{–sorfiup, –torfiup}, {–sorfiit, –torfiit}
kaffi¦soriartorpoq	V	{–soriartunngilaq, –toriartunngilaq}
kaffi¦sorniartarfik	N	{–sorniartarfiup, –torniartarfiup}, {–sorniartarfiit, –torniartarfiit}
kaffi¦sorpoq	V	{–sunngilaq, –tunngilaq}
kaffisunni	N	–p, –t
kaffit	N, pl.	-
kaka¦o	N	–up, –ut
kalk	N	–ip, –it
kalkeerunne¦q	N	–rup, –rit
kalki	N	–p, –t
kalkininne¦q	N	–rup, –rit
kalkitaqart¦oq	N	–up, –ut
kaloria	N	–p, –t
kam¦eeraq	N	{–eeqqap, –iaqqap}, {–eeqqat, –iaqqat}
kameernia¦q	N	–p, –t
kameerniart¦oq	N	–up, –ut
kamigi¦ppoq	V	–nngilaq
kamigissaa¦rpoq	V	–nngilaq
kamik¦oq	N	–up, –ut
kamil¦erpaa	V	–inngilaa
kamiliar¦aa	V	–inngilaa
kamili¦orpoq	V	–unngilaq
kamilisa¦rpoq	V	–nngilaq
kamillartaat	N	–ip, –it
kamillartart¦oq	N	–up, –ut
kamill¦erpoq	V	–inngilaq
kamillet¦e	N	–ip, {–er, –it}
kamilu¦ppoq	V	–nngilaq
kaminngorti¦ppaa	V	–nngilaa
kaminngu¦aq	N	–up, –it
kamissaaru¦ppoq	V	–tinngilaq
kammagiit	N, pl.	-
kammagiunnaa¦rpaa	V	–nngilaa
kammalaat	N, pl.	-
kammat	N, pl.	-
kandidat	N	–ip, –it
kaneli	N	–p, –t
kapitali	N	–p, –t
karakteri	N	–p, –t
karaterne¦q	N	–rup, –rit
karburator	N	–ip, –it
karburatori	N	–p, –t
kardusi	N	–p, –t
karreerniart¦oq	N	–up, –ut
karreqal¦erpoq	V	–inngilaq
karreqangaart¦oq	N	–up, –ut
karrertaajaaffilia¦q	N	–p, –t
karri	N	–p, –t
karri¦iaavoq	V	{–ajaanngilaq, –iaanngilaq}
karri¦iarnikut	N, pl.	{–ajarnikut, –iarnikut}
karri¦iarpaa	V	{–ajanngilaa, –ianngilaa}
karrit	N, pl.	-
karsersu¦aq	N	–up, –it
kars¦i	N	–ip, {–er, –it}
kars¦iaraasaq	N	{–eeraasap, –iaraasap}, {–eeraasat, –iaraasat}
karsimiittuutit	N, pl.	-
karsisi¦voq	V	–nngilaq
kartoffeli	N	–p, –t
kas¦eerpaa	V	–iinngilaa
kasiil¦erpaa	V	–inngilaa
kassettebåndoptager	N	–ip, –it
kassettebåndoptageri	N	–p, –t
katalogi	N	–p, –t
katederi	N	–p, –t
kemi	N	{–ip, –p}, {–it, –t}
kemi¦i	N	{–ip, –p}, {–it, –t}
kemikalia	N	–p, –t
kemiker	N	–ip, –it
kemikeri	N	–p, –t
kerubi	N	–p, –t
k¦ilometerilersuut	N	{–ilometerilersuutip, –ilometerilertuutip, –milersuutip, –milertuutip}, {–ilometerilersuutit, –ilometerilertuutit, –milersuutit, –milertuutit}
kilu	N	–p, –t
kilugi¦ppoq	V	–nngilaq
kilugivi¦ppoq	V	–nngilaq
kiluki¦ppoq	V	–nngilaq
kilukits¦oq	N	–up, –ut
kilukivi¦ppoq	V	–nngilaq
kilul¦erpaa	V	–inngilaa
kilul¦ik	N	{–iup, –lip, –lup}, –lit
kilumiuusa¦rpoq	V	–nngilaq
kilumiuu¦voq	V	–nngilaq
kioski	N	–p, –t
kirsebær	N	–ip, –it
kirsebæri	N	–p, –t
kitteli	N	–p, –t
kjol¦e	N	–ip, {–er, –it}
kladd¦e	N	–ip, {–er, –it}
klass¦e	N	–ip, {–er, –it}
klaveri	N	–p, –t
klima	N	–p, –t
knallerti	N	–p, –t
knægt	N	–ip, –it
knægti	N	–p, –t
knækbrødi	N	–p, –t
koblingi	N	–p, –t
koksit	N, pl.	-
kommissioni	N	–p, –t
kommunalbestyrels¦e	N	–ip, {–er, –it}
kommunalbestyrelsit	N, pl.	-
kommun¦e	N	–ip, {–er, –it}
kommunefogedi	N	–p, –t
kommune¦qarfik	N	{–qarfiup, –-qarfiup}, {–qarfiit, –-qarfiit}
kommune¦rujussuaq	N	{–rujussuup, –-rujussuup}, {–rujussuit, –-rujussuit}
kommunisti	N	–p, –t
kommunistiussu¦seq	N	–tsip, –tsit
kommunistiusuusaaginnart¦oq	N	–up, –ut
konsulenti	N	–p, –t
konsuleqarfi¦k	N	–up, –it
kont¦o	N	–up, –ut
kontoqarfius¦oq	N	–up, –ut
kontorchefi	N	–p, –t
kontorfuldmægtigi	N	–p, –t
korali	N	–p, –t
korsstingi	N	–p, –t
kr.	N	–-ip, –-it
kranersu¦aq	N	–up, –it
krani	N	–p, –t
kredsdommeri	N	–p, –t
kridti	N	–p, –t
kroneqa¦rpoq	V	–nngilaq
kryds&tværs	N	–ip, –it
krydsi	N	–p, –t
krydsil¦erpaa	V	–inngilaa
krydsilersuiffi¦k	N	–up, –it
krydsiliiffissa¦q	N	–p, –t
krydsiliine¦q	N	–rup, –rit
krydsilii¦voq	V	–nngilaq
kræfteqarne¦q	N	–rup, –rit
kræfteqa¦rpoq	V	–nngilaq
kræfteqart¦oq	N	–up, –ut
kræftert¦oq	N	–up, –ut
kræfti	N	–p, –t
k¦uarti	N	{–uartip, –vart-ip}, {–uartit, –vart-it}
kufferti	N	–p, –t
kulleri	N	–p, –t
kultureqanngissu¦seq	N	–tsip, –tsit
kulturi	N	–p, –t
kulturisioqatigiinne¦q	N	–rup, –rit
kursuserne¦q	N	–rup, –rit
kursus¦erpoq	V	–inngilaq
kursusertarfi¦k	N	–up, –it
kursusi	N	–p, –t
kutteri	N	–p, –t
kvadratkilometer	N	–ip, –it
kviksølv	N	–ip, –it
kviksølvi	N	–p, –t
kvækeri	N	–p, –t
kystskipperi	N	–p, –t
kæmnereqarfi¦k	N	–up, –it
kæmneri	N	–p, –t
kærnemælk	N	–ip, –it
kærnemælki	N	–p, –t
kørvelit	N, pl.	-
laboratorieteknikeri	N	–p, –t
labrador	N	–ip, –it
lagkag¦e	N	–ip, {–er, –it}
lama	N	–p, –t
landsdommeri	N	–p, –t
landsfoged	N	–ip, –it
landsfogedi	N	–p, –t
landsholdit	N, pl.	-
landshøvdingi	N	–p, –t
landskass¦e	N	–ip, {–er, –it}
landslæg¦e	N	–ip, {–er, –it}
landsråd	N	–ip, –it
Landsrådi	N	–p, –t
landsrådi	N	–p, –t
langrend	N	–ip, –it
lapisi	N	–p, –t
lastbili	N	–p, –t
lasti	N	–p, –t
ledning	N	–ip, –it
ledningeqanngits¦oq	N	–up, –ut
ledningi	N	–p, –t
legat	N	–ip, –it
legati	N	–p, –t
leksikoni	N	–p, –t
lektori	N	–p, –t
licensi	N	–p, –t
linoleum	N	–ip, –it
linoleumi	N	–p, –t
linoli¦e	N	–ap, –at
literi	N	–p, –t
lott¦o	N	–up, –ut
lottortart¦oq	N	–up, –ut
lutetium	N	–ip, –it
lærlingehjem	N	–ip, –it
lærlingi	N	–p, –t
løverniarne¦q	N	–rup, –rit
løviusa¦q	N	–p, –t
magister	N	–ip, –it
magisteri	N	–p, –t
magneteqarfi¦k	N	–up, –it
magneteqart¦oq	N	–up, –ut
magneti	N	–p, –t
mail	N	–ip, –it
majsi	N	–p, –t
makeqqi¦ppoq	V	–nngilaq
maker¦eerpoq	V	–iinngilaq
makeria¦rpoq	V	–nngilaq
makiaa¦rpoq	V	–nngilaq
makillaqqi¦ppoq	V	–nngilaq
makrelerniarne¦q	N	–rup, –rit
makreli	N	–p, –t
mandeli	N	–p, –t
manuskripti	N	–p, –t
mapp¦erpoq	V	–inngilaq
mappersa¦gaq	N	–kkap, –kkat
mappersakkat	N, pl.	-
mappersi¦gaq	N	–kkap, –kkat
mappersimas¦oq	N	–up, –ut
mappersima¦voq	V	–nngilaq
mappert¦oq	N	–up, –ut
mapp¦i	N	–ip, {–er, –it}
mappiussi¦voq	V	–nngilaq
marathonerne¦q	N	–rup, –rit
maratoni	N	–p, –t
marcipani	N	–p, –t
margarin¦e	N	–ip, {–er, –it}
marihuana	N	–p, –t
Marmoril¦ik	N	{–iup, –lip, –lup}, –lit
marmorisiorfi¦k	N	–up, –it
marski	N	–p, –t
martyri	N	–p, –t
maskinisti	N	–p, –t
maskinmester	N	–ip, –it
maskinmesteri	N	–p, –t
maskinmesterinngornia¦q	N	–p, –t
maskinmesteriune¦q	N	–rup, –rit
masteri	N	–p, –t
masterinngorniarne¦q	N	–rup, –rit
matematikeri	N	–p, –t
mavedans	N	–ip, –it
medisteri	N	–p, –t
mekanikeri	N	–p, –t
meloni	N	–p, –t
mesteri	N	–p, –t
metodisti	N	–p, –t
mi¦ileqarpoq	V	{–ileqanngilaq, –l-eqanngilaq}
mi¦ili	N	{–ilip, –l-ip}, {–ilit, –l-it}
m¦iiteri	N	{–eter-ip, –iiterip}, {–eter-it, –iiterit}
mikrofoni	N	–p, –t
mikroplast	N	–ip, –it
mileqqort¦ooq	N	–uup, –uut
mileqqortoorsi¦voq	V	–nngilaq
milita¦q	N	–p, –t
milittoorne¦q	N	–rup, –rit
miljømedicin	N	–ip, –it
milliard	N	–ip, –it
milliardi	N	–p, –t
minerali	N	–p, –t
minister	N	–ip, –it
ministereqarfi¦k	N	–up, –it
ministereqatigiit	N, pl.	-
ministeri	N	–p, –t
ministeriune¦q	N	–rup, –rit
ministeriusimas¦oq	N	–up, –ut
minut¦si	N	{–-ip, –sip}, {–-it, –sit}
minut¦silersuut	N	{–-ilersuutip, –-ilertuutip, –silersuutip, –silertuutip}, {–-ilersuutit, –-ilertuutit, –silersuutit, –silertuutit}
mistali	N	–p, –t
mobili	N	–p, –t
mod¦e	N	–ip, {–er, –it}
modern¦e	N	–ip, –it
mongoli	N	–p, –t
monopoli	N	–p, –t
montøri	N	–p, –t
morfem	N	–ip, –it
morfemilerine¦q	N	–rup, –rit
mormoni	N	–p, –t
multivitamin	N	–ip, –it
muslim	N	–ip, –it
muslimeqarfi¦k	N	–up, –it
mærk¦e	N	–ip, {–er, –it}
mærkil¦erpaa	V	–inngilaa
mærkilii¦voq	V	–nngilaq
mæsling	N	–ip, –it
mæslingit	N, pl.	-
møtrik	N	–ip, –it
narkoman	N	–ip, –it
nationalmuseum	N	–ip, –it
nationalparki	N	–p, –t
natmad	N	–ip, –it
natron	N	–ip, –it
natroni	N	–p, –t
naturfag	N	–ip, –it
navigationsskol¦e	N	–ip, {–er, –it}
nazist	N	–ip, –it
nazisti	N	–p, –t
nazistiujunnaar¦sippaa	V	{–sinngilaa, –tinngilaa}
negativ	N	–ip, –it
negativi	N	–p, –t
neger	N	–ip, –it
negererpalutt¦oq	N	–up, –ut
negeri	N	–p, –t
nikkel	N	–ip, –it
nikkelersu¦aq	N	–up, –it
nikkeli	N	–p, –t
nikotin	N	–ip, –it
nikotini	N	–p, –t
niss¦e	N	–ip, {–er, –it}
niss¦erpoq	V	–inngilaq
niss¦i	N	–ip, {–er, –it}
niss¦iaraq	N	{–eeqqap, –iaqqap}, {–eeqqat, –iaqqat}
nissilia¦q	N	–p, –t
nissita¦q	N	–p, –t
nissiut	N	–ip, –it
nordpol	N	–ip, –it
nordpoli	N	–p, –t
nylon	N	–ip, –it
nyloni	N	–p, –t
oas¦e	N	–ip, {–er, –it}
obersti	N	–p, –t
officeri	N	–p, –t
oliveni	N	–p, –t
olympiad¦e	N	–iip, –iit
ombudsmandeqarfi¦k	N	–up, –it
ombudsmandi	N	–p, –t
oori	N	–p, –t
oorit	N, pl.	-
orang¦e	N	–ip, {–er, –it}
ordbog¦eeraq	N	{–eeqqap, –iaqqap}, {–eeqqat, –iaqqat}
Ordbogi	N	–p, –t
ordbogi	N	–p, –t
ordbogit	N, pl.	-
ordeneqarne¦q	N	–rup, –rit
ordeni	N	–p, –t
ordenilers¦orpaa	V	–unngilaa
ordenilersui¦voq	V	–nngilaq
organisti	N	–p, –t
original	N	–ip, –it
orkesteri	N	–p, –t
ozoni	N	–p, –t
palm¦e	N	–ip, {–er, –it}
palm¦i	N	–ip, {–er, –it}
papeerullu¦innarpoq	V	{–innanngilaq, –aannanngilaq}
papeeru¦ppoq	V	–tinngilaq
papeerussima¦voq	V	–nngilaq
papeqanngits¦oq	N	–up, –ut
papiki¦ppoq	V	–nngilaq
papikkaa¦q	N	–p, –t
papil¦ik	N	{–iup, –lip, –lup}, –lit
papillit	N, pl.	-
papyrusi	N	–p, –t
parki	N	–p, –t
parlamenti	N	–p, –t
parte¦eqat	N	{–eqatip, –qatip}, {–eqatit, –qatit}
parti¦i	N	{–ip, –p}, {–it, –t}
parti¦it	N, pl.	{–it, –t}
partisani	N	–p, –t
pasill¦erpoq	V	–inngilaq
pasinaa¦rpaa	V	–nngilaa
pasitsanne¦q	N	–rup, –rit
patenti	N	–p, –t
patrulj¦e	N	–ip, {–er, –it}
pedel	N	–ip, –it
pedeli	N	–p, –t
pemmikani	N	–p, –t
penicillini	N	–p, –t
pensionati	N	–p, –t
pensionisti	N	–p, –t
pergamenti	N	–p, –t
personnummeri	N	–p, –t
pessari	N	–p, –t
ph.d.	N	–-p, –-t
ph.d.-nngornia¦q	N	–p, –t
ph.d.-nngorniarne¦q	N	–rup, –rit
ph.d.-nngorniut	N	–ip, –it
ph.d.-nngorniutit	N, pl.	-
pianisti	N	–p, –t
piloti	N	–p, –t
planet	N	–ip, –it
pokali	N	–p, –t
pokalinnanniunne¦q	N	–rup, –rit
pokalinna¦ppoq	V	–nngilaq
polarcirkeli	N	–p, –t
polarkredsi	N	–p, –t
politeeqarfi¦k	N	–up, –it
politiit	N, pl.	-
politiiune¦q	N	–rup, –rit
politikeri	N	–p, –t
politikerit	N, pl.	-
politiki	N	–p, –t
politikikkut	N, pl.	-
politimestereqarfi¦k	N	–up, –it
politimesteri	N	–p, –t
polyesteri	N	–p, –t
poor'lu	N	{bollip, boor'lup, poor'lup}, {boller, bollit, boor'lut, poor'lut}
poor'luliaq	N	{bolliliap, boor'luliap, poor'luliap}, {bolliliat, boor'luliat, poor'luliat}
porn¦o	N	–up, –ut
portøri	N	–p, –t
postanvisningi	N	–p, –t
postboksi	N	–p, –t
postkorti	N	–p, –t
praktikerfi¦k	N	–up, –it
praktikerfissa¦q	N	–p, –t
primusi	N	–p, –t
prinsi	N	–p, –t
prism¦e	N	–ip, {–er, –it}
pristali	N	–p, –t
privati	N	–p, –t
procenti	N	–p, –t
procentpointi	N	–p, –t
professori	N	–p, –t
programsekretæri	N	–p, –t
projekteqarne¦q	N	–rup, –rit
projekti	N	–p, –t
proteini	N	–p, –t
protokoli	N	–p, –t
provinsi	N	–p, –t
provsteqarfi¦k	N	–up, –it
provsti	N	–p, –t
præsidenteqarfi¦k	N	–up, –it
præsidenti	N	–p, –t
psykolog	N	–ip, –it
psykologeqarfi¦k	N	–up, –it
psykologi	N	–ip, –it
psykologi	N	–p, –t
psykologii	N	–p, –t
pump¦e	N	–ip, {–er, –it}
pumpeqarfi¦k	N	–up, –it
pundi	N	–p, –t
pyramid¦e	N	–ip, {–er, –it}
pædagogi	N	–p, –t
pædagogik	N	–ip, –it
pær¦e	N	–ip, {–er, –it}
pærilerfi¦k	N	–up, –it
pøls¦e	N	–ip, {–er, –it}
rabarberi	N	–p, –t
rac¦e	N	–ip, {–er, –it}
radari	N	–p, –t
radi¦o	N	–up, –ut
radioaktivius¦oq	N	–up, –ut
radioavis	N	–ip, –it
radioavisi	N	–p, –t
radiohusi	N	–p, –t
radioqarfi¦k	N	–up, –it
radioteateri	N	–p, –t
radis¦e	N	–ip, {–er, –it}
radiuernia¦q	N	–p, –t
radiusi	N	–p, –t
raketi	N	–p, –t
realisti	N	–p, –t
realklass¦e	N	–ip, {–er, –it}
realskol¦e	N	–ip, {–er, –it}
redaktøri	N	–p, –t
regulatori	N	–p, –t
reklam¦e	N	–ip, {–er, –it}
rektangeli	N	–p, –t
rektori	N	–p, –t
religioni	N	–p, –t
revisori	N	–p, –t
ribsi	N	–p, –t
ribsit	N, pl.	-
rigsombudeqarfi¦k	N	–up, –it
Rigsombudi	N	–p, –t
rituali	N	–p, –t
ritualit	N, pl.	-
rock	N	–ip, –it
rocki	N	–p, –t
romi	N	–p, –t
rubineqarfi¦k	N	–up, –it
rubinisiorfi¦k	N	–up, –it
ruderi	N	–p, –t
rundstykk¦e	N	–ip, {–er, –it}
rådhusi	N	–p, –t
rækkehusi	N	–p, –t
rødkålit	N, pl.	-
røntgeni	N	–p, –t
sagg¦erpoq	V	–inngilaq
sak¦i	N	–ip, {–er, –it}
sakiatsi¦aq	N	–up, –it
sakiatsiariissu¦seq	N	–tsip, –tsit
sakig¦aa	V	–inngilaa
sakissat	N, pl.	-
sakiu¦voq	V	–nngilaq
sakrament¦e	N	–ip, {–er, –it}
sakramentilia¦rpoq	V	–nngilaq
salikkumina¦rpoq	V	–nngilaq
salitaa¦voq	V	–nngilaq
salita¦q	N	–p, –t
salitassa¦q	N	–p, –t
sekretæri	N	–p, –t
sekstanti	N	–p, –t
sekundilersuis¦oq	N	–up, –ut
sekundilersuisuune¦q	N	–rup, –rit
semesteri	N	–p, –t
serafi	N	–p, –t
servereqarfi¦k	N	–up, –it
sigti	N	–p, –t
sigt¦i	N	–ip, {–er, –it}
sigtiliassat	N, pl.	-
skema	N	–p, –t
skoledirektøri	N	–p, –t
skoleinspektøri	N	–p, –t
skorpion	N	–ip, –it
skorpioni	N	–p, –t
skrællingit	N, pl.	-
skærmersu¦aq	N	–up, –it
smiley	N	–p, –t
smokingi	N	–p, –t
smokingilisaa¦rpoq	V	–nngilaq
SMS	N	–-ip, –-it
snescootererne¦q	N	–rup, –rit
snescooteri	N	–p, –t
snowboard	N	–ip, –it
snowboard¦erpoq	V	–inngilaq
socialisti	N	–p, –t
socialliberal	N	–ip, –it
socialmedhjælperi	N	–p, –t
socialrådgiveri	N	–p, –t
sodavandi	N	–p, –t
solari	N	–p, –t
soya	N	–p, –t
spandi	N	–p, –t
specialarbejderi	N	–p, –t
specialklass¦e	N	–ip, {–er, –it}
spejdereqarne¦q	N	–rup, –rit
spejderi	N	–p, –t
spinatit	N, pl.	-
spirali	N	–p, –t
sporti	N	–p, –t
stencili	N	–p, –t
stressert¦oq	N	–up, –ut
stressi	N	–p, –t
sudoku	N	–p, –t
sundhedsmedhjælperi	N	–p, –t
supervision	N	–ip, –it
svampi	N	–p, –t
svendi	N	–p, –t
syfilisi	N	–p, –t
synagog¦e	N	–ip, {–er, –it}
systemi	N	–p, –t
sætteskipperi	N	–p, –t
sølveqarfi¦k	N	–up, –it
sølvi	N	–p, –t
sølvinna¦ppoq	V	–nngilaq
tabeli	N	–p, –t
TAC	N	–ip, –it
takti	N	–p, –t
tandpasta	N	–p, –t
tankeqarfi¦k	N	–up, –it
tankersuaqarfi¦k	N	–up, –it
tanki	N	–p, –t
tankileris¦oq	N	–up, –ut
taxa	N	–p, –t
taxarne¦q	N	–rup, –rit
taxa¦rpoq	V	–nngilaq
taxartart¦oq	N	–up, –ut
taxartitsis¦oq	N	–up, –ut
teknik	N	–ip, –it
teknikeri	N	–p, –t
teknologi	N	–ip, –it
teknologi	N	–p, –t
telefon	N	–ip, –it
telefoneqarfi¦k	N	–up, –it
telefonerfig¦aa	V	–inngilaa
telefonerne¦q	N	–rup, –rit
telefon¦erpoq	V	–inngilaq
telefonertarfi¦k	N	–up, –it
telefoni	N	–p, –t
telefonileris¦oq	N	–up, –ut
telegrafisti	N	–p, –t
telemedicin	N	–ip, –it
teologii	N	–p, –t
terminalilerisut	N, pl.	-
termometeri	N	–p, –t
testament¦e	N	–ip, {–er, –it}
testamentili¦orpoq	V	–unngilaq
testamentit	N, pl.	-
Testamentitaa¦q	N	–p, –t
testamentitaa¦q	N	–p, –t
Testamentitoq¦aq	N	{–qap, –ap}, {–qat, –at}
testamentitoq¦aq	N	{–qap, –ap}, {–qat, –at}
Thulekulturi	N	{–p, –p}, {–t, –t}
thulekulturi	N	–p, –t
timelæreri	N	–p, –t
timeqa¦rpoq	V	–nngilaq
timersoqatigiiffiit	N, pl.	-
timersoqatigiiffi¦k	N	–up, –it
timersorne¦q	N	–rup, –rit
timers¦orpoq	V	–unngilaq
timersortarfi¦k	N	–up, –it
timersortart¦oq	N	–up, –ut
timersortartut	N, pl.	-
timi	N	–p, –t
timigi¦ssarneq	N	{–ssarnerup, –ttarnerup}, {–ssarnerit, –ttarnerit}
timigi¦ssarpoq	V	–ttanngilaq
timigissartarfi¦k	N	–up, –it
timigissartarne¦q	N	–rup, –rit
timigissartart¦oq	N	–up, –ut
timigi¦ssuuvoq	V	{–ssuunngilaq, –ttuunngilaq}
timitaaru¦ppoq	V	–tinngilaq
timital¦erpaa	V	–inngilaa
timitalii¦voq	V	–nngilaq
timital¦ik	N	{–iup, –lip, –lup}, –lit
timita¦q	N	–p, –t
timitaqanngits¦oq	N	–up, –ut
timitartaa¦rpoq	V	–nngilaq
timiusaat	N	–ip, –it
timiusaateqa¦rpoq	V	–nngilaq
timiusa¦q	N	–p, –t
timiusar¦torpoq	V	{–sunngilaq, –tunngilaq}
timiusat	N, pl.	-
timiu¦siorfik	N	{–siorfiup, –tiliorfiup}, {–siorfiit, –tiliorfiit}
timiu¦siorpoq	V	{–siunngilaq, –tiliunngilaq}
timiu¦siortoq	N	{–siortup, –tiliortup}, {–siortut, –tiliortut}
tineqqa¦voq	V	–nngilaq
tinerujussuarne¦q	N	–rup, –rit
tineruloorne¦q	N	–rup, –rit
tingerlaa¦q	N	–p, –t
tingerlaat	N, pl.	-
tingi	N	–p, –t
tingit	N, pl.	-
tingitaasima¦voq	V	–nngilaq
tingitaavi¦ppoq	V	–nngilaq
tingitaa¦voq	V	–nngilaq
tingita¦q	N	–p, –t
tini	N	–p, –t
tinil¦erpoq	V	–inngilaq
tinimuka¦rpoq	V	–nngilaq
tomati	N	–p, –t
ton¦si	N	{–-ip, –nip, –sip}, {–-it, –nit, –s, –sit}
traktori	N	–p, –t
trawleri	N	–p, –t
trekanti	N	–p, –t
trillebøri	N	–p, –t
trinitatisi	N	–p, –t
trompeti	N	–p, –t
trucki	N	–p, –t
trumfi	N	–p, –t
trussi¦t	N, pl.	{–it, –t}
trækprocenti	N	–p, –t
tuberkulos¦e	N	–ip, {–er, –it}
tunersuit	N, pl.	-
tunillanneqarsinnaanngissu¦seq	N	–tsip, –tsit
tunillanneqarsinnaanngits¦oq	N	–up, –ut
tunillanneqart¦oq	N	–up, –ut
tunillatsinne¦q	N	–rup, –rit
tunillatsinnerit	N, pl.	-
tunillatsissimas¦oq	N	–up, –ut
tunillatsissinnaane¦q	N	–rup, –rit
tunillatsitt¦oq	N	–up, –ut
tuniniaaffi¦k	N	–up, –it
tuniniaallamma¦k	N	–ap, –at
tuniseqataas¦oq	N	–up, –ut
tuniseqqu¦aa	V	–nngilaa
Tunisiam¦eersoq	N	{–eersup, –eertup, –inngaanneersup, –inngaanneertup}, {–eersut, –eertut, –inngaanneersut, –inngaanneertut}
tunisine¦q	N	–rup, –rit
tunisis¦oq	N	–up, –ut
tunisi¦voq	V	–nngilaq
tuniusa¦rpoq	V	–nngilaq
turisteqarfi¦k	N	–up, –it
turisti	N	–p, –t
tvistit	N, pl.	-
tyfusi	N	–p, –t
tyggegummi	N	{–ip, –p}, {–it, –t}
tæpp¦e	N	–ip, {–er, –it}
udvalgi	N	–p, –t
umami	N	{–ip, –p}, {–it, –t}
umami¦sunnippoq	V	{–isunninngilaq, –sunninngilaq}
Ungb¦o	N	–up, –ut
ungdomspensioni	N	–p, –t
uniformi	N	–p, –t
universiteteqarfi¦k	N	–up, –it
universiteti	N	–p, –t
uraneqarfi¦k	N	–up, –it
urani	N	–p, –t
uranisiorfi¦k	N	–up, –it
uranisiorne¦q	N	–rup, –rit
uranital¦ik	N	{–iup, –lip, –lup}, –lit
valmu¦e	N	–ip, {–er, –it}
valsi	N	–p, –t
versi	N	–p, –t
versili¦orpoq	V	–unngilaq
vide¦o	N	–up, –ut
vide¦orpoq	V	–unngilaq
vikingi	N	–p, –t
villa	N	–p, –t
vinkeli	N	–p, –t
vitamineqarluart¦oq	N	–up, –ut
vitamini	N	–p, –t
vitamini¦torneq	N	{–sornerup, –tornerup}, {–sornerit, –tornerit}
vodka	N	–p, –t
weekendi	N	–p, –t
whisky	N	–p, –t
whist	N	–ip, –it
wienerbrødi	N	–p, –t
wienerbrødit	N, pl.	-
workshop	N	–ip, –it
yoghurti	N	–p, –t
zinki	N	–p, –t
zoologi	N	–ip, –it
zoologi	N	–p, –t
zoologii	N	–p, –t
åkand¦e	N	–ip, {–er, –it}
æblejuic¦e	N	–ip, {–er, –it}
æbleskiv¦e	N	–ip, {–er, –it}
æggesnapsi	N	–p, –t
ækvatori	N	–p, –t
ærkebiskop	N	–ip, –it
æteri	N	–p, –t
økonoma	N	–p, –t
ør¦e	N	–ip, {–er, –it}
