Lexeme	WC	Flexion
oas¦e	N	–ip, {–er, –it}
obersti	N	–p, –t
okay	Interj	(no generation)
oktobari	N	–p, –t
oliveni	N	–p, –t
ombudsmandeqarfi¦k	N	–up, –it
ombudsmandi	N	–p, –t
ooqanngits¦oq	N	–up, –ut
ooqanngitsortorpoq	V	(no generation)
ooqattaarine¦q	N	–rup, –rit
ooqattaar¦ineq	N	{–inerup, –sinerup}, {–inerit, –sinerit}
ooqattaarineqarne¦q	N	–rup, –rit
ooqattaar¦ineqarneq	N	{–ineqarnerup, –sineqarnerup}, {–ineqarnerit, –sineqarnerit}
ooqattaar¦isinnaaneq	N	{–isinnaanerup, –sisinnaanerup}, {–isinnaanerit, –sisinnaanerit}
ooqattaar¦isoq	N	{–isup, –sisup}, {–isut, –sisut}
ooqattaarivoq	V	(no generation)
ooqattaarneqanngitsoq	N	{ooqattaarneqanngitsup, uuteqattaarneqanngitsup}, {ooqattaarneqanngitsut, uuteqattaarneqanngitsut}
ooqattaarneqanngits¦oq	N	–up, –ut
ooqattaarneqarneq	N	{ooqattaarneqarnerup, uuteqattaarneqarnerup}, {ooqattaarneqarnerit, uuteqattaarneqarnerit}
ooqattaarneqarne¦q	N	–rup, –rit
ooqattaarpaa	V	(no generation)
ooqattaarpoq	V	(no generation)
ooqattaarsivoq	V	(no generation)
ooqattaarutaanna¦q	N	–ap, –at
ooqattaarutaas¦oq	N	–up, –ut
ooqattaasarfi¦k	N	–up, –it
ooqattaasarne¦q	N	–rup, –rit
ooqattaasarpoq	V	(no generation)
ooqattaatsiarne¦q	N	–rup, –rit
ooqattaavi¦k	N	–up, –it
ooqattaavoq	V	(no generation)
ooq¦eeq	N	–iip, –iit
ooqeeraa	V	(no generation)
ooqeeriunnaarpaa	V	(no generation)
ooqqaa¦gaq	N	–kkap, –kkat
ooqqaajuvoq	V	(no generation)
ooqqaa¦q	N	–p, –t
ooqqaarpaa	V	(no generation)
ooqqilluanngilaq	V	(no generation)
ooqqippoq	V	(no generation)
ooqqissoq	N	{ooqqissup, ooqqittup, uuteqqissup, uuteqqittup}, {ooqqissut, ooqqittut, uuteqqissut, uuteqqittut}
ooqqiss¦oq	N	–up, –ut
ooqqi¦ssoq	N	{–ssup, –ttup}, {–ssut, –ttut}
ooqqivippoq	V	(no generation)
oori	N	{oorip, øre-p}, {oorit, øre-t}
oorlaajuvoq	V	(no generation)
oorlaa¦q	N	–p, –t
oorukkiartorpaa	V	(no generation)
oorunne¦q	N	–rup, –rit
ooruppaa	V	(no generation)
ooruppoq	V	(no generation)
oqaannarajuppoq	V	(no generation)
oqaannarne¦q	N	–rup, –rit
oqaannarniut	N	–ip, –it
oqaannarpoq	V	(no generation)
oqaannarsorpoq	V	(no generation)
oqaappaa	V	(no generation)
oqaaqqissaarine¦q	N	–rup, –rit
oqaaqqissaarivoq	V	(no generation)
oqaaqqissaarpaa	V	(no generation)
oqaaqqissaartippaa	V	(no generation)
oqaaqqissaarti¦ppoq	V	–nngilaq
oqaaqqissaarut	N	–ip, –it
oqaaqqissaarutigaa	V	(no generation)
oqaarulluinnarpoq	V	(no generation)
oqaaruppoq	V	(no generation)
oqaasal¦ik	N	{–iup, –lip, –lup}, –lit
oqaasa¦q	N	–p, –t
oqaas¦eeraq	N	{–eeqqap, –iaqqap}, {–eeqqat, –iaqqat}
oqaa¦seq	N	–tsip, –tsit
oqaaseqaat	N	–ip, –it
oqaaseqaateqarfissa¦q	N	–p, –t
oqaaseqaa¦tilersuineq	N	{–sersuinerup, –tilersuinerup}, {–sersuinerit, –tilersuinerit}
oqaaseqanngits¦oq	N	–up, –ut
oqaaseqarfigaa	V	(no generation)
oqaaseqarfigeqquneqarpoq	V	(no generation)
oqaaseqarfiginerusariaqanngilaq	V	(no generation)
oqaaseqarfigitsiarpaa	V	(no generation)
oqaaseqarne¦q	N	–rup, –rit
oqaaseqarnianngilaq	V	(no generation)
oqaaseqarpoq	V	(no generation)
oqaaseqarsinnaane¦q	N	–rup, –rit
oqaaseqartart¦oq	N	–up, –ut
oqaaseqartartuus¦oq	N	–up, –ut
oqaaseqartartuutita¦q	N	–p, –t
oqaaseqartita¦q	N	–p, –t
oqaaseqartitta¦gaq	N	–kkap, –kkat
oqaaseqatigiilerine¦q	N	–rup, –rit
oqaa¦seqatigiilerineq	N	{–seqatigiilerinerup, –tileqatigiilerinerup}, {–seqatigiilerinerit, –tileqatigiilerinerit}
oqaaseqatigiiliorne¦q	N	–rup, –rit
oqaa¦seqatigiiliorneq	N	{–seqatigiiliornerup, –tileqatigiiliornerup}, {–seqatigiiliornerit, –tileqatigiiliornerit}
oqaaseqatigiit	N, pl.	-
oqaa¦seqatigiit	N, pl.	{–seqatigiit, –tileqatigiit}
oqaaseraa	V	(no generation)
oqaaserineqa¦rajuttoq	N	{–kkajuttup, –rajuttup}, {–kkajuttut, –rajuttut}
oqaa¦serineqarajuttoq	N	{–serineqakkajuttup, –serineqarajuttup, –tilerineqakkajuttup, –tilerineqarajuttup}, {–serineqakkajuttut, –serineqarajuttut, –tilerineqakkajuttut, –tilerineqarajuttut}
oqaaserinerluppaa	V	(no generation)
oqaaserippoq	V	(no generation)
oqaaserisannaa¦q	N	–p, –t
oqaaserisa¦q	N	–p, –t
oqaaserisarta¦gaq	N	–kkap, –kkat
oqaa¦serisartagaq	N	{–serisartakkap, –tilerisartakkap}, {–serisartakkat, –tilerisartakkat}
oqaaserissaarpoq	V	(no generation)
oqaaserluffigaa	V	(no generation)
oqaaserluppoq	V	(no generation)
Oqaaserpassualeriffi¦k	N	–up, –it
Oqaaserpassualeriffi¦k	Prop	–up, –it
oqaaserpassualerine¦q	N	–rup, –rit
oqaaserpassualeris¦oq	N	–up, –ut
oqaaserpassual¦ik	N	{–iup, –lip, –lup}, –lit
oqaasersia¦q	N	–p, –t
oqaasersi¦ooq	N	–uup, –uut
oqaasersiuut	N	–ip, –it
oqaasersiuut	N, pl.	-
oqaasersivaa	V	(no generation)
oqaasertalersorpaa	V	(no generation)
oqaasertalersuine¦q	N	–rup, –rit
oqaasertalersuivoq	V	(no generation)
oqaasertaligaanngits¦oq	N	–up, –ut
oqaa¦sertaligaanngitsoq	N	{–sertaligaanngitsup, –tilertaligaanngitsup}, {–sertaligaanngitsut, –tilertaligaanngitsut}
oqaasertaliine¦q	N	–rup, –rit
oqaasertaliussa¦q	N	–p, –t
oqaaserta¦q	N	–p, –t
oqaaserujuit	N, pl.	-
oqaasiinnaas¦oq	N	–up, –ut
oqaasiinnaliorne¦q	N	–rup, –rit
Oqaasileriffi¦k	N	–up, –it
Oqaasileriffi¦k	Prop	–up, –it
oqaasilerine¦q	N	–rup, –rit
oqaasileris¦oq	N	–up, –ut
oqaasilerissu¦siaq	N	{–siap, –tiliap}, {–siat, –tiliat}
oqaasilerissu¦siortoq	N	{–siortup, –tiliortup}, {–siortut, –tiliortut}
oqaasilerisuuvoq	V	(no generation)
oqaasilerivoq	V	(no generation)
oqaasilia¦q	N	–p, –t
oqaasiliorne¦q	N	–rup, –rit
Oqaasiliortut	N, pl.	-
Oqaasiliortut	Prop, pl.	-
oqaasiliuutissat	N	–ip, –it
oqaasinnaa¦q	N	–p, –t
oqaasinngorpaa	V	(no generation)
oqaasinngortippaa	V	(no generation)
oqaasinnguussimas¦oq	N	–up, –ut
oqaasipalaa¦q	N	–p, –t
oqaasipalaat	N, pl.	-
oqaasipiluffigitippoq	V	(no generation)
oqaasipilu¦k	N	–up, –it
oqaasipiluliorfigaa	V	(no generation)
oqaasipilulissuuvoq	V	(no generation)
oqaasipilunne¦q	N	–rup, –rit
oqaa¦sipilunneq	N	{–sipilunnerup, –tilipilunnerup}, {–sipilunnerit, –tilipilunnerit}
oqaasipiluppoq	V	(no generation)
oqaasipilussaarpoq	V	(no generation)
oqaasipilussu¦aq	N	–up, –it
oqaasipiluttuarpoq	V	(no generation)
oqaasipiluuppaa	V	(no generation)
oqaasipiluussine¦q	N	–rup, –rit
oqaasipiluussivoq	V	(no generation)
oqaasipiluut	N	–ip, –it
oqaasissaaruppoq	V	(no generation)
oqaasissa¦q	N	–p, –t
oqaasissaqarfigaa	V	(no generation)
oqaasissaqarfiginngilaa	V	(no generation)
oqaasissaqarfiginnitt¦oq	N	–up, –ut
oqaasissaqarluart¦oq	N	–up, –ut
oqaasissaqarne¦q	N	–rup, –rit
oqaasissaqarpianngilaq	V	(no generation)
oqaasissaqartitaane¦q	N	–rup, –rit
oqaasissaqartitaanerus¦oq	N	–up, –ut
oqaasissaqartitaas¦oq	N	–up, –ut
oqaasissaqart¦oq	N	–up, –ut
oqaasissaqartuune¦q	N	–rup, –rit
oqaasissaqartuunerus¦oq	N	–up, –ut
oqaasissarsiorne¦q	N	–rup, –rit
oqaasissiorneqarpoq	V	(no generation)
oqaasissiorpaa	V	(no generation)
oqaasissiuivoq	V	(no generation)
oqaasitoqaas¦oq	N	–up, –ut
oqaasiusart¦oq	N	–up, –ut
oqaa¦siusartoq	N	{–siusartup, –tiliusartup}, {–siusartut, –tiliusartut}
oqaassivoq	V	(no generation)
oqaassut	N	–ip, –it
oqaassutigaa	V	(no generation)
oqaatigaa	V	(no generation)
oqaatigiinna¦gaq	N	–kkap, –kkat
oqaatigineqanngits¦oq	N	–up, –ut
oqa¦atigineqanngitsoq	N	{–atigineqanngitsup, –jutigineqanngitsup}, {–atigineqanngitsut, –jutigineqanngitsut}
oqaatiginerluppaa	V	(no generation)
oqaatiginneriaa¦seq	N	–tsip, –tsit
oqaatiginnippoq	V	(no generation)
oqaatiginnitt¦oq	N	–up, –ut
oqaatigisaane¦q	N	–rup, –rit
oqaatigisaas¦oq	N	–up, –ut
oqaatigisa¦q	N	–p, –t
oqaatigisassaanngits¦oq	N	–up, –ut
oqaatigisoorpaa	V	(no generation)
oqaatigitsiarpaa	V	(no generation)
oqaatilliis¦oq	N	–up, –ut
oqaatilliivoq	V	(no generation)
oqaatissuaane¦q	N	–rup, –rit
oqaatissuaas¦oq	N	–up, –ut
oqaatissuaavoq	V	(no generation)
oqaatissuarpaa	V	(no generation)
oqaatsartorpaa	V	(no generation)
oqaatseriarpoq	V	(no generation)
oqaatseriart¦oq	N	–up, –ut
oqaat¦seriartoq	N	{–iteriartup, –seriartup}, {–iteriartut, –seriartut}
oqaatseriillivoq	V	(no generation)
oqaatseriippoq	V	(no generation)
oqaatseriissu¦seq	N	–tsip, –tsit
oqaat¦seriissuseq	N	{–iteriissutsip, –seriissutsip}, {–iteriissutsit, –seriissutsit}
oqaatseriits¦oq	N	–up, –ut
oqaatserii¦tsoq	N	{–ssup, –tsup, –ttup}, {–ssut, –tsut, –ttut}
oqaatserit¦ooq	N	–uup, –uut
oqaatserituallaaqaaq	V	(no generation)
oqaatserivoq	V	(no generation)
oqaatsit	N, pl.	-
oqaats¦oq	N	–up, –ut
oqaatsorniarpoq	V	(no generation)
oqaatsua¦q	N	–p, –t
oqaatsueruppoq	V	(no generation)
oqaatsunukarpoq	V	(no generation)
Oqaatsut	N, pl.	-
Oqaatsut	Prop, pl.	-
oqaatsuusa¦q	N	–p, –t
oqajamaa¦q	N	–p, –t
oqajamaas¦oq	N	–up, –ut
oqajamaassu¦seq	N	–tsip, –tsit
oqajamaavoq	V	(no generation)
oqajuerne¦q	N	–rup, –rit
oqajuerpoq	V	(no generation)
oqajuer¦soq	N	{–sup, –tup}, {–sut, –tut}
oqajuissu¦seq	N	–tsip, –tsit
oqajuits¦oq	N	–up, –ut
oqakippoq	V	(no generation)
oqakivippoq	V	(no generation)
oqallatsiarne¦q	N	–rup, –rit
oqallatsiarpoq	V	(no generation)
oqallatsiartarpoq	V	(no generation)
oqallattaalerpoq	V	(no generation)
oqallattaarpoq	V	(no generation)
oqalliffi¦k	N	–up, –it
oqalliffissaanngilaq	V	(no generation)
oqallinne¦q	N	–rup, –rit
oqallippalunne¦q	N	–rup, –rit
oqallisaa	N	–p, –t
oqallisaajuarpoq	V	(no generation)
oqallisaajunnaarpoq	V	(no generation)
oqallisaavoq	V	(no generation)
oqalliseqataas¦oq	N	–up, –ut
oqalliseriaa¦seq	N	–tsip, –tsit
oqallisigaa	V	(no generation)
oqallisigeqqusaanngits¦oq	N	–up, –ut
oqallisigineqangaart¦oq	N	–up, –ut
oqallisigineqart¦oq	N	–up, –ut
oqallisigingaalerpaa	V	(no generation)
oqallisiginneqqaarne¦q	N	–rup, –rit
oqallisiginnikkusunnginne¦q	N	–rup, –rit
oqallisiginnippoq	V	(no generation)
oqallisiginnitt¦oq	N	–up, –ut
oqallisiginni¦ttoq	N	{–ssup, –ttup}, {–ssut, –ttut}
oqallisigiuarpaa	V	(no generation)
oqallisigiunnaarpaa	V	(no generation)
oqallisissaanngilaq	V	(no generation)
oqallisissia¦q	N	–p, –t
oqallissaarisart¦oq	N	–up, –ut
oqallissaarivoq	V	(no generation)
oqallissaarut	N	–ip, –it
oqallissaaruteqarne¦q	N	–rup, –rit
oqallissutigaa	V	(no generation)
oqallit	N, pl.	-
oqallittarfi¦k	N	–up, –it
oqallorippallaanngilaq	V	(no generation)
oqallorippoq	V	(no generation)
oqallorissaarpoq	V	(no generation)
oqallorissaas¦oq	N	–up, –ut
oqallori¦ssaat	N	{–ssaatip, –ttaatip}, {–ssaatit, –ttaatit}
oqallorissarne¦q	N	–rup, –rit
oqallori¦ssarneq	N	{–ssarnerup, –ttarnerup}, {–ssarnerit, –ttarnerit}
oqallorissivoq	V	(no generation)
oqallori¦ssoq	N	{–ssup, –ttup}, {–ssut, –ttut}
oqallorissorsuuvoq	V	(no generation)
oqallorissu¦seq	N	–tsip, –tsit
oqalloriusa¦q	N	–p, –t
oqallorluppoq	V	(no generation)
oqallorluttuuvoq	V	(no generation)
oqallort¦ooq	N	–uup, –uut
oqallortunersaavoq	V	(no generation)
oqallortuvoq	V	(no generation)
oqallukippoq	V	(no generation)
oqallukitsuunngilaq	V	(no generation)
oqallutsippallaarpoq	V	(no generation)
oqallutsissutigaa	V	(no generation)
oqaloqateqarne¦q	N	–rup, –rit
oqaloqateqarpoq	V	(no generation)
oqaloqatigaa	V	(no generation)
oqaloqatigeerujoorne¦q	N	–rup, –rit
oqaloqatigiinne¦q	N	–rup, –rit
oqaloqatigiinnerit	N, pl.	-
oqaloqatigiissuteqarne¦q	N	–rup, –rit
oqaloqatigiissutigaa	V	(no generation)
oqaloqatigiissutissaavoq	V	(no generation)
oqaloqatigiissutissa¦q	N	–p, –t
oqaloqatigiissutit	N, pl.	-
oqaloqatigiitsiarne¦q	N	–rup, –rit
oqaloqatigineqarsinnaas¦oq	N	–up, –ut
oqaloqatiginninne¦q	N	–rup, –rit
oqaloqatiginnippoq	V	(no generation)
oqaloqatiginnitsitaas¦oq	N	–up, –ut
oqaloqatigiuminart¦oq	N	–up, –ut
oqaloqatikkuminart¦oq	N	–up, –ut
oqaloqqippoq	V	(no generation)
oqalorujoorpoq	V	(no generation)
oqalorujuffigaa	V	(no generation)
oqalorujukkajuppoq	V	(no generation)
oqalorujulerpoq	V	(no generation)
oqalorujunne¦q	N	–rup, –rit
oqalorujuppoq	V	(no generation)
oqalorujuttaannarpoq	V	(no generation)
oqalorujuunne¦q	N	–rup, –rit
oqalorujuuppaa	V	(no generation)
oqalorujuussine¦q	N	–rup, –rit
oqalorujuussivoq	V	(no generation)
oqalorujuut	N	–ip, –it
oqalorusaarne¦q	N	–rup, –rit
oqalorusaarpoq	V	(no generation)
oqalorussaappaa	V	(no generation)
oqalorussarpoq	V	(no generation)
oqaloruusarpoq	V	(no generation)
oqaluagajuppoq	V	(no generation)
oqalualaa¦q	N	–p, –t
oqalualaaqaqaaq	V	(no generation)
oqalualaaraa	V	(no generation)
oqalualaarpoq	V	(no generation)
oqalualaarsiorpaa	V	(no generation)
oqalualaarut	N	–ip, –it
oqalualuffigaa	V	(no generation)
oqalualunne¦q	N	–rup, –rit
oqalualuppalu¦k	N	–up, –it
oqalualuppoq	V	(no generation)
oqaluarpalu¦k	N	–up, –it
oqaluarpaluppoq	V	(no generation)
oqaluasaal¦ik	N	{–iup, –lip, –lup}, –lit
oqaluasaa¦q	N	–p, –t
oqaluasaarpoq	V	(no generation)
oqaluatsiia¦q	N	–p, –t
oqaluavoq	V	(no generation)
oqaluffigaa	V	(no generation)
oqaluffi¦k	N	–up, –it
oqaluffik¦oq	N	–up, –ut
oqaluffissaa¦q	N	–p, –t
oqaluffissaarsu¦aq	N	–up, –it
oqaluffitoq¦aq	N	–qap, –qat
oqaluffittaa¦q	N	–p, –t
oqalugiaat	N	–ip, –it
oqalugiarfi¦k	N	–up, –it
oqalugiarne¦q	N	–rup, –rit
oqalugiarpoq	V	(no generation)
oqalugiartart¦oq	N	–up, –ut
oqalugiartippaa	V	(no generation)
oqalugiartitsivoq	V	(no generation)
oqalugiart¦oq	N	–up, –ut
oqaluinnarne¦q	N	–rup, –rit
oqaluinnarniut	N	–ip, –it
oqaluinnarpoq	V	(no generation)
oqalukkumat¦ooq	N	–uup, –uut
oqalukuluffigaa	V	(no generation)
oqalukuluppoq	V	(no generation)
oqalulerpoq	V	(no generation)
oqalulinnguaraluarpoq	V	(no generation)
oqalullaqqippoq	V	(no generation)
oqalullaqqiss¦oq	N	–up, –ut
oqalullaqqi¦ssoq	N	{–ssup, –ttup}, {–ssut, –ttut}
oqalullaqqissu¦seq	N	–tsip, –tsit
oqalullaqqissuunngilaq	V	(no generation)
oqalullarpoq	V	(no generation)
oqalulluarsinnaanngits¦oq	N	–up, –ut
oqalunguserpoq	V	(no generation)
oqalungusiaat	N	–ip, –it
oqalungusiallaqqippoq	V	(no generation)
oqalungusiarpoq	V	(no generation)
oqalungusiut	N	–ip, –it
oqalungussarne¦q	N	–rup, –rit
oqalungussarpoq	V	(no generation)
oqalunne¦q	N	–rup, –rit
oqalunnerulerpoq	V	(no generation)
oqalunnguatsiaraluarpoq	V	(no generation)
oqalupiluffigaa	V	(no generation)
oqalupilukkajuppoq	V	(no generation)
oqalupiluppoq	V	(no generation)
oqaluppalaanngu¦aq	N	–up, –it
oqaluppalaa¦q	N	–p, –t
oqaluppalaaraa	V	(no generation)
oqaluppalaarisa¦q	N	–p, –t
oqaluppalaarniartorujussu¦aq	N	–up, –it
oqaluppalaarpoq	V	(no generation)
oqaluppallaaqaaq	V	(no generation)
oqaluppallaarne¦q	N	–rup, –rit
oqaluppallaarnersu¦aq	N	–up, –it
oqaluppallaarpoq	V	(no generation)
oqaluppallaartaqaaq	V	(no generation)
oqaluppoq	V	(no generation)
oqalussinnaajunnaarne¦q	N	–rup, –rit
oqalussinnaane¦q	N	–rup, –rit
oqalussinnaanngorpoq	V	(no generation)
oqalussinnaanngortippaa	V	(no generation)
oqalussinnaas¦oq	N	–up, –ut
oqalussinnaavoq	V	(no generation)
oqalutseqarne¦q	N	–rup, –rit
oqalutsi	N	–p, –t
oqalutsigaa	V	(no generation)
oqalutsigisa¦q	N	–p, –t
oqalutsiuvoq	V	(no generation)
oqaluttaagalu¦aq	N	–up, –it
oqaluttaane¦q	N	–rup, –rit
oqaluttaa¦seq	N	–tsip, –tsit
oqaluttaat	N	–ip, –it
oqaluttaavoq	V	(no generation)
oqaluttarfi¦k	N	–up, –it
oqaluttarne¦q	N	–rup, –rit
oqaluttarpoq	V	(no generation)
oqaluttart¦oq	N	–up, –ut
oqalutt¦oq	N	–up, –ut
oqaluttorujussuanngorpoq	V	(no generation)
oqaluttuaannarpoq	V	(no generation)
oqaluttuaaralia¦q	N	–p, –t
oqaluttuaas¦oq	N	–up, –ut
oqaluttuaateqarne¦q	N	–rup, –rit
oqaluttualeqqaarpoq	V	(no generation)
oqaluttualerit¦ooq	N	–uup, –uut
oqaluttualerpoq	V	(no generation)
oqaluttualia¦q	N	–p, –t
oqaluttualiat	N, pl.	-
oqaluttualiortart¦oq	N	–up, –ut
oqaluttualiort¦oq	N	–up, –ut
oqaluttualiullaqqippoq	V	(no generation)
oqaluttuallaqqippoq	V	(no generation)
oqaluttuallaqqissu¦seq	N	–tsip, –tsit
oqaluttua¦q	N	–p, –t
oqaluttuaraa	V	(no generation)
oqaluttuareqqiine¦q	N	–rup, –rit
oqaluttuareqqippaa	V	(no generation)
oqaluttuareqqita¦q	N	–p, –t
oqaluttuarfigaa	V	(no generation)
oqaluttuariaa¦seq	N	–tsip, –tsit
oqaluttuarineqarpoq	V	(no generation)
oqaluttuarineqarsinnaanngits¦oq	N	–up, –ut
oqaluttuarinninne¦q	N	–rup, –rit
oqaluttuarinnissinnaassu¦seq	N	–tsip, –tsit
oqaluttuarisaane¦q	N	–rup, –rit
oqaluttuarissavaa	V	(no generation)
oqaluttuarne¦q	N	–rup, –rit
oqaluttuarpalaart¦oq	N	–up, –ut
oqaluttuarpoq	V	(no generation)
oqaluttuarsinnaassu¦seq	N	–tsip, –tsit
oqaluttuartart¦oq	N	–up, –ut
oqaluttuart¦oq	N	–up, –ut
oqaluttuaruju¦k	N	–up, –it
oqaluttuarumat¦ooq	N	–uup, –uut
oqaluttuassarsiorpoq	V	(no generation)
oqaluttuat	N, pl.	-
oqaluttuatoq¦aq	N	{–qap, –ap}, {–qat, –at}
oqaluttuatoqqat	N, pl.	-
oqaluttuuppaa	V	(no generation)
oqaluttuussivoq	V	(no generation)
oqaluukkuminaappoq	V	(no generation)
oqaluukkuminarpoq	V	(no generation)
oqaluukkuminart¦oq	N	–up, –ut
oqaluummarippoq	V	(no generation)
oqaluuppaa	V	(no generation)
oqaluusaavoq	V	(no generation)
oqaluu¦seq	N	–tsip, –tsit
oqaluuseraa	V	(no generation)
oqaluusereqqippaa	V	(no generation)
oqaluuserineqanngits¦oq	N	–up, –ut
oqaluu¦serineqanngitsoq	N	{–serineqanngitsup, –tilerineqanngitsup}, {–serineqanngitsut, –tilerineqanngitsut}
oqaluuserineqart¦oq	N	–up, –ut
oqaluu¦serineqartoq	N	{–serineqartup, –tilerineqartup}, {–serineqartut, –tilerineqartut}
oqaluuserinngivippaa	V	(no generation)
oqaluuserinnippoq	V	(no generation)
oqaluuserisa¦q	N	–p, –t
oqaluuserisassa¦q	N	–p, –t
oqaluuserisassat	N, pl.	-
oqaluusissiorpoq	V	(no generation)
oqaluusiuvoq	V	(no generation)
oqaluussaanngilaq	V	(no generation)
oqaluussa¦q	N	–p, –t
oqaluussassaanngilaq	V	(no generation)
oqaluussiartortikkumavaa	V	(no generation)
oqaluussine¦q	N	–rup, –rit
oqaluussinerit	N, pl.	-
oqaluussisart¦oq	N	–up, –ut
oqaluussis¦oq	N	–up, –ut
oqaluussissut	N	–ip, –it
oqaluussi¦ssut	N, pl.	{–ssut, –ttut}
oqaluussissutigaa	V	(no generation)
oqaluussivoq	V	(no generation)
oqaluusuunngilaq	V	(no generation)
oqaluut	N	–ip, –it
oqaluutaasa¦q	N	–p, –t
oqaluutaassut	N	–ip, –it
oqaluutaavoq	V	(no generation)
oqaluuteqarfi¦k	N	–up, –it
oqaluutigaa	V	(no generation)
oqaluutinngortippaa	V	(no generation)
oqaluutita¦q	N	–p, –t
oqaluuvoq	V	(no generation)
oqamisaarpoq	V	(no generation)
oqamivoq	V	(no generation)
oqanngikkaluarpoq	V	(no generation)
oqanngisaannarpoq	V	(no generation)
oqapallappoq	V	(no generation)
oqapallattarpoq	V	(no generation)
oqapiloorpoq	V	(no generation)
oqapiluffigaa	V	(no generation)
oqapiluppoq	V	(no generation)
oq¦aq	N	{–ap, –qap}, {–at, –qat}
oqaqqaarpoq	V	(no generation)
oqaqqaartuuvoq	V	(no generation)
oqaqqarniut	N	–ip, –it
oqaraa	V	(no generation)
oqaraanngilaq	V	(no generation)
oqaraluanngilaq	V	(no generation)
oqarasuaat	N	–ip, –it
oqarasuaateqarfi¦k	N	–up, –it
oqarasuaa¦tilerisoq	N	{–serisup, –tilerisup}, {–serisut, –tilerisut}
oqarasuarfigaa	V	(no generation)
oqarasuarne¦q	N	–rup, –rit
oqarasuarpoq	V	(no generation)
oqarasuartaat	N	–ip, –it
oqarasuartarfi¦k	N	–up, –it
oqarataarajuppoq	V	(no generation)
oqarataarpoq	V	(no generation)
oqarataartaannarpoq	V	(no generation)
oqarataart¦oq	N	–up, –ut
oqarataassu¦seq	N	–tsip, –tsit
oqarfigaa	V	(no generation)
oqarfigeqqippaa	V	(no generation)
oqarfigeruloorpaa	V	(no generation)
oqarfigineqarpoq	V	(no generation)
oqarfiginninne¦q	N	–rup, –rit
oqarfigipiloorpaa	V	(no generation)
oqarfigipiluuivoq	V	(no generation)
oqariaa¦seq	N	–tsip, –tsit
oqariarne¦q	N	–rup, –rit
oqariartaa¦seq	N	–tsip, –tsit
oqariartaasinnaa¦q	N	–p, –t
oqariartorfigaa	V	(no generation)
oqariartorpoq	V	(no generation)
oqariartortitsivigaa	V	(no generation)
oqariartort¦oq	N	–up, –ut
oqariartuuppaa	V	(no generation)
oqariartuussivoq	V	(no generation)
oqariartuut	N	–ip, –it
oqariartuutaavoq	V	(no generation)
oqariartuutigaa	V	(no generation)
oqariasaarpoq	V	(no generation)
oqariataallaqqiss¦oq	N	–up, –ut
oqariataallaqqi¦ssoq	N	{–ssup, –ttup}, {–ssut, –ttut}
oqaria¦taallaqqissoq	N	{–saallaqqissup, –saallaqqittup, –taallaqqissup, –taallaqqittup}, {–saallaqqissut, –saallaqqittut, –taallaqqissut, –taallaqqittut}
oqariataallaqqissu¦seq	N	–tsip, –tsit
oqaria¦taallaqqissuseq	N	{–saallaqqissutsip, –taallaqqissutsip}, {–saallaqqissutsit, –taallaqqissutsit}
oqariataarne¦q	N	–rup, –rit
oqaria¦taarneq	N	{–saarnerup, –taarnerup}, {–saarnerit, –taarnerit}
oqariataarpoq	V	(no generation)
oqariataartart¦oq	N	–up, –ut
oqaria¦taartartoq	N	{–saartartup, –taartartup}, {–saartartut, –taartartut}
oqariataartartuuvoq	V	(no generation)
oqarluarpoq	V	(no generation)
oqarmiu	N	–p, –t
oqarne¦q	N	–rup, –rit
oqarneraane¦q	N	–rup, –rit
oqarnikkumatuvoq	V	(no generation)
oqarnippoq	V	(no generation)
oqarpallappoq	V	(no generation)
oqarpallattarpoq	V	(no generation)
oqarpoq	V	(no generation)
oqarsaarine¦q	N	–rup, –rit
oqarsaarpaa	V	(no generation)
oqarsiivaa	V	(no generation)
oqarsinnaat	N, pl.	-
oqarsorfigaa	V	(no generation)
oqarsorpoq	V	(no generation)
oqartarinngilaq	V	(no generation)
oqartarne¦q	N	–rup, –rit
oqartoorne¦q	N	–rup, –rit
oqartoorpoq	V	(no generation)
oqartoqanngilaq	V	(no generation)
oqartussaaffeqarfi¦k	N	–up, –it
oqartussaaffigaa	V	(no generation)
oqartussaaffi¦k	N	–up, –it
oqartussaaqataalerne¦q	N	–rup, –rit
oqar¦tussaaqataalerneq	N	{–tussaaqataalernerup, –sussaaqataalernerup}, {–tussaaqataalernerit, –sussaaqataalernerit}
oqartussaaqataane¦q	N	–rup, –rit
oqar¦tussaaqataaneq	N	{–tussaaqataanerup, –sussaaqataanerup}, {–tussaaqataanerit, –sussaaqataanerit}
oqartussaas¦oq	N	–up, –ut
oqartussaasoqarfi¦k	N	–up, –it
oqartussaassuseqarne¦q	N	–rup, –rit
oqar¦tussaassuseqarneq	N	{–tussaassuseqarnerup, –sussaassuseqarnerup}, {–tussaassuseqarnerit, –sussaassuseqarnerit}
oqartussaasut	N, pl.	-
oqartussaatitaas¦oq	N	–up, –ut
oqartussaatita¦q	N	–p, –t
oqartussaavinne¦q	N	–rup, –rit
oqar¦tussaavinneq	N	{–tussaavinnerup, –sussaavinnerup}, {–tussaavinnerit, –sussaavinnerit}
oqartussaavoq	V	(no generation)
oqartussaqarfi¦k	N	–up, –it
oqartussat	N, pl.	-
oqartussatuaaniart¦oq	N	–up, –ut
oqarumarpianngits¦oq	N	–up, –ut
oqaruserajuppoq	V	(no generation)
oqaruserfigaa	V	(no generation)
oqaruserne¦q	N	–rup, –rit
oqaruserpoq	V	(no generation)
oqarusiut	N	–ip, –it
oqarusiutaavoq	V	(no generation)
oqarusiutigaa	V	(no generation)
oqarusuppoq	V	(no generation)
oqasisarpoq	V	(no generation)
oqasisartaannarpoq	V	(no generation)
oqasissa¦q	N	–p, –t
oqassaanngilaq	V	(no generation)
oqassaanngissu¦seq	N	–tsip, –tsit
oqassaanngits¦oq	N	–up, –ut
oqassarlerpoq	V	(no generation)
oqassarlersippaa	V	(no generation)
oqassarliuppaa	V	(no generation)
oqassatanngueruppoq	V	(no generation)
oqatsiaat	N	–ip, –it
oqatsiaat	N, pl.	-
oqatsiaatigaa	V	(no generation)
oqatsiarne¦q	N	–rup, –rit
oqatsiarpoq	V	(no generation)
oqersarpoq	V	(no generation)
oqigaa	V	(no generation)
oqiginnippoq	V	(no generation)
oqigisoorpaa	V	(no generation)
oqigivippaa	V	(no generation)
oqilaallivoq	V	(no generation)
oqilaalu¦k	N	–up, –it
oqilaappoq	V	(no generation)
oqilaaqaaq	V	(no generation)
oqilaneqqisaanne¦q	N	–rup, –rit
oqilanerulerpoq	V	(no generation)
oqilasaarpoq	V	(no generation)
oqilas¦ooq	N	–uup, –uut
oqila¦sooq	N	{–suup, –tuup}, {–suut, –tuut}
oqilavallaanngilaq	V	(no generation)
oqilavippoq	V	(no generation)
oqilavoq	V	(no generation)
oqiliallappoq	V	(no generation)
oqiliallassimas¦oq	N	–up, –ut
oqiline¦q	N	–rup, –rit
oqilisaaffigineqarpoq	V	(no generation)
oqilisaaffigisa¦q	N	–p, –t
oqilisaane¦q	N	–rup, –rit
oqilisaanneqarne¦q	N	–rup, –rit
oqilisaappaa	V	(no generation)
oqilisaassine¦q	N	–rup, –rit
oqilisaassinertal¦ik	N	{–iup, –lip, –lup}, –lit
oqilisaassissut	N	–ip, –it
oqilisaassissut	N, pl.	-
oqilisaassivoq	V	(no generation)
oqilisippaa	V	(no generation)
oqilissut	N	–ip, –it
oqilivaa	V	(no generation)
oqilivoq	V	(no generation)
oqillappoq	V	(no generation)
oqillassarpaa	V	(no generation)
oqillassarpoq	V	(no generation)
oqillassimaarpoq	V	(no generation)
oqillatsi¦ppoq	V	–nngilaq
oqillisippaa	V	(no generation)
oqillivoq	V	(no generation)
oqilluaarippoq	V	(no generation)
oqilluaarissivoq	V	(no generation)
oqiluallagaa	V	(no generation)
oqiluallappoq	V	(no generation)
oqimaagaa	V	(no generation)
oqimaaginnippoq	V	(no generation)
oqimaagisoorpaa	V	(no generation)
oqimaalline¦q	N	–rup, –rit
oqimaallisippaa	V	(no generation)
oqimaallivoq	V	(no generation)
oqimaaloqut¦aq	N	{–ap, –tap}, {–at, –tat}
oqimaalutaane¦q	N	–rup, –rit
oqimaalutaaqqinne¦q	N	–rup, –rit
oqimaalutaaqqissaarne¦q	N	–rup, –rit
oqimaalutaasarfi¦k	N	–up, –it
oqimaalutaasart¦oq	N	–up, –ut
oqimaalutaat	N	–ip, –it
oqimaalutaavi¦k	N	–up, –it
oqimaalutaa¦vik	N	{–ffiup, –viup}, {–ffiit, –viit}
oqimaalutaavoq	V	(no generation)
oqimaalut¦aq	N	{–ap, –tap}, {–at, –tat}
oqimaalutarpaa	V	(no generation)
oqimaalutserpaa	V	(no generation)
oqimaalutsiivoq	V	(no generation)
oqimaanaarpaa	V	(no generation)
oqimaannerus¦oq	N	–up, –ut
oqimaannerussu¦seq	N	–tsip, –tsit
oqimaappallaarne¦q	N	–rup, –rit
oqimaappallaarsoraa	V	(no generation)
oqimaappallaart¦oq	N	–up, –ut
oqimaappalutt¦oq	N	–up, –ut
oqimaappoq	V	(no generation)
oqimaaqatigiinne¦q	N	–rup, –rit
oqimaaqatigiinnginne¦q	N	–rup, –rit
oqimaaqatigiissaarine¦q	N	–rup, –rit
oqimaaqatigiissaarivoq	V	(no generation)
oqimaaqatigiissarpaa	V	(no generation)
oqimaaqatigii¦ssitsineq	N	{–ssitsinerup, –tsitsinerup}, {–ssitsinerit, –tsitsinerit}
oqimaaqatigiissu¦seq	N	–tsip, –tsit
oqimaassu¦seq	N	–tsip, –tsit
oqimaassuseqart¦oq	N	–up, –ut
oqimaassusiugajunnerus¦oq	N	–up, –ut
oqimaats¦oq	N	–up, –ut
oqimaatsorsiorpoq	V	(no generation)
oqimaatsorsiortippaa	V	(no generation)
oqimaatsorsu¦aq	N	–up, –it
oqimaatsuuvoq	V	(no generation)
oqimangerajuppoq	V	(no generation)
oqimangerne¦q	N	–rup, –rit
oqimangerpoq	V	(no generation)
oqimangiuippoq	V	(no generation)
oqimangiut	N	–ip, –it
oqimangiutaavoq	V	(no generation)
oqimangiutigaa	V	(no generation)
oqinaarpaa	V	(no generation)
oqinaarsivoq	V	(no generation)
oqinaavippaa	V	(no generation)
oqinnersa¦q	N	–p, –t
oqinnerulerpoq	V	(no generation)
oqinnerulersippaa	V	(no generation)
oqinnerus¦oq	N	–up, –ut
oqinnerusunngortippaa	V	(no generation)
oqinninngu¦aq	N	–up, –it
oqippallaarsoraa	V	(no generation)
oqippoq	V	(no generation)
oqissu¦seq	N	–tsip, –tsit
oqi¦tsoq	N	{–ssup, –tsup, –ttup}, {–ssut, –tsut, –ttut}
oqitsoralaanngu¦aq	N	–up, –it
oqi¦tsoralaannguaq	N	{–ssoralaannguup, –tsoralaannguup, –ttoralaannguup}, {–ssoralaannguit, –tsoralaannguit, –ttoralaannguit}
oqitsorsiorpoq	V	(no generation)
oqoqarfi¦k	N	–up, –it
oqoqarne¦q	N	–rup, –rit
oqornarpoq	V	(no generation)
oqornerulerpoq	V	(no generation)
oqorpoq	V	(no generation)
oqorsaalluarne¦q	N	–rup, –rit
oqorsaalluarpoq	V	(no generation)
oqorsaappaa	V	(no generation)
oqorsaaserpoq	V	(no generation)
oqorsaat	N	–ip, –it
oqorsaataavoq	V	(no generation)
oqorsaatigaa	V	(no generation)
oqorsaatil¦ik	N	{–iup, –lip, –lup}, –lit
oqorsaatissa¦q	N	–p, –t
oqorsaavoq	V	(no generation)
oqorsarpaa	V	(no generation)
oqorsarpoq	V	(no generation)
oqorsarsima¦voq	V	–nngilaq
oqorsivoq	V	(no generation)
oqort¦oq	N	–up, –ut
oqortuinnaavoq	V	(no generation)
oqorunaqaaq	V	(no generation)
oqorunarpallaanngilaq	V	(no generation)
oqorunarpoq	V	(no generation)
oqorunarsarpoq	V	(no generation)
oqorunarsivoq	V	(no generation)
oqoruserpaa	V	(no generation)
oqoruserpoq	V	(no generation)
oqorusersorpaa	V	(no generation)
oqoru¦sersorpoq	V	–tilersunngilaq
oqorut	N	–ip, –it
oqorutissia¦q	N	–p, –t
oqorutitaarpoq	V	(no generation)
oqorutsiorpoq	V	(no generation)
oqqakippoq	V	(no generation)
oqqanne¦q	N	–rup, –rit
oqqappaa	V	(no generation)
oqqarliorajuppoq	V	(no generation)
oqqarliorpoq	V	(no generation)
oqqarlunne¦q	N	–rup, –rit
oqqarluppoq	V	(no generation)
oqqarluttuune¦q	N	–rup, –rit
oqqarluut	N	–ip, –it
oqqarluutaavoq	V	(no generation)
oqqartuvoq	V	(no generation)
oqqassaarivoq	V	(no generation)
oqqassine¦q	N	–rup, –rit
oqqassivoq	V	(no generation)
oqqateruloorpaa	V	(no generation)
oqqerpaa	V	(no generation)
oqqersorpaa	V	(no generation)
oqqersuiffigaa	V	(no generation)
oqqersuivoq	V	(no generation)
oqqersuut	N	–ip, –it
oqqersuutaavoq	V	(no generation)
oqqersuutigaa	V	(no generation)
oqqi	N	–p, –t
oqqiffeeruppoq	V	(no generation)
oqqiffigaa	V	(no generation)
oqqiffi¦k	N	–up, –it
oqqiffissaaruppoq	V	(no generation)
oqqiffissarsiorpoq	V	(no generation)
oqqiffiulluarpoq	V	(no generation)
oqqiisimavoq	V	(no generation)
oqqiivoq	V	(no generation)
oqqikkiartorpoq	V	(no generation)
oqqiorfi¦k	N	–up, –it
oqqiorfissarsiorpoq	V	(no generation)
oqqioriartorpoq	V	(no generation)
oqqiorpoq	V	(no generation)
oqqippaa	V	(no generation)
oqqippoq	V	(no generation)
oqqisaarpoq	V	(no generation)
oqqisimaarpoq	V	(no generation)
oqqiuppoq	V	(no generation)
oqq¦oq	N	–up, –ut
oqqorpaappaa	V	(no generation)
oqqorpaassaane¦q	N	–rup, –rit
oqqorpaassaavoq	V	(no generation)
oqqorparpoq	V	(no generation)
oqqorpasippoq	V	(no generation)
oqquannippoq	V	(no generation)
oqquannisaarpoq	V	(no generation)
oqqua¦q	N	–p, –t
oqquarpoq	V	(no generation)
oqquarta¦q	N	–p, –t
oqquart¦oq	N	–up, –ut
oqquassu¦seq	N	–tsip, –tsit
oqquavippoq	V	(no generation)
oqquiffi¦k	N	–up, –it
oqquiffissarsiorpoq	V	(no generation)
oqquikkiartorpoq	V	(no generation)
oqquippaa	V	(no generation)
oqquippoq	V	(no generation)
oqquisartorne¦q	N	–rup, –rit
oqquisartorpoq	V	(no generation)
oqquivoq	V	(no generation)
oqquj¦ooq	N	–uup, –uut
oqqummukaappaa	V	(no generation)
oqqummukaarpoq	V	(no generation)
oqqummukarpoq	V	(no generation)
oqqumukarpoq	V	(no generation)
oqquppaa	V	(no generation)
oqqussivoq	V	(no generation)
oqquusimaarpoq	V	(no generation)
oqquutserpoq	V	(no generation)
oquerulluinnarpoq	V	(no generation)
oqueruppoq	V	(no generation)
oquerusarpaa	V	(no generation)
oquffaari¦k	N	–p, –t
oquffaari¦k	N	–up, –it
oquiaat	N	–ip, –it
oquillisarpoq	V	(no generation)
oquippallaaqaaq	V	(no generation)
oquippoq	V	(no generation)
oquit	N, pl.	-
oqu¦k	N	–up, –it
oqul¦ik	N	{–iup, –lip, –lup}, –lit
oqulissuuvoq	V	(no generation)
oqumigaarne¦q	N	–rup, –rit
oqumigaarpoq	V	(no generation)
oqumippoq	V	(no generation)
oqumme¦raq	N	–qqap, –qqat
oqummerartorpoq	V	(no generation)
oqummerassa¦q	N	–p, –t
oqummerpaa	V	(no generation)
oqummersa¦q	N	–p, –t
oqummersarpaa	V	(no generation)
oqummersilaarpoq	V	(no generation)
oqummersivaa	V	(no generation)
oqumm¦ersivoq	V	–issinngilaq
oqummia¦gaq	N	–kkap, –kkat
oqummiak¦oq	N	–up, –ut
oqummi¦aq	N	–ssap, –ssat
oqummiaqarpoq	V	(no generation)
oqummiaqatta¦q	N	–p, –t
oqummiarfi¦k	N	–up, –it
oqummiarpaa	V	(no generation)
oqummiarpoq	V	(no generation)
oqummiartuarpaa	V	(no generation)
oqummigassa¦q	N	–p, –t
oqummisserpaa	V	(no generation)
oqummisserpoq	V	(no generation)
oqummissersorpoq	V	(no generation)
oqummissinert¦ooq	N	–uup, –uut
oqummissivaa	V	(no generation)
oqummissivoq	V	(no generation)
oqummiunniarpaa	V	(no generation)
oqummiuppaa	V	(no generation)
oqummiussaavoq	V	(no generation)
oqummiussilaarne¦q	N	–rup, –rit
oqummiussivoq	V	(no generation)
oqunne¦q	N	–rup, –rit
oqunngilaq	V	(no generation)
oquppoq	V	(no generation)
oqusserpaa	V	(no generation)
oqussimavoq	V	(no generation)
oqussunni¦ppoq	V	–nngilaq
oqutt¦oq	N	–up, –ut
oquttorsuuvoq	V	(no generation)
oquutalerpoq	V	(no generation)
oquut¦aq	N	{–ap, –tap}, {–at, –tat}
oquutarsivoq	V	(no generation)
oquutartorpoq	V	(no generation)
oquutserpaa	V	(no generation)
oquutserpoq	V	(no generation)
oquutsersorpaa	V	(no generation)
oquutsiorpoq	V	(no generation)
oquutsiuppaa	V	(no generation)
orang¦e	N	–ip, {–er, –it}
ordbog¦eeraq	N	{–eeqqap, –iaqqap}, {–eeqqat, –iaqqat}
Ordbogi	N	–p, –t
ordbogi	N	–p, –t
ordbogit	N, pl.	-
ordeneqarne¦q	N	–rup, –rit
ordenilersorpaa	V	(no generation)
ordenilersuivoq	V	(no generation)
orfaajusaarpoq	V	(no generation)
orfaavoq	V	(no generation)
orfuppaa	V	(no generation)
oriaane¦q	N	–rup, –rit
oriarne¦q	N	–rup, –rit
oriarpaa	V	(no generation)
oriartorfi¦k	N	–up, –it
oriartorpaa	V	(no generation)
oriartorpoq	V	(no generation)
original	N	–ip, –it
oriorfigaa	V	(no generation)
oriorne¦q	N	–rup, –rit
oriorpaa	V	(no generation)
oriorpoq	V	(no generation)
orissa¦q	N	–p, –t
oriu¦gaq	N	–kkap, –kkat
orleqqappaa	V	(no generation)
orleqqassivoq	V	(no generation)
orleqqavoq	V	(no generation)
orlerpaa	V	(no generation)
orlerpoq	V	(no generation)
orlersaraa	V	(no generation)
orlersimane¦q	N	–rup, –rit
orlersimavoq	V	(no generation)
orlingaarpoq	V	(no generation)
orlingasorujussuuvoq	V	(no generation)
orlingavoq	V	(no generation)
orloqqajaas¦oq	N	–up, –ut
orloqqajarpoq	V	(no generation)
orlugaj¦ooq	N	–uup, –uut
orlugajuppoq	V	(no generation)
orlugajutt¦oq	N	–up, –ut
orlugaluttuaqaaq	V	(no generation)
orlukulavoq	V	(no generation)
orlukutsoorpoq	V	(no generation)
orlunavianngilaq	V	(no generation)
orlune¦q	N	–rup, –rit
orlungavoq	V	(no generation)
orlusaannarpoq	V	(no generation)
orlussut	N	–ip, –it
orlussutigaa	V	(no generation)
orlutippaa	V	(no generation)
orlutitsivoq	V	(no generation)
orluvoq	V	(no generation)
ornakkerpoq	V	(no generation)
ornavaat	N	–ip, –it
ornavaffi¦k	N	–up, –it
ornavaffil¦ik	N	{–iup, –lip, –lup}, –lit
ornavappoq	V	(no generation)
orneqquaa	V	(no generation)
orngavaat	N	–ip, –it
orngavaffi¦k	N	–up, –it
orngavaffil¦ik	N	{–iup, –lip, –lup}, –lit
orngavappoq	V	(no generation)
ornigaa	V	(no generation)
ornigal¦ik	N	{–iup, –lip, –lup}, –lit
orni¦gaq	N	–kkap, –kkat
ornigarneqarluarpoq	V	(no generation)
ornigassa¦q	N	–p, –t
orniginarpoq	V	(no generation)
orniginartippaa	V	(no generation)
orniginart¦oq	N	–up, –ut
orniginngilaa	V	(no generation)
ornigisaqanngissu¦seq	N	–tsip, –tsit
ornigisaqanngits¦oq	N	–up, –ut
orniguffi¦k	N	–up, –it
ornigukkumanngilaq	V	(no generation)
ornigunne¦q	N	–rup, –rit
orniguppoq	V	(no generation)
ornigussinnaanngilaq	V	(no generation)
ornigussinnaatitaassut	N	–ip, –it
orniguteqqippoq	V	(no generation)
ornigut¦eqqusineq	N	{–eqqusinerup, –seqqusinerup}, {–eqqusinerit, –seqqusinerit}
ornigut¦eqqusissut	N	{–eqqusissutip, –seqqusissutip}, {–eqqusissutit, –seqqusissutit}
orniguteriikatappoq	V	(no generation)
ornigutilussinnarpoq	V	(no generation)
ornigutipallappoq	V	(no generation)
ornigutissaarpoq	V	(no generation)
ornigutissamaarpoq	V	(no generation)
orniguttarne¦q	N	–rup, –rit
ornigutt¦oq	N	–up, –ut
orniguttutuaavoq	V	(no generation)
ornikkumajunnaarsippaa	V	(no generation)
ornikkumanngilaa	V	(no generation)
ornikkuminaakkaluaqaaq	V	(no generation)
ornikkuminaakkaluarpoq	V	(no generation)
ornikkuminaakkunarpoq	V	(no generation)
ornikkuminaappoq	V	(no generation)
ornilisit	N	–ip, –it
orninneqarsinnaas¦oq	N	–up, –ut
orninngikkallassavaa	V	(no generation)
orninngitsoorpaa	V	(no generation)
ornippaa	V	(no generation)
ornissavaa	V	(no generation)
ornita¦q	N	–p, –t
ornitassa¦q	N	–p, –t
ornittaannarpaa	V	(no generation)
ornittaavoq	V	(no generation)
ornitta¦gaq	N	–kkap, –kkat
orpeqannginnersa¦q	N	–p, –t
orpeqanngits¦oq	N	–up, –ut
orpeqarfi¦k	N	–up, –it
orpeqarne¦q	N	–rup, –rit
orpeqart¦oq	N	–up, –ut
orpigaa¦raq	N	–qqap, –qqat
orpigal¦ik	N	{–iup, –lip, –lup}, –lit
orpigangas¦oq	N	–up, –ut
orpi¦gaq	N	–kkap, –kkat
orpigaqarfi¦k	N	–up, –it
orpigaqarpoq	V	(no generation)
orpiia¦gaq	N	–kkap, –kkat
orpi¦k	N	{–up, –ngup}, {–it, –ngit}
orpiliaa¦raq	N	–qqap, –qqat
orpilianngu¦aq	N	–up, –it
orpilia¦q	N	–p, –t
orpili¦aq	N	–ssap, –ssat
orpiliaqataavoq	V	(no generation)
orpiliarne¦q	N	–rup, –rit
orpiliarpoq	V	(no generation)
orpiliarsu¦aq	N	–up, –it
orpiliassa¦q	N	–p, –t
orpiliassia¦q	N	–p, –t
orpimmiutaania¦q	N	–p, –t
orpimmiut¦aq	N	{–ap, –tap}, {–at, –tat}
orpimmiutarsu¦aq	N	–up, –it
orpinngu¦aq	N	–up, –it
orpinnguarpaa	V	(no generation)
orpinnguarti¦ppoq	V	–nngilaq
orpippaa	V	(no generation)
orpippal¦ik	N	{–iup, –lip, –lup}, –lit
orpippassualerine¦q	N	–rup, –rit
orpippassualiarpoq	V	(no generation)
orpippassual¦ik	N	{–iup, –lip, –lup}, –lit
orpippassuaqangaart¦oq	N	–up, –ut
orpippassuaqanngits¦oq	N	–up, –ut
orpippassuaqarfi¦k	N	–up, –it
orpippassuaqart¦oq	N	–up, –ut
orpippassuit	N, pl.	-
orpissu¦aq	N	–up, –it
orpivi¦k	N	–up, –it
orraalaarpoq	V	(no generation)
orraane¦q	N	–rup, –rit
orraasaannarpoq	V	(no generation)
orraasorsuuvoq	V	(no generation)
orraavallaarpoq	V	(no generation)
orraavoq	V	(no generation)
orrajaappoq	V	(no generation)
orrajaats¦oq	N	–up, –ut
orrajaavippoq	V	(no generation)
orrajagaa	V	(no generation)
orrajajuarpoq	V	(no generation)
orrajaqaaq	V	(no generation)
orrajas¦oq	N	–up, –ut
orrajavoq	V	(no generation)
orrajoqisaarpoq	V	(no generation)
orrajoqisaartippaa	V	(no generation)
orrallappoq	V	(no generation)
orrallatsippaa	V	(no generation)
orrallattoorpoq	V	(no generation)
orrarippallaaqaaq	V	(no generation)
orrarippoq	V	(no generation)
orrarissivoq	V	(no generation)
orrarluppoq	V	(no generation)
orrarluttunngorpoq	V	(no generation)
orroriuppoq	V	(no generation)
orruppaa	V	(no generation)
orrutigaa	V	(no generation)
orsaallappoq	V	(no generation)
orse¦q	N	–rup, –rit
orserfi¦k	N	–up, –it
orserisuuvoq	V	(no generation)
orserivoq	V	(no generation)
orserpaa	V	(no generation)
orserpoq	V	(no generation)
orsersaarpoq	V	(no generation)
orsersorfi¦k	N	–up, –it
orsersorpaa	V	(no generation)
orsersorpoq	V	(no generation)
orsersortarfi¦k	N	–up, –it
orsersuut	N	–ip, –it
orser¦suut	N	{–suutip, –tuutip}, {–suutit, –tuutit}
orsiaat	N	–ip, –it
orsiarpoq	V	(no generation)
orsiartaat	N	–ip, –it
orsiine¦q	N	–rup, –rit
orsiivoq	V	(no generation)
orsilerpaa	V	(no generation)
orsil¦ik	N	{–iup, –lip, –lup}, –lit
orsilluarpoq	V	(no generation)
orsinngujuippoq	V	(no generation)
orsinnguvoq	V	(no generation)
orsiorpoq	V	(no generation)
orsiukkumanngilaa	V	(no generation)
orsiuppaa	V	(no generation)
orsiut	N	–ip, –it
orsivaarpoq	V	(no generation)
orsivi¦k	N	–up, –it
orsivissu¦aq	N	–up, –it
orsivoq	V	(no generation)
ors¦oq	N	–up, –ut
orsoqarluart¦oq	N	–up, –ut
orsoqart¦oq	N	–up, –ut
orsorasappoq	V	(no generation)
orsorasattuinnaavoq	V	(no generation)
orsorsivoq	V	(no generation)
orsortaajaane¦q	N	–rup, –rit
orsortaajarpaa	V	(no generation)
orsorta¦q	N	–p, –t
Orsort¦ooq	N	–uup, –uut
Orsort¦ooq	Prop	–uup
orsoruppoq	V	(no generation)
orsoruttaqaaq	V	(no generation)
orsuaasanippoq	V	(no generation)
orsuaasa¦q	N	–p, –t
orsuaasart¦ooq	N	–uup, –uut
orsualikaa¦q	N	–p, –t
orsualikaarsu¦aq	N	–up, –it
orsualika¦k	N	–ap, –at
orsualikannerit	N, pl.	-
orsualikappoq	V	(no generation)
orsualikarpoq	V	(no generation)
orsualikattuinnaavoq	V	(no generation)
orsualikkerpoq	V	(no generation)
orsualikkersorpoq	V	(no generation)
orsuannisaa¦q	N	–p, –t
orsuannisaarpoq	V	(no generation)
orsuarleqivoq	V	(no generation)
orsuarlequt	N	–ip, –it
orsuarlequtissa¦q	N	–p, –t
orsuarlerpaa	V	(no generation)
orsuarnippoq	V	(no generation)
orsuerluarpoq	V	(no generation)
orsuerluerpoq	V	(no generation)
orsuerne¦q	N	–rup, –rit
orsuernia¦q	N	–p, –t
orsuerniarpoq	V	(no generation)
orsuerniart¦oq	N	–up, –ut
orsuerpoq	V	(no generation)
orsuerulluinnarpoq	V	(no generation)
orsueruppoq	V	(no generation)
orsugasaarpoq	V	(no generation)
orsugiaajaaffi¦k	N	–up, –it
orsugi¦ak	N	{–aap, –ssap}, {–aat, –ssat}
orsugial¦ik	N	{–iup, –lip, –lup}, –lit
orsugiassiorfi¦k	N	–up, –it
orsugiass¦iorfik	N	{–iorfiup, –aliorfiup}, {–iorfiit, –aliorfiit}
orsugiass¦iorneq	N	{–iornerup, –aliornerup}, {–iornerit, –aliornerit}
orsugisserpoq	V	(no generation)
orsuiaane¦q	N	–rup, –rit
orsu¦iaaneq	N	{–ajaanerup, –iaanerup}, {–ajaanerit, –iaanerit}
orsuia¦k	N	–ap, –at
orsuial¦ik	N	{–iup, –lip, –lup}, –lit
orsuiarpaa	V	(no generation)
orsui¦k	N	–up, –it
orsuine¦q	N	–rup, –rit
orsuinnaavoq	V	(no generation)
orsuinnanngorpoq	V	(no generation)
orsuisorpoq	V	(no generation)
orsuisuut	N	–ip, –it
orsuivoq	V	(no generation)
orsukits¦oq	N	–up, –ut
orsulersorpaa	V	(no generation)
orsuler¦suut	N	{–suutip, –tuutip}, {–suutit, –tuutit}
orsul¦ik	N	{–iup, –lip, –lup}, –lit
orsulissuuvoq	V	(no generation)
orsuminaatsi¦aq	N	–up, –it
orsum¦ineq	N	–ernup, –ernit
orsungas¦oq	N	–up, –ut
orsuninne¦q	N	–rup, –rit
orsunnappoq	V	(no generation)
orsunnattaa¦q	N	–p, –t
orsunngerpoq	V	(no generation)
orsunnguvoq	V	(no generation)
orsupalinnarpoq	V	(no generation)
orsupalippoq	V	(no generation)
orsupalitserpaa	V	(no generation)
orsupalitt¦oq	N	–up, –ut
orsupali¦ttoq	N	{–ssup, –ttup}, {–ssut, –ttut}
orsupalittuinnaavoq	V	(no generation)
orsussaarniarfi¦k	N	–up, –it
orsussaasivi¦k	N	–up, –it
orsussa¦q	N	–p, –t
orsuuserpaa	V	(no generation)
orsuusivi¦k	N	–up, –it
orsuut	N	–ip, –it
orsuutaaruppoq	V	(no generation)
orsuutissa¦q	N	–p, –t
orsuutiterpaa	V	(no generation)
orsuutiterutit	N	–ip, –it
orsuuvoq	V	(no generation)
orulluffigaa	V	(no generation)
orullugaa	V	(no generation)
orulluigaa	V	(no generation)
orulluppoq	V	(no generation)
orullussimaarpoq	V	(no generation)
orullut	N	–ip, –it
orulluteqarfissa¦q	N	–p, –t
orulluteqarsinnaatitaane¦q	N	–rup, –rit
orulluteqartarfi¦k	N	–up, –it
orullutigaa	V	(no generation)
orullutiginninne¦q	N	–rup, –rit
orullutiginnippoq	V	(no generation)
oruluffigaa	V	(no generation)
orulugaa	V	(no generation)
orulugajutt¦oq	N	–up, –ut
orulune¦q	N	–rup, –rit
orulusarfi¦k	N	–up, –it
orulusarpaa	V	(no generation)
orulussut	N	–ip, –it
orulussut	N, pl.	-
orulutippaa	V	(no generation)
orulut¦ooq	N	–uup, –uut
oruluut	N	–ip, –it
oruluutaavoq	V	(no generation)
oruluutigaa	V	(no generation)
oruluvoq	V	(no generation)
oruneerpaa	V	(no generation)
orunersorpoq	V	(no generation)
orunit	N	–ip, –it
orunitorpoq	V	(no generation)
oruuppaa	V	(no generation)
oruussivoq	V	(no generation)
