Lexeme	WC	Flexion
Paa	N	–p, –t
paagu¦aq	N	–ssap, –ssat
paagu¦ppaa	V	–tinngilaa
paagu¦seq	N	–tsip, –tsit
paagu¦sersorpaa	V	{–sersunngilaa, –tilersunngilaa}
paagut	N	–ip, –it
paagut	N, pl.	-
paajaqisorujussu¦uvoq	V	{–aanngilaq, –unngilaq}
paajaqi¦voq	V	–nngilaq
paaki¦ppoq	V	–nngilaq
paakkarummii¦ppoq	V	–nngilaq
paakkaru¦serpaa	V	{–sinngilaa, –tilinngilaa}
paakkaru¦sersorpaa	V	{–sersunngilaa, –tilersunngilaa}
paakkarussu¦aq	N	–up, –it
paakkarut	N	–ip, –it
paakkarutissa¦q	N	–p, –t
paakuju¦ppoq	V	–nngilaq
paakujutsi¦ppoq	V	–nngilaq
paakujuttuinnaa¦voq	V	–nngilaq
paalang¦erpaa	V	–inngilaa
paaleri¦voq	V	–nngilaq
paal¦erpaa	V	–inngilaa
paalersaas¦erpoq	V	–inngilaq
paalersaa¦serpoq	V	{–sinngilaq, –tilinngilaq}
paaler¦saaserpoq	V	{–saasinngilaq, –saatilinngilaq, –taasinngilaq, –taatilinngilaq}
paalersaasi¦orpoq	V	–unngilaq
paalersaa¦siorpoq	V	{–siunngilaq, –tiliunngilaq}
paaler¦saasiorpoq	V	{–saasiunngilaq, –saatiliunngilaq, –taasiunngilaq, –taatiliunngilaq}
paalersaat	N	–ip, –it
paaler¦saat	N	{–saatip, –taatip}, {–saatit, –taatit}
paaliaa¦rpoq	V	–nngilaq
paaliorti	N	–p, –t
paalla¦ppoq	V	–nngilaq
paallats¦erpoq	V	–inngilaq
paallatsi¦ppaa	V	–nngilaa
paallatt¦oorpoq	V	–uunngilaq
paamaarna¦rpoq	V	–nngilaq
paamaa¦rpoq	V	–nngilaq
paamaarti¦ppaa	V	–nngilaa
paamaart¦oq	N	–up, –ut
paamaaru¦ppaa	V	–tinngilaa
paamaarussaas¦oq	N	–up, –ut
paamaarussine¦q	N	–rup, –rit
paamaarussi¦voq	V	–nngilaq
paamaarutaa¦voq	V	–nngilaq
paamaarutig¦aa	V	–inngilaa
paamaassu¦seq	N	–tsip, –tsit
paamig¦aa	V	–inngilaa
paamii¦ppoq	V	–nngilaq
paaminna¦rpoq	V	–nngilaq
paaminnart¦oq	N	–up, –ut
paami¦oq	N	–up, –ut
paami¦ppoq	V	–nngilaq
paamisaa¦rpaa	V	–nngilaa
paamisaarti¦ppoq	V	–nngilaq
paamisaartuarpaa	V	(no generation)
paamititsinaqaaq	V	(no generation)
paamititsi¦voq	V	–nngilaq
paamitsaa¦ppaa	V	–tinngilaa
paamitsaatig¦aa	V	–inngilaa
paamitsajui¦ppoq	V	–nngilaq
paamitsa¦ppoq	V	–nngilaq
paamiunii¦ppoq	V	–nngilaq, –nngilaq
Paamiut	N, pl.	-
Paamiut	Prop, pl.	-
paammeri¦voq	V	–nngilaq
paamm¦erpoq	V	–inngilaq
paammersi¦ppaa	V	–nngilaa
paammers¦oorpoq	V	–uunngilaq
paammii¦vaa	V	–nngilaa
paammiivi¦ppaa	V	–nngilaa
paane¦q	N	–rup, –rit
paang¦erpaa	V	–inngilaa
paangersima¦vaa	V	–nngilaa
paangersi¦ppoq	V	–nngilaq
paangiu¦ppaa	V	–tinngilaa
paangiu¦ppoq	V	–tinngilaq
paangiusimaannarpoq	V	(no generation)
paania¦rpaa	V	–nngilaa
paanippallaaqaaq	V	(no generation)
paani¦ppoq	V	–nngilaq
paannaangasunngu¦aq	N	–up, –it
paannaa¦q	N	–p, –t
paannaa¦q	N	–rup, –rit
paannaat	N, pl.	-
paannga¦rpoq	V	–nngilaq
paannikkajuppoq	V	(no generation)
paanni¦ppoq	V	–nngilaq
paapaa¦q	N	–p, –t
paa¦q	N	–p, –t
paaqa¦rpoq	V	–nngilaq
paaqartinngilaa	V	(no generation)
paaqarti¦ppaa	V	–nngilaa
paaqqangas¦oorpoq	V	–uunngilaq
paaqqangati¦ppaa	V	–nngilaa
paaqqanga¦voq	V	–nngilaq
paaqqeqqissaa¦rpaa	V	–nngilaa
paaqqinniffi¦k	N	–up, –it
paaqqinninne¦q	N	–rup, –rit
paaqqinninnersiutit	N, pl.	-
paaqqinni¦ppoq	V	–nngilaq
paaqqinnitsig¦aa	V	–inngilaa
paaqqinnittarfiit	N, pl.	-
paaqqinnittarfi¦k	N	–up, –it
paaqqisa¦rpaa	V	–nngilaa
paaqqisig¦aa	V	–inngilaa
paaqqi¦vaa	V	–nngilaa
paaqqukkiart¦orpaa	V	–unngilaa
paaqqu¦ppaa	V	–tinngilaa
paaqqu¦ppoq	V	–tinngilaq
paaqqutar¦aa	V	–inngilaa
paaqqutarinninne¦q	N	–rup, –rit
paaqqutarisarial¦ik	N	{–iup, –lip, –lup}, –lit
paaqqutariuarpaa	V	(no generation)
paaqqutig¦aa	V	–inngilaa
paaqqutiinna¦rpaa	V	–nngilaa
paaqqutilliigaju¦ppoq	V	–nngilaq
paaqqutilliisa¦rpoq	V	–nngilaq
paaqqutillii¦voq	V	–nngilaq
paar¦aa	V	–inngilaa
paaraarsu¦k	N	–up, –it
paa¦raq	N	–qqap, –qqat
paarasua¦rpaa	V	–nngilaa
paarasua¦rpoq	V	–nngilaq
paarataa¦rpoq	V	–nngilaq
paaratiisi	N	–p, –t
paareqqu¦aa	V	–nngilaa
paarfi¦k	N	–up, –it
paaria¦rpaa	V	–nngilaa
paaria¦rpoq	V	–nngilaq
paariart¦orpaa	V	–unngilaa
paarillua¦gaq	N	–kkap, –kkat
paarillua¦rpaa	V	–nngilaa
paarineqarne¦q	N	–rup, –rit
paarinerlugaane¦q	N	–rup, –rit
paarinerluine¦q	N	–rup, –rit
paarinerlu¦ppaa	V	–nngilaa
paarinnilluannginne¦q	N	–rup, –rit
paarinninne¦q	N	–rup, –rit
paarinnittussaatitaane¦q	N	–rup, –rit
paarisa¦q	N	–p, –t
paarisassa¦q	N	–p, –t
paarititsine¦q	N	–rup, –rit
paarlaaffi¦k	N	–up, –it
paarlaanna¦rpaa	V	–nngilaa
paarlaanne¦q	N	–rup, –rit
paarlaa¦ppaa	V	–tinngilaa
paarlaa¦ppoq	V	–tinngilaq
paarlaassaa¦voq	V	–nngilaq
paarlaasseqatigiinne¦q	N	–rup, –rit
paarlaassine¦q	N	–rup, –rit
paarlaassi¦voq	V	–nngilaq
paarlaassuine¦q	N	–rup, –rit
paarlaassui¦voq	V	–nngilaq
paarlaateqatigiinne¦q	N	–rup, –rit
paarlaa¦teqatigiinneq	N	{–qatigiinnerup, –teqatigiinnerup, –tseqatigiinnerup, –titeqatigiinnerup}, {–qatigiinnerit, –teqatigiinnerit, –tseqatigiinnerit, –titeqatigiinnerit}
paarlaateqatigii¦ttarneq	N	{–ssarnerup, –ttarnerup}, {–ssarnerit, –ttarnerit}
paarlaat¦eqatigiittarneq	N	{–eqatigiissarnerup, –eqatigiittarnerup, –seqatigiissarnerup, –seqatigiittarnerup, –iteqatigiissarnerup, –iteqatigiittarnerup}, {–eqatigiissarnerit, –eqatigiittarnerit, –seqatigiissarnerit, –seqatigiittarnerit, –iteqatigiissarnerit, –iteqatigiittarnerit}
paarlaatitsine¦q	N	–rup, –rit
paarlaat¦itsineq	N	{–itsinerup, –sitsinerup}, {–itsinerit, –sitsinerit}
paarlaa¦vaa	V	–nngilaa
paarlaga¦rpaa	V	–nngilaa
paarlaga¦rpoq	V	–nngilaq
paarlagartua¦rpoq	V	–nngilaq
paarlagarunnaa¦rpoq	V	–nngilaq
paarlagiaa¦voq	V	–nngilaq
paarlagia¦rpaa	V	–nngilaa
paarlagia¦rpoq	V	–nngilaq
paarlanga¦voq	V	–nngilaq
paarla¦ppaa	V	–nngilaa
paarlatsi	N	–p, –t
paarlatsine¦q	N	–rup, –rit
paarlatsi¦ppaa	V	–nngilaa
paarlat¦taagallartoq	N	{–saagallartup, –taagallartup}, {–saagallartut, –taagallartut}
paarlat¦taasartussarsiuussisarfik	N	{–saasartussarsiuussisarfiup, –taasartussarsiuussisarfiup}, {–saasartussarsiuussisarfiit, –taasartussarsiuussisarfiit}
paarlat¦taasoq	N	{–saasup, –taasup}, {–saasut, –taasut}
paarlattarfi¦k	N	–up, –it
paarlatt¦oq	N	–up, –ut
paarl¦eq	N	–iup, –iit
paarlermii¦ppoq	V	–nngilaq
paarlerpaa¦q	N	–p, –t
paarlersaat	N	–ip, –it
paarlersaa¦voq	V	–nngilaq
paarliu¦voq	V	–nngilaq
paarmaasa¦q	N	–p, –t
paarmaasat	N, pl.	-
paarmalia¦rpoq	V	–nngilaq
paarma¦q	N	–p, –t
paarmaqullueru¦ppoq	V	–tinngilaq
paarmaqullu¦k	N	–up, –it
paarmaqutigi¦ppoq	V	–nngilaq
paarmaqutit	N, pl.	-
paarmaqutita¦rpoq	V	–nngilaq
paarmarlu¦k	N	–up, –it
paarmarsu¦aq	N	–up, –it
paarmorfig¦aa	V	–inngilaa
paarm¦orpoq	V	–unngilaq
paarmorsinnaanngilaq	V	(no generation)
paarmort¦oq	N	–up, –ut
paarmortua¦rpoq	V	–nngilaq
paarmualaa¦rpoq	V	–nngilaq
paarmuli¦aq	N	–ssap, –ssat
paarnaaral¦ik	N	{–iup, –lip, –lup}, –lit
paarnaarunneqarne¦q	N	–rup, –rit
paarnaaru¦ppaa	V	–tinngilaa
paarnaarussaane¦q	N	–rup, –rit
paarnaarussa¦q	N	–p, –t
paarnaarussine¦q	N	–rup, –rit
paarnaarussiveqarne¦q	N	–rup, –rit
paarnaarussi¦veqarneq	N	{–ffeqarnerup, –veqarnerup}, {–ffeqarnerit, –veqarnerit}
paarnaarussivi¦k	N	–up, –it
paarnaarussi¦vik	N	{–ffiup, –viup}, {–ffiit, –viit}
paarnaasa¦q	N	–p, –t
paarnalia¦rpoq	V	–nngilaq
paarna¦q	N	–p, –t
paarnaqullu¦k	N	–up, –it
paarnaqutit	N, pl.	-
paarnarlu¦k	N	–up, –it
paarnarsu¦aq	N	–up, –it
paarnart¦orpoq	V	–unngilaq
paarnar¦torpoq	V	{–sunngilaq, –tunngilaq}
paarnat	N, pl.	-
paarnga¦q	N	–p, –t
paarngaqutit	N, pl.	-
paarngarsua¦q	N	–rup, –rit
paarngarsu¦aq	N	–up, –it
paarngia¦q	N	–p, –t
paarngiarfi¦k	N	–up, –it
paarngia¦rpoq	V	–nngilaq
paarngiartaanna¦rpoq	V	–nngilaq
paarngorfig¦aa	V	–inngilaa
paarng¦orpoq	V	–unngilaq
paarngort¦oq	N	–up, –ut
paarngualaa¦rpoq	V	–nngilaq
paarnguli¦aq	N	–ssap, –ssat
paarnia¦q	N	–p, –t
paarniarfi¦k	N	–up, –it
paarnia¦rpoq	V	–nngilaq
paarniartaanna¦rpoq	V	–nngilaq
paarni¦ppoq	V	–nngilaq
paarnorfig¦aa	V	–inngilaa
paarn¦orpoq	V	–unngilaq
paarnualaa¦rpoq	V	–nngilaq
paarnuli¦aq	N	–ssap, –ssat
paa¦rpoq	V	–nngilaq
paarsaa¦voq	V	–nngilaq
paarsa¦q	N	–p, –t
paarsar¦aa	V	–inngilaa
paarsillua¦rpoq	V	–nngilaq
paarsine¦q	N	–rup, –rit
paarsinerlunne¦q	N	–rup, –rit
paarsinerlu¦ppoq	V	–nngilaq
paarsinikuu¦voq	V	–nngilaq
paarsisart¦oq	N	–up, –ut
paarsisig¦aa	V	–inngilaa
paarsi¦sigaa	V	–tiginngilaa
paarsis¦oq	N	–up, –ut
paarsisut	N, pl.	-
paarsisuus¦oq	N	–up, –ut
paarsiui¦ppoq	V	–nngilaq
paarsi¦voq	V	–nngilaq
paarsuaasa¦q	N	–p, –t
paarsua¦q	N	–p, –t
paarsu¦aq	N	–up, –it
paarti¦ppaa	V	–nngilaa
paartitsi¦voq	V	–nngilaq
paart¦oq	N	–up, –ut
paartoqa¦rpoq	V	–nngilaq
paart¦orpoq	V	–unngilaq
paar¦torpoq	V	{–sunngilaq, –tunngilaq}
paartuu¦voq	V	–nngilaq
paarussa¦rpoq	V	–nngilaq
paarussartuinnaa¦voq	V	–nngilaq
paarut	N	–ip, –it
paarutaa¦voq	V	–nngilaq
paarutig¦aa	V	–inngilaa
paaseqatigiinne¦q	N	–rup, –rit
paa¦seqatigiinneq	N	{–seqatigiinnerup, –tileqatigiinnerup}, {–seqatigiinnerit, –tileqatigiinnerit}
paaseqqi¦ppaa	V	–nngilaa
paa¦seqqippaa	V	{–seqqinngilaa, –tileqqinngilaa}
paaseqqi¦taq	N	{–sap, –tap}, {–sat, –tat}
paa¦seqqitaq	N	{–seqqisap, –seqqitap, –tileqqisap, –tileqqitap}, {–seqqisat, –seqqitat, –tileqqisat, –tileqqitat}
paa¦serpaa	V	{–sinngilaa, –tilinngilaa}
paas¦erpoq	V	–inngilaq
paa¦serpoq	V	{–sinngilaq, –tilinngilaq}
paasers¦orpoq	V	–unngilaq
paa¦sersorpoq	V	{–sersunngilaq, –tilersunngilaq}
paaserusu¦ppaa	V	–nngilaa
paa¦serusuppaa	V	{–serusunngilaa, –tilerusunngilaa}
paasileratalla¦rpaa	V	–nngilaa
paasil¦erpaa	V	–inngilaa
paa¦silerpaa	V	{–silinngilaa, –tililinngilaa}
paasillua¦rpaa	V	–nngilaa
paasillu¦innarpaa	V	{–aannanngilaa, –innanngilaa}
paasiluus¦erpaa	V	–inngilaa
paasimaqaaq	V	(no generation)
paasinaa¦ppoq	V	–nngilaq
paasinarluart¦oq	N	–up, –ut
paasina¦rpoq	V	–nngilaq
paasinarsaane¦q	N	–rup, –rit
paasinarsisi¦ppaa	V	–nngilaa
paasinarsi¦sippaa	V	{–sinngilaa, –tinngilaa}
paasinart¦oq	N	–up, –ut
paasineqarne¦q	N	–rup, –rit
paasineqatsaalivaa	V	(no generation)
paasinerluine¦q	N	–rup, –rit
paasinerlu¦ppaa	V	–nngilaa
paasiniaaffi¦k	N	–up, –it
paasiniaajumane¦q	N	–rup, –rit
paasiniaane¦q	N	–rup, –rit
paasiniaaqqissaarne¦q	N	–rup, –rit
paasiniaasar¦toqatigiit	N, pl.	{–toqatigiit, –soqatigiit}
paasiniaassut	N	–ip, –it
paasiniaa¦voq	V	–nngilaq
paasiniaqqissaa¦rpaa	V	–nngilaa
paasinia¦rpaa	V	–nngilaa
paasinneria¦saarneq	N	{–saarnerup, –taarnerup}, {–saarnerit, –taarnerit}
paasinneria¦taarneq	N	{–saarnerup, –taarnerup}, {–saarnerit, –taarnerit}
paasinngitsoorpaa	V	(no generation)
paasinnikkiartuaarpoq	V	(no generation)
paasinnilluarne¦q	N	–rup, –rit
paasinninne¦q	N	–rup, –rit
paasinni¦ppoq	V	–nngilaq
paasinnissinnaassu¦seq	N	–tsip, –tsit
paasinnitt¦oq	N	–up, –ut
paasisa¦q	N	–p, –t
paasisaqarfigilaa¦gaq	N	–kkap, –kkat
paasisaqarfi¦k	N	–up, –it
paasisaqa¦rpoq	V	–nngilaq
paasisaqarusussu¦seq	N	–tsip, –tsit
paasisariaqanngilaq	V	(no generation)
paasisassaalluanngits¦oq	N	–up, –ut
paasisassaanngilaq	V	(no generation)
paasisassarsioqqusine¦q	N	–rup, –rit
paasisassarsiorne¦q	N	–rup, –rit
paasisimanninne¦q	N	–rup, –rit
paasisimasaaru¦ppoq	V	–tinngilaq
paasisimasaarut¦itippaa	V	{–itsinngilaa, –sitsinngilaa, –itinngilaa, –sinngilaa}
paasisimasaarut¦ititsineq	N	{–ititsinerup, –itsitsinerup, –sititsinerup, –sitsitsinerup}, {–ititsinerit, –itsitsinerit, –sititsinerit, –sitsitsinerit}
paasisimasal¦ik	N	{–iup, –lip, –lup}, –lit
paasisimasaqal¦erpoq	V	–inngilaq
paasisimasaqanngits¦oq	N	–up, –ut
paasisimasaqarfi¦k	N	–up, –it
paasisimasaqarlua¦rpoq	V	–nngilaq
paasisimasaqarluart¦oq	N	–up, –ut
paasisimasaqa¦rpoq	V	–nngilaq
paasisimasaqart¦oq	N	–up, –ut
paasisimasaqassu¦seq	N	–tsip, –tsit
paasisimasat	N, pl.	-
paasisi¦ppaa	V	–nngilaa
paasi¦sippaa	V	{–sinngilaa, –tinngilaa}
paasisitsiniaane¦q	N	–rup, –rit
paasi¦sitsiniaaneq	N	{–sitsiniaanerup, –titsiniaanerup}, {–sitsiniaanerit, –titsiniaanerit}
paasisitsisarfi¦k	N	–up, –it
paasi¦sitsisarfik	N	{–sitsisarfiup, –titsisarfiup}, {–sitsisarfiit, –titsisarfiit}
paasis¦oorpaa	V	–uunngilaa
paasissaalluanngilaq	V	(no generation)
paasissaanngilaq	V	(no generation)
paasissaanngits¦oq	N	–up, –ut
paa¦sissaanngitsoq	N	{–sissaanngitsup, –tilissaanngitsup}, {–sissaanngitsut, –tilissaanngitsut}
paasissaas¦oq	N	–up, –ut
paasissaa¦voq	V	–nngilaq
paasissutaalluart¦oq	N	–up, –ut
paasissutaas¦oq	N	–up, –ut
paasissutissaateqarfi¦k	N	–up, –it
paasissutissa¦q	N	–p, –t
paasissutissarsiffi¦k	N	–up, –it
paasissutissarsi¦orpoq	V	–unngilaq
paasissutissat	N, pl.	-
paasissutissiar¦aa	V	–inngilaa
paasissutissiareqqi¦ppaa	V	–nngilaa
paasissutiss¦iineq	N	{–aliinerup, –iinerup}, {–aliinerit, –iinerit}
paasissutiss¦iisarfik	N	{–aliisarfiup, –iisarfiup}, {–aliisarfiit, –iisarfiit}
paasissutiss¦iisartoq	N	{–aliisartup, –iisartup}, {–aliisartut, –iisartut}
paasissutiss¦iisinnaaneq	N	{–aliisinnaanerup, –iisinnaanerup}, {–aliisinnaanerit, –iisinnaanerit}
paasissutiss¦iisoq	N	{–aliisup, –iisup}, {–aliisut, –iisut}
paasissutiss¦iissusiaq	N	{–aliissusiap, –aliissutiliap, –iissusiap, –iissutiliap}, {–aliissusiat, –aliissutiliat, –iissusiat, –iissutiliat}
paasissutiss¦iissut	N	{–aliissutip, –iissutip}, {–aliissutit, –iissutit}
paasissutiss¦iisussaatitaaneq	N	{–aliisussaatitaanerup, –iisussaatitaanerup}, {–aliisussaatitaanerit, –iisussaatitaanerit}
paasissutissi¦ppaa	V	–nngilaa
paasiti¦ppaa	V	–nngilaa
paasi¦tippaa	V	{–tinngilaa, –sinngilaa}
paasiumasa¦rpaa	V	–nngilaa
paasiuminaallisaat	N	–ip, –it
paasiuminaatsittorujussuu¦aa	V	–nngilaa
paasiuminaats¦oq	N	–up, –ut
paasiuminaatsoqanngits¦oq	N	–up, –ut
paasiuminarluart¦oq	N	–up, –ut
paasiuminart¦oq	N	–up, –ut
paasiuminassu¦seq	N	–tsip, –tsit
paasi¦vaa	V	–nngilaa
paassaanna¦rpoq	V	–nngilaq
paassaasa¦q	N	–p, –t
paassaasivi¦k	N	–up, –it
paassaasivimmii¦ppoq	V	–nngilaq
paassalivi¦k	N	–up, –it
paassa¦q	N	–p, –t
paassat	N, pl.	-
paassivi¦k	N	–up, –it
paassuarpalu¦ppoq	V	–nngilaq
paassua¦rpoq	V	–nngilaq
paasunneqaaq	V	(no generation)
paasunni¦ppoq	V	–nngilaq
paataaja¦rpaa	V	–nngilaa
paataaja¦rpoq	V	–nngilaq
paataajarti¦ppaa	V	–nngilaa
paataars¦erpoq	V	–inngilaq
paataarsersima¦voq	V	–nngilaq
paat¦erpaa	V	–inngilaa
paat¦erpoq	V	–inngilaq
paaters¦orpoq	V	–unngilaq
paatersullaqqi¦ppoq	V	–nngilaq
paaterunne¦q	N	–rup, –rit
paati¦ppoq	V	–nngilaq
paatissia¦q	N	–p, –t
paatit	N, pl.	-
paatitaa¦rpoq	V	–nngilaq
paat¦ooq	N	–uup, –uut
paatoorsu¦aq	N	–up, –it
paatsiveerunne¦q	N	–rup, –rit
paatsiveeru¦ppaa	V	–tinngilaa
paatsiveeru¦ppoq	V	–tinngilaq
paatsiveerus¦imaartoq	N	{–imaartup, –simaartup}, {–imaartut, –simaartut}
paatsiveerussaataas¦oq	N	–up, –ut
paatsiveerussutig¦aa	V	–inngilaa
paatsiveerut¦sippaa	V	{–inngilaa, –sinngilaa, –itinngilaa}
paatsivi¦k	N	–up, –it
paatsivissaaru¦ppoq	V	–tinngilaq
paatsivitanngueru¦ppoq	V	–tinngilaq
paatsoorne¦q	N	–rup, –rit
paatsoorneqarsinnaanngits¦oq	N	–up, –ut
paats¦oorpaa	V	–uunngilaa
paats¦oorpoq	V	–uunngilaq
paatsuu¦gaq	N	–kkap, –kkat
paatsuugassaanngits¦oq	N	–up, –ut
paatsuui¦voq	V	–nngilaq
paatsuunganarpoq	V	(no generation)
paatsuunganart¦oq	N	–up, –ut
paatt¦orpaa	V	–unngilaa
paattuut	N	–ip, –it
paattuutita¦rpoq	V	–nngilaq
paa¦vaa	V	–nngilaa
paavatig¦ooq	N	–uup, –uut
paaverlu¦erpaa	V	–inngilaa
paaverlu¦erpoq	V	–inngilaq
paaverluersima¦voq	V	–nngilaq
paaviaane¦q	N	–rup, –rit
paav¦iaaneq	N	{–ajaanerup, –iaanerup}, {–ajaanerit, –iaanerit}
paaviaas¦oq	N	–up, –ut
paav¦iaasoq	N	{–ajaasup, –iaasup}, {–ajaasut, –iaasut}
paaviaat	N	–ip, –it
paaviaataars¦erpoq	V	–inngilaq
paaviaataaru¦ppoq	V	–tinngilaq
paaviaatisi¦voq	V	–nngilaq
paaviaa¦voq	V	–nngilaq
paav¦iaavoq	V	{–ajaanngilaq, –iaanngilaq}
paaviagaa¦voq	V	–nngilaq
paav¦iagaavoq	V	{–ajagaanngilaq, –iagaanngilaq}
paavia¦rpaa	V	–nngilaa
paav¦iarpaa	V	{–ajanngilaa, –ianngilaa}
paavinnaa¦voq	V	–nngilaq
paavinna¦q	N	–rup, –rit
paavinnarsu¦aq	N	–up, –it
paaviussu¦seq	N	–tsip, –tsit
paaviu¦voq	V	–nngilaq
paav¦ooq	N	–uup, –uut
paavoq	V	(no generation)
paffa	Interj	(no generation)
paffarujussu¦aq	N	–up, –it
paffequtit	N	–ip, –it
paffi¦k	N	–up, –it
paffillu¦ppoq	V	–nngilaq
paffimmiu	N	–p, –t
paggatig¦aa	V	–inngilaa
paggatigisa¦q	N	–p, –t
paggatsitsi¦voq	V	–nngilaq
pagg¦erpoq	V	–inngilaq
pagginne¦q	N	–rup, –rit
paggit	N	–ip, –it
paggivi¦k	N	–up, –it
Paggivitta¦q	N	–p, –t
pajugut	N	–ip, –it
pajugutig¦aa	V	–inngilaa
pajugutisia¦q	N	–p, –t
paju¦ppaa	V	–nngilaa
paju¦ppoq	V	–nngilaq
pajutt¦orpoq	V	–unngilaq
pajuttut	N, pl.	-
pakalaa¦q	N	–p, –t
pakala¦k	N	–ap, –at
pakalatsi¦voq	V	–nngilaq
pakammi¦ppaa	V	–nngilaa
pakani¦ppaa	V	–nngilaa
paka¦ppaa	V	–nngilaa
pakasaa¦rpoq	V	–nngilaq
pakasa¦ppaa	V	–nngilaa
pakasa¦rpaa	V	–nngilaa
pakasarti¦ppoq	V	–nngilaq
pakassi¦ppaa	V	–nngilaa
pakassumminne¦q	N	–rup, –rit
pakassummi¦ppaa	V	–nngilaa
pakatsinart¦oq	N	–up, –ut
pakatsine¦q	N	–rup, –rit
pakatsisa¦rpaa	V	–nngilaa
pakatsisi¦ppaa	V	–nngilaa
pakatsisitaane¦q	N	–rup, –rit
pakatsisitsi¦voq	V	–nngilaq
pakatsis¦oq	N	–up, –ut
pakatsissutig¦aa	V	–inngilaa
pakatsi¦voq	V	–nngilaq
pakini¦ppaa	V	–nngilaa
Pakistanim¦eersoq	N	{–eersup, –eertup, –inngaanneersup, –inngaanneertup}, {–eersut, –eertut, –inngaanneersut, –inngaanneertut}
Pakistanimioq	N	(no generation)
Pakistan¦imiu	N	{–ermiup, –imiup}, {–ermiut, –imiut}
pakkalu¦aq	N	–ssap, –ssat
pakkera¦rpaa	V	–nngilaa
pakk¦erpaa	V	–inngilaa
pakkersimaa¦rpaa	V	–nngilaa
pakkeru¦ppoq	V	–tinngilaq
pakkerussima¦voq	V	–nngilaq
pakkisa¦rpaa	V	–nngilaa
pakku	Pron, pl.	–a
pakku¦a	Pron, pl.	–a
pakku¦ppaa	V	–tinngilaa
pakku¦serpaa	V	{–sinngilaa, –tilinngilaa}
pakku¦serpaa	V	–tilinngilaa
pakkussivi¦k	N	–up, –it
pakkussi¦vik	N	{–ffiup, –viup}, {–ffiit, –viit}
pakkut	N	–ip, –it
pal'a¦k	N	–ap, –at
palaa¦voq	V	–nngilaq
palannga¦rpoq	V	–nngilaq
palaseqarfi¦k	N	–up, –it
palaserpalu¦ppoq	V	–nngilaq
palasi	N	–p, –t
palasig¦aa	V	–inngilaa
palasikkut	N, pl.	-
palasinng¦orpoq	V	–unngilaq
palasinngorti¦ppaa	V	–nngilaa
palasinngortitsine¦q	N	–rup, –rit
palasissaaleqine¦q	N	–rup, –rit
palasissa¦q	N	–p, –t
palasit	N, pl.	-
palasiugalu¦aq	N	{–ap, –up}, –it
palasiugalu¦aq	N	–up, –it
palasiune¦q	N	–rup, –rit
palasiusaa¦rpoq	V	–nngilaq
palasius¦oq	N	–up, –ut
palasiu¦voq	V	–nngilaq
pal¦eq	N	–lip, –lit
pal¦erpaa	V	–inngilaa
pal¦erpoq	V	–inngilaq
palersaat	N	–ip, –it
paler¦saat	N	{–saatip, –taatip}, {–saatit, –taatit}
palersarne¦q	N	–rup, –rit
palersimas¦oq	N	–up, –ut
palersima¦voq	V	–nngilaq
palersine¦q	N	–rup, –rit
palersi¦voq	V	–nngilaq
palersuarpoq	V	(no generation)
palissat	N, pl.	-
pallari¦ppoq	V	–nngilaq
pall¦eq	N	–ip, –it
pall¦erpaa	V	–inngilaa
pallersaat	N	–ip, –it
pallersa¦rpoq	V	–nngilaq
pallers¦orpaa	V	–unngilaa
pallersu¦aq	N	–up, –it
palligassaanngilaq	V	(no generation)
pallig¦oorpaa	V	–uunngilaa
palligukkiart¦orpoq	V	–unngilaq
palligu¦ppaa	V	–tinngilaa
palligu¦ppoq	V	–tinngilaq
pallikkiart¦orpaa	V	–unngilaa
pallil¦erpaa	V	–inngilaa
pallilia¦rpoq	V	–nngilaq
pallimanngivi¦ppaa	V	–nngilaa
pallima¦vaa	V	–nngilaa
pallima¦voq	V	–nngilaq
pallim¦oorpaa	V	–uunngilaa
palli¦ppaa	V	–nngilaa
palli¦ppoq	V	–nngilaq
pallisa¦q	N	–p, –t
pallissimaarpaa	V	(no generation)
pallitsaaliu¦gaq	N	–kkap, –kkat
pallittaalisa¦q	N	–p, –t
pallitt¦orpaa	V	–unngilaa
pallorfig¦aa	V	–inngilaa
pallorfiginninne¦q	N	–rup, –rit
pallorfiginnitt¦oq	N	–up, –ut
pallorfiginni¦ttoq	N	{–ssup, –ttup}, {–ssut, –ttut}
pall¦orpoq	V	–unngilaq
pallorsima¦voq	V	–nngilaq
pallorti¦ppaa	V	–nngilaa
pallungaanna¦rpoq	V	–nngilaq
pallungagaju¦ppoq	V	–nngilaq
pallunga¦voq	V	–nngilaq
pallunngarsorfi¦k	N	–up, –it
pallunngars¦orpoq	V	–unngilaq
pallunngavi¦k	N	–up, –it
pallunngavittaa¦rpoq	V	–nngilaq
paloqqa¦voq	V	–nngilaq
palu¦aq	N	–kkap, –kkat
palu¦gaq	N	–kkap, –kkat
palungataa¦q	N	–p, –t
palunga¦voq	V	–nngilaq
palu¦voq	V	–nngilaq
Palæstinam¦eersoq	N	{–eersup, –eertup, –inngaanneersup, –inngaanneertup, –inngaanninngaanneersup, –inngaanninngaanneertup}, {–eersut, –eertut, –inngaanneersut, –inngaanneertut, –inngaanninngaanneersut, –inngaanninngaanneertut}
Palæstinamioq	N	(no generation)
Palæstina¦miu	N	{–miup, –rmiup}, {–miut, –rmiut}
pam¦eerpaa	V	–iinngilaa
pamersaane¦q	N	–rup, –rit
pamersa¦rpaa	V	–nngilaa
pameru¦ppaa	V	–tinngilaa
pamiaki¦ppoq	V	–nngilaq
pamiallu¦erpaa	V	–inngilaa
pamiallu¦k	N	–up, –it
pamiallutt¦orpoq	V	–unngilaq
pamialluusa¦q	N	–p, –t
pami¦aq	N	–ssap, –ssat
pami¦oq	N	–up, –ut
pamiort¦ooq	N	–uup, –uut
pamiu¦erpaa	V	–inngilaa
pamiuki¦ppoq	V	–nngilaq
pamiul¦ik	N	{–iup, –lip, –lup}, –lit
pana	N	–p, –t
panaanne¦q	N	–rup, –rit
panaa¦ppaa	V	–tinngilaa
panaa¦raq	N	–qqap, –qqat
panaasal¦ik	N	{–iup, –lip, –lup}, –lit
panaasali¦orpoq	V	–unngilaq
panaasa¦q	N	–p, –t
panaassi¦voq	V	–nngilaq
panaa¦voq	V	–nngilaq
panal¦erpoq	V	–inngilaq
panal¦ik	N	{–iup, –lip, –lup}, –lit
pana¦rpaa	V	–nngilaa
panarsu¦aq	N	–up, –it
panerfaa¦voq	V	–nngilaq
panerfa¦k	N	–ap, –at
panerfal¦ik	N	{–iup, –lip, –lup}, –lit
panerfa¦q	N	–rup, –rit
panerfaqarne¦q	N	–rup, –rit
panerfiu¦ppaa	V	–tinngilaa
panerneeru¦ppoq	V	–tinngilaq
panerneqanngits¦oq	N	–up, –ut
panernersu¦aq	N	–up, –it
panerniarfig¦aa	V	–inngilaa
panernikuu¦voq	V	–nngilaq
panernitannguaqanngilaq	V	(no generation)
pan¦erpaa	V	–inngilaa
pan¦erpoq	V	–inngilaq
panersaa¦vik	N	{–ffiup, –viup}, {–ffiit, –viit}
panersa¦rpaa	V	–nngilaa
paners¦erpaa	V	–inngilaa
panersiivi¦k	N	–up, –it
panersii¦vik	N	{–ffiup, –viup}, {–ffiit, –viit}
panersu¦ppoq	V	–nngilaq
panertiinna¦rpaa	V	–nngilaa
panert¦oorpoq	V	–uunngilaq
panert¦oq	N	–up, –ut
panertorsaat	N	–ip, –it
panertort¦orpoq	V	–unngilaq
panertor¦torpoq	V	{–sunngilaq, –tunngilaq}
panertulia¦q	N	–p, –t
panertuli¦voq	V	–nngilaq
pangaligaa¦rpoq	V	–nngilaq
pangaligi¦aq	N	–ssap, –ssat
pangalinnert¦ooq	N	–uup, –uut
pangali¦ppoq	V	–nngilaq
pangalitsi¦ppaa	V	–nngilaa
pangali¦tsippaa	V	{–ssinngilaa, –tsinngilaa}
pangalittuarpoq	V	(no generation)
pangallaa¦ppaa	V	–tinngilaa
pangallaassa¦q	N	–p, –t
pangallakkiart¦orpoq	V	–unngilaq
pangalla¦ppoq	V	–nngilaq
pangallori¦ppoq	V	–nngilaq
pangallus¦erpoq	V	–inngilaq
pangallussi¦voq	V	–nngilaq
paniasaat	N	–ip, –it
panig¦aa	V	–inngilaa
panigiit	N, pl.	-
paniinna¦q	N	–ap, –at
pani¦k	N	–up, –it
panikaa¦q	N	–p, –t
panikaassiassat	N, pl.	-
panikaassiat	N, pl.	-
panik¦oq	N	–up, –ut
panilisa¦rpoq	V	–nngilaq
paningaja¦ppoq	V	–nngilaq
panissaa¦rpoq	V	–nngilaq
panissa¦q	N	–p, –t
panissia¦q	N	–p, –t
panisua¦q	N	–p, –t
panitua¦q	N	–p, –t
pa¦nna	Pron	–ssuma, {–kku, –kkua}
pannaats¦oq	N	–up, –ut
pannakaali¦orpoq	V	–unngilaq
pannakaa¦q	N	–p, –t
pannakaat¦orpoq	V	–unngilaq
pannaku	N	–p, –t
pannakui¦k	N	–up, –it
pannakuu¦voq	V	–nngilaq
pannari¦k	N	–up, –it
pannari¦ppoq	V	–nngilaq
pannarissits¦erpaa	V	–inngilaa
pannarissi¦voq	V	–nngilaq
pannarivi¦ppoq	V	–nngilaq
pannarni¦ppoq	V	–nngilaq
pannarpalla¦ppoq	V	–nngilaq
pannarpalu¦ppoq	V	–nngilaq
pannarpaluttuinnaa¦voq	V	–nngilaq
panne¦q	N	–rup, –rit
pann¦erpoq	V	–inngilaq
Pannert¦ooq	N	–uup, –uut
pannili¦gaq	N	–kkap, –kkat
panniliga¦rpoq	V	–nngilaq
papatta¦ppoq	V	–nngilaq
papa¦voq	V	–nngilaq
papeerulluinna¦rpoq	V	–nngilaq
papeerullu¦innarpoq	V	{–innanngilaq, –aannanngilaq}
papeeru¦ppoq	V	–tinngilaq
papeerussima¦voq	V	–nngilaq
papeqanngilaq	V	(no generation)
papeqanngits¦oq	N	–up, –ut
papeqilas¦oq	N	–up, –ut
papeqila¦voq	V	–nngilaq
papeqqiu¦ppoq	V	–tinngilaq
papeqqiutivi¦ppoq	V	–nngilaq
papeqqu¦ppoq	V	–tinngilaq
papequmitsa¦ppoq	V	–nngilaq
pape¦roq	N	–qqup, –qqut
paperors¦orpoq	V	–unngilaq
paperor¦sorpoq	V	{–sunngilaq, –tunngilaq}
paperortorti¦ppaa	V	–nngilaa
paperor¦tortippaa	V	{–sortinngilaa, –tortinngilaa}
paperuki¦ppoq	V	–nngilaq
paperuusa¦q	N	–p, –t
papi¦k	N	–up, –it
papikaja¦k	N	–ap, –at
papikatsu¦k	N	–up, –it
papikila¦voq	V	–nngilaq
papikilluinna¦rpoq	V	–nngilaq
papiki¦ppoq	V	–nngilaq
papikisaa¦rpoq	V	–nngilaq
papikisaart¦oq	N	–up, –ut
papikkaa¦q	N	–p, –t
papikuuju¦k	N	–up, –it
papil¦ik	N	{–iup, –lip, –lup}, –lit
papille¦raq	N	–qqap, –qqat
papillit	N, pl.	-
papillu¦ppoq	V	–nngilaq
papimmissa¦rpoq	V	–nngilaq
papimmissarujunngu¦aq	N	–up, –it
papitt¦ooq	N	–uup, –uut
papittoorsu¦aq	N	–up, –it
pappakkaluttuinna¦rpoq	V	–nngilaq
pappangavallaaqaaq	V	(no generation)
pappanga¦voq	V	–nngilaq
pappa¦ppoq	V	–nngilaq
pappatsi¦ppaa	V	–nngilaa
pappattaarpoq	V	(no generation)
pappi	N	(no generation)
pappiala	N	–p, –t
pappialaarniarfi¦k	N	–up, –it
pappialakoorfi¦k	N	–up, –it
pappialamine¦q	N	–rup, –rit
pappialam¦ineq	N	–ernup, –ernit
pappiala¦q	N	–p, –t
pappialarsorne¦q	N	–rup, –rit
pappialar¦sorneq	N	{–sornerup, –tornerup}, {–sornerit, –tornerit}
pappialarsu¦aq	N	–up, –it
pappialarta¦q	N	–p, –t
pappia¦ra	N	–qqap, –qqat
pappiaraarnia¦q	N	–p, –t
pappiaraarniarfi¦k	N	–up, –it
pappiaraaru¦ppoq	V	–tinngilaq
pappiarakoorfi¦k	N	–up, –it
pappiaram¦ineq	N	–ernup, –ernit
pappiara¦q	N	–p, –t
pappiararsu¦aq	N	–up, –it
pappili¦aq	N	{–ap, –ssap}, {–at, –ssat}
paqinna¦rpoq	V	–nngilaq
paqinnart¦oq	N	–up, –ut
paqqaa¦rpoq	V	–nngilaq
paqqappallaaqaaq	V	(no generation)
paqqa¦ppoq	V	–nngilaq
paqqasaa¦rpoq	V	–nngilaq
paqqass¦erpaa	V	–inngilaa
paqqassia¦q	N	–p, –t
paqq¦erpoq	V	–inngilaq
paqqersi¦ppaa	V	–nngilaa
paqqers¦oorpoq	V	–uunngilaq
paqqingasuunngilaq	V	(no generation)
paqqingavallaa¦rpoq	V	–nngilaq
paqqinga¦voq	V	–nngilaq
paqqisaa¦rpoq	V	–nngilaq
paqqisaarutig¦aa	V	–inngilaa
paqqiu¦ppaa	V	–tinngilaa
paqqut	N	–ip, –it
paqumig¦aa	V	–inngilaa
paqumigineqa¦rpoq	V	–nngilaq
paqumigineqart¦oq	N	–up, –ut
paqumigisa¦q	N	–p, –t
paquminarsa¦rpaa	V	–nngilaa
paquminart¦oq	N	–up, –ut
paqumisunne¦q	N	–rup, –rit
paqumisu¦ppoq	V	–nngilaq
paqumisutsitaane¦q	N	–rup, –rit
paragraffi	N	(no generation)
paratiisi	N	–p, –t
parnaarneqanngits¦oq	N	–up, –ut
parnaa¦rpaa	V	–nngilaa
parnaa¦rpoq	V	–nngilaq
parnaarsaat	N	–ip, –it
parnaarsimaffi¦k	N	–up, –it
parnaarsimanngilaq	V	(no generation)
parnaarsimanngits¦oq	N	–up, –ut
parnaarsima¦voq	V	–nngilaq
parnaarsimmavi¦k	N	–up, –it
parnaarsine¦q	N	–rup, –rit
parnaarsorfi¦k	N	–up, –it
parnaars¦orpaa	V	–unngilaa
parnaaru¦ppaa	V	–tinngilaa
parnaarussaagallarne¦q	N	–rup, –rit
parnaarussaajunnaar¦sippaa	V	{–sinngilaa, –tinngilaa}
parnaarussaane¦q	N	–rup, –rit
parnaarussaa¦rpaa	V	–nngilaa
parnaarussaarsi¦ppaa	V	–nngilaa
parnaarussaas¦oq	N	–up, –ut
parnaarussaa¦voq	V	–nngilaq
parnaarussa¦q	N	–p, –t
parnaarussassanngorti¦ppaa	V	–nngilaa
parnaarussivi¦k	N	–up, –it
parnaarussi¦vik	N	{–ffiup, –viup}, {–ffiit, –viit}
parnaarussivimmii¦ppoq	V	–nngilaq
parnaarussi¦vimmiippoq	V	{–ffimmiinngilaq, –vimmiinngilaq}
parnaarut	N	–ip, –it
parnginna¦rpoq	V	–nngilaq
parnginnarti¦ppaa	V	–nngilaa
parngu¦ppaa	V	–tinngilaa
parngu¦ppoq	V	–tinngilaq
parngussa¦q	N	–p, –t
parngutig¦aa	V	–inngilaa
parngutiinna¦rpoq	V	–nngilaq
parngut¦iinnarpoq	V	{–iinnanngilaq, –siinnanngilaq}
parngutivi¦ppoq	V	–nngilaq
parninna¦rpoq	V	–nngilaq
parninnarti¦ppaa	V	–nngilaa
parni¦vaa	V	–nngilaa
parni¦voq	V	–nngilaq
parnu¦ppaa	V	–tinngilaa
parnu¦ppoq	V	–nngilaq
parnussa¦q	N	–p, –t
parnutig¦aa	V	–inngilaa
parnutiinna¦rpoq	V	–nngilaq
parnu¦tilersoq	N	{–sersup, –sertup, –tilersup, –tilertup, –tsilersup, –tsilertup}, {–sersut, –sertut, –tilersut, –tilertut, –tsilersut, –tsilertut}
parnutivi¦ppoq	V	–nngilaq
parrataa¦rpaa	V	–nngilaa
parrataa¦rpoq	V	–nngilaq
parsangassutig¦aa	V	–inngilaa
parsanga¦voq	V	–nngilaq
parsiaa¦voq	V	–nngilaq
parsia¦rpaa	V	–nngilaa
pasill¦erpaa	V	–inngilaa
pasill¦erpoq	V	–inngilaq
pasillersi	N	–p, –t
pasillertaanna¦rpaa	V	–nngilaa
pasillertaanna¦rpoq	V	–nngilaq
pasilliine¦q	N	–rup, –rit
pasilliisaanna¦rpoq	V	–nngilaq
pasilliisuu¦voq	V	–nngilaq
pasillii¦voq	V	–nngilaq
pasilliut	N	–ip, –it
pasilliutaaru¦ppoq	V	–tinngilaq
pasilliutaa¦voq	V	–nngilaq
pasilliutig¦aa	V	–inngilaa
pasinaa¦ppoq	V	–nngilaq
pasinaa¦rpaa	V	–nngilaa
pasinaarsaarajuppoq	V	(no generation)
pasinaarsaa¦rpoq	V	–nngilaq
pasinaarsaarutig¦aa	V	–inngilaa
pasinaat	N	–ip, –it
pasinakujutt¦oq	N	–up, –ut
pasinakujuttoqa¦rpoq	V	–nngilaq
pasinanngilaq	V	(no generation)
pasinanngivi¦ppoq	V	–nngilaq
pasinapilu¦ppoq	V	–nngilaq
pasinarluinna¦rpoq	V	–nngilaq
pasina¦rpoq	V	–nngilaq
pasinart¦oq	N	–up, –ut
pasineqart¦oq	N	–up, –ut
pasinerlu¦ppaa	V	–nngilaa
pasinnikkajuppoq	V	(no generation)
pasinnikkajussu¦seq	N	–tsip, –tsit
pasisaa¦rpaa	V	–nngilaa
pasisaa¦rpoq	V	–nngilaq
pasisaa¦voq	V	–nngilaq
pasisa¦q	N	–p, –t
pasitsaali¦vaa	V	–nngilaa
pasitsaali¦voq	V	–nngilaq
pasitsaa¦ppaa	V	–tinngilaa
pasitsaassine¦q	N	–rup, –rit
pasitsaassi¦voq	V	–nngilaq
pasitsakkaluttuinnarpoq	V	(no generation)
pasitsanne¦q	N	–rup, –rit
pasitsa¦ppoq	V	–nngilaq
pasitsassaarut	N	–ip, –it
pasi¦vaa	V	–nngilaa
passangaa¦ppoq	V	{–nngilaq, –tinngilaq}
passappallaa¦rpoq	V	–nngilaq
passa¦ppoq	V	–nngilaq
passarlu¦ppaa	V	–nngilaa
passeqartussaane¦q	N	–rup, –rit
pass¦erpoq	V	–inngilaq
passi	N	(no generation)
passi¦k	N	–up, –it
passimmiu	N	–p, –t
passukkunnaa¦rpaa	V	–nngilaa
passumanii¦ppoq	V	–nngilaq
passunneqanngits¦oq	N	–up, –ut
passunnerits¦oq	N	–up, –ut
passu¦ppaa	V	–tinngilaa
passussa¦q	N	–p, –t
passussimanngits¦oq	N	–up, –ut
passussine¦q	N	–rup, –rit
passussi¦veqarfik	N	{–ffeqarfiup, –veqarfiup}, {–ffeqarfiit, –veqarfiit}
passussi¦vik	N	{–ffiup, –viup}, {–ffiit, –viit}
passussi¦voq	V	–nngilaq
passuta¦q	N	–p, –t
passuttuarpaa	V	(no generation)
patajaalline¦q	N	–rup, –rit
patajaallisaane¦q	N	–rup, –rit
patajaalli¦voq	V	–nngilaq
patajaa¦ppoq	V	–nngilaq
patajaassu¦seq	N	–tsip, –tsit
patajaats¦oq	N	–up, –ut
patajaavi¦ppoq	V	–nngilaq
patajasi¦voq	V	–nngilaq
pataja¦voq	V	–nngilaq
patanaalli¦voq	V	–nngilaq
patanaalluinnarpoq	V	(no generation)
patanaa¦ppoq	V	–nngilaq
patanaa¦rpaa	V	–nngilaa
patanaarsaane¦q	N	–rup, –rit
patana¦rpoq	V	–nngilaq
patanarsi¦voq	V	–nngilaq
patanart¦oq	N	–up, –ut
patequt	N	–ip, –it
pateria¦rpaa	V	–nngilaa
pat¦erpaa	V	–inngilaa
pat¦erpoq	V	–inngilaq
patiffi¦k	N	–up, –it
patiffil¦ik	N	{–iup, –lip, –lup}, –lit
patigassa¦q	N	–p, –t
patiiaat	N	–ip, –it
patillua¦rpaa	V	–nngilaa
patinne¦q	N	–rup, –rit
patinngulaa¦rpoq	V	–nngilaq
patinngutitsi¦voq	V	–nngilaq
patinngu¦voq	V	–nngilaq
patipassu¦ppaa	V	–tinngilaa
pati¦ppaa	V	–nngilaa
pati¦ppoq	V	–nngilaq
pati¦ssivoq	V	{–ssinngilaq, –tsinngilaq}
patitaa¦voq	V	–nngilaq
patita¦q	N	–p, –t
patitassa¦q	N	–p, –t
patiti¦ppaa	V	–nngilaa
pati¦tippaa	V	{–sinngilaa, –tinngilaa, –tsinngilaa}
pati¦tsippaa	V	{–sinngilaa, –tinngilaa, –tsinngilaa}
pati¦tsitaq	N	{–sitap, –titap, –tsitap}, {–sitat, –titat, –tsitat}
pati¦tsivoq	V	{–ssinngilaq, –tsinngilaq}
patittari¦aq	N	{–ssap, –ap}, {–ssat, –at}
patittari¦aq	N	–ssap, –ssat
patruuneqarpoq	V	(no generation)
patruuni	N	(no generation)
patruuniisivi¦k	N	–up, –it
patruunisi¦voq	V	–nngilaq
patsikkunnaa¦rpaa	V	–nngilaa
patsi¦ppaa	V	–nngilaa
patsisaa¦voq	V	–nngilaq
patsiseqanngivi¦ppoq	V	–nngilaq
patsiseqarluart¦oq	N	–up, –ut
patsiseqa¦rpoq	V	–nngilaq
patsisig¦aa	V	–inngilaa
patsisiginia¦gaq	N	–kkap, –kkat
patsisiginngilaa	V	(no generation)
patsisissaaru¦ppoq	V	–tinngilaq
patsisissaarutivi¦ppoq	V	–nngilaq
patsisissaatita¦q	N	–p, –t
patsisissa¦q	N	–p, –t
patsisissaqanngits¦oq	N	–up, –ut
patsisissarsi¦orpoq	V	–unngilaq
patsisissarsiortaannarpoq	V	(no generation)
patsi¦t	N	–sip, –sit
pattaanne¦q	N	–rup, –rit
pattaa¦ppoq	V	–tinngilaq
pattaasi¦orpoq	V	–unngilaq
pattaa¦siorpoq	V	{–siunngilaq, –tiliunngilaq}
pattaat	N	–ip, –it
pattaffiit	N, pl.	-
pattaffi¦k	N	–up, –it
pattagiaa¦raq	N	–qqap, –qqat
pattagiaasa¦q	N	–p, –t
pattagial¦ik	N	{–iup, –lip, –lup}, –lit
pattagiapalaa¦q	N	–p, –t
pattagi¦aq	N	–ssap, –ssat
pattagia¦rpoq	V	–nngilaq
pattagiars¦orpoq	V	–unngilaq
pattagiar¦sorpoq	V	{–sunngilaq, –tunngilaq}
pattagiarsu¦aq	N	–up, –it
pattagissiort¦oq	N	–up, –ut
pattagissiortuu¦voq	V	–nngilaq
pattakkiartoqqaarallarpoq	V	(no generation)
pattakkiartoqqaarpoq	V	(no generation)
pattakkiartoqqaarumavoq	V	(no generation)
pattaku	N	–p, –t
pattalaarine¦q	N	–rup, –rit
pattalaa¦rpaa	V	–nngilaa
pattalaarti¦ppoq	V	–nngilaq
pattalaartuinnaa¦vaa	V	–nngilaa
pattallaqqi¦ppoq	V	–nngilaq
pattallaqqissi¦voq	V	–nngilaq
pattallaqqissorujussu¦uvoq	V	{–aanngilaq, –unngilaq}
pattallaqqi¦ssorujussuuvoq	V	{–ssorujussuaanngilaq, –ssorujussuunngilaq, –ttorujussuaanngilaq, –ttorujussuunngilaq}
pattapalaa¦rpoq	V	–nngilaq
patta¦ppaa	V	–nngilaa
patta¦ppoq	V	–nngilaq
pattari¦ppoq	V	–nngilaq
pattarujoorpoq	V	(no generation)
pattassinnaa¦voq	V	–nngilaq
pattatta¦rpoq	V	–nngilaq
pattattart¦oq	N	–up, –ut
pattatt¦oq	N	–up, –ut
pattatt¦orpoq	V	–unngilaq
pattattuu¦voq	V	–nngilaq
pattorne¦q	N	–rup, –rit
patt¦orpaa	V	–unngilaa
patugukkiart¦orpaa	V	–unngilaa
patugu¦ppaa	V	–tinngilaa
patugu¦ppoq	V	–tinngilaq
patugusimane¦q	N	–rup, –rit
patugusima¦voq	V	–nngilaq
patugussaa¦voq	V	–nngilaq
patugut	N	–ip, –it
patugutaa¦rpaa	V	–nngilaa
patugutaa¦voq	V	–nngilaq
patugutivi¦ppaa	V	–nngilaa
patugut¦ivippaa	V	{–ivinngilaa, –sivinngilaa}
pavanii¦ppoq	V	–nngilaq
pavungapilorujussu¦aq	N	–up, –it
pavungarsualiartart¦oq	N	–up, –ut
pavungarsu¦aq	N	–up, –it
pavunnaa¦ppaa	V	–tinngilaa
pavunna¦rpoq	V	–nngilaq
pavunnarsima¦voq	V	–nngilaq
pavunnart¦oq	N	–up, –ut
pavuunaqqu¦ppaa	V	–tinngilaa
pavuunaqqu¦ppoq	V	–tinngilaq
pavuunarsu¦aq	N	–up, –it
pavuunarujussu¦aq	N	–up, –it
pee¦raq	N	–qqap, –qqat
peerariit	N, pl.	-
peerartaa¦rpoq	V	–nngilaq
peeriaannaa¦voq	V	–nngilaq
p¦eerpaa	V	–iinngilaa
p¦eerpoq	V	–iinngilaq
peersaat	N	–ip, –it
peer¦saat	N	{–saatip, –taatip}, {–saatit, –taatit}
peersaa¦voq	V	–nngilaq
peersa¦q	N	–p, –t
peersart¦oq	N	–up, –ut
peersima¦voq	V	–nngilaq
peersine¦q	N	–rup, –rit
peersinnaa¦voq	V	–nngilaq
peer¦sinneqarneq	N	{–sinneqarnerup, –tinneqarnerup}, {–sinneqarnerit, –tinneqarnerit}
peer¦sippaa	V	{–sinngilaa, –tinngilaa}
peersitaane¦q	N	–rup, –rit
peer¦sitaaneq	N	{–sitaanerup, –titaanerup}, {–sitaanerit, –titaanerit}
peer¦sitaavoq	V	{–sitaanngilaq, –titaanngilaq}
peer¦sitaq	N	{–sitap, –titap}, {–sitat, –titat}
peersitsine¦q	N	–rup, –rit
peer¦sitsineq	N	{–sitsinerup, –titsinerup}, {–sitsinerit, –titsinerit}
peersi¦vaa	V	–nngilaa
peersi¦voq	V	–nngilaq
peers¦oorpoq	V	–uunngilaq
peersuatsaa¦vaa	V	–nngilaa
peertussaajunnaar¦toq	N	{–sup, –tup}, {–sut, –tut}
peer¦tussaajunnaartoq	N	{–sussaajunnaarsup, –sussaajunnaartup, –tussaajunnaarsup, –tussaajunnaartup}, {–sussaajunnaarsut, –sussaajunnaartut, –tussaajunnaarsut, –tussaajunnaartut}
peerukkiart¦orpoq	V	–unngilaq
peerukkiartorsimas¦oq	N	–up, –ut
peerumasanngilaq	V	(no generation)
peeru¦ppaa	V	–tinngilaa
peeru¦ppoq	V	–tinngilaq
peerussi¦vaa	V	–nngilaa
peerutiisa¦rpoq	V	–nngilaq
peerutivi¦ppoq	V	–nngilaq
pensiuun¦erpoq	V	–inngilaq
pensiuuni	N	–p, –t
pensiuunisiat	N, pl.	-
peqal¦erpoq	V	–inngilaq
peqangaa¦rpoq	V	–nngilaq
peqanngilaq	V	(no generation)
peqannginne¦q	N	–rup, –rit
peqanngitsoorpoq	V	(no generation)
peqanngitsoorti¦ppaa	V	–nngilaa
peqaqaaq	V	(no generation)
peqaqqi¦ppoq	V	–nngilaq
peqaraluanngilaq	V	(no generation)
peqa¦rpoq	V	–nngilaq
peqasaa¦rpoq	V	–nngilaq
peqa¦sersorpaa	V	{–sersunngilaa, –tilersunngilaa}
peqassu¦seq	N	–tsip, –tsit
peqat	N	–ip, –it
peqataaffig¦aa	V	–inngilaa
peqataaffigil¦erpaa	V	–inngilaa
peqataajuma¦voq	V	–nngilaq
peqataalerne¦q	N	–rup, –rit
peqataaler¦sippaa	V	{–sinngilaa, –tinngilaa}
peqataane¦q	N	–rup, –rit
peqataanissa¦q	N	–p, –t
peqataannginne¦q	N	–rup, –rit
peqataanngits¦oq	N	–up, –ut
peqataarusunne¦q	N	–rup, –rit
peqataas¦oq	N	–up, –ut
peqataassut	N	–ip, –it
peqataasussa¦q	N	–p, –t
peqataati¦ppaa	V	–nngilaa
peqataatitsine¦q	N	–rup, –rit
peqataa¦voq	V	–nngilaq
peqateqarne¦q	N	–rup, –rit
peqateqarsinnaaleriartorfi¦k	N	–up, –it
peqatig¦aa	V	–inngilaa
peqatigiiffiit	N, pl.	-
peqatigiiffi¦k	N	–up, –it
peqatigiiffilerine¦q	N	–rup, –rit
peqatigiilerne¦q	N	–rup, –rit
peqatigiilersimanngitsut	N, pl.	-
peqatigiilluassu¦seq	N	–tsip, –tsit
peqatigiinne¦q	N	–rup, –rit
Peqatigiinniat	N, pl.	-
peqatigiinniat	N, pl.	-
peqatigii¦ssut	N, pl.	{–ssut, –ttut}
peqatigiit	N, pl.	-
peqatigil¦erpaa	V	–inngilaa
peqatigisa¦q	N	–p, –t
peqatissarsiorne¦q	N	–rup, –rit
peqillua¦rpoq	V	–nngilaq
peqimi¦voq	V	–nngilaq
peqingaalaa¦rpoq	V	–nngilaq
peqingaa¦rpoq	V	–nngilaq
peqingane¦q	N	–rup, –rit
peqingas¦oq	N	–up, –ut
peqingasorsu¦aq	N	–up, –it
peqingasulia¦q	N	–p, –t
peqingavallaa¦rpoq	V	–nngilaq
peqinga¦voq	V	–nngilaq
peqinne¦q	N	–rup, –rit
peqinnerulerne¦q	N	–rup, –rit
peqinngari¦ppoq	V	–nngilaq
peqinngarissa¦rpaa	V	–nngilaa
peqi¦ppaa	V	–nngilaa
peqi¦ppoq	V	–nngilaq
peqisaava¦q	N	–p, –t
peqisa¦ppoq	V	–nngilaq
peqisattua¦rpoq	V	–nngilaq
peqissima¦voq	V	–nngilaq
peqitaa¦voq	V	–nngilaq
peqita¦q	N	–p, –t
peqitassa¦q	N	–p, –t
peqiti¦ppaa	V	–nngilaa
peqit¦ippaa	V	–sinngilaa
peqi¦tsippaa	V	{–ssinngilaa, –tsinngilaa}
peqitsivi¦k	N	–up, –it
peqitsi¦voq	V	–nngilaq
peqqaarfi¦k	N	–up, –it
peqqaat	N	–ip, –it
peqqaataa¦voq	V	–nngilaq
peqqaatig¦aa	V	–inngilaa
peqqalutt¦orpaa	V	–unngilaa
peqqalutt¦orpoq	V	–unngilaq
peqqamm¦erpoq	V	–inngilaq
peqqanngilaq	V	(no generation)
peqqarnii¦ppoq	V	–nngilaq
peqqarniisaarfig¦aa	V	–inngilaa
peqqarniisaarne¦q	N	–rup, –rit
peqqarniisaarnerunngits¦oq	N	–up, –ut
peqqarniisaarnia¦q	N	–p, –t
peqqarniisaarniarne¦q	N	–rup, –rit
peqqarniisaa¦rpoq	V	–nngilaq
peqqarniisaartuunngits¦oq	N	–up, –ut
peqqarniissu¦seq	N	–tsip, –tsit
peqqarniits¦oq	N	–up, –ut
peqqa¦rpoq	V	–nngilaq
peqqartaa¦ppoq	V	–nngilaq
peqqiig¦aa	V	–inngilaa
peqqiillinart¦oq	N	–up, –ut
peqqiilli¦orpoq	V	–unngilaq
peqqiillisimas¦oq	N	–up, –ut
peqqiillissutig¦aa	V	–inngilaa
peqqiippalu¦ppoq	V	–nngilaq
peqqii¦ppoq	V	–nngilaq
peqqiisaa¦ppaa	V	–tinngilaa
peqqiissut	N	–ip, –it
peqqii¦ssut	N, pl.	{–ssut, –ttut}
peqqiits¦oq	N	–up, –ut
peqqii¦tsoq	N	{–ssup, –tsup, –ttup}, {–ssut, –tsut, –ttut}
peqqikkunnanngilaq	V	(no generation)
peqqikkunna¦rpoq	V	–nngilaq
peqqilluanngilaq	V	(no generation)
peqqillua¦rpoq	V	–nngilaq
peqqilluinnarpoq	V	(no generation)
peqqinnanngits¦oq	N	–up, –ut
peqqinnart¦oq	N	–up, –ut
peqqinne¦q	N	–rup, –rit
peqqinngilluinnarpoq	V	(no generation)
peqqinnissaleris¦oq	N	–up, –ut
peqqinnissaqarfiit	N, pl.	-
peqqinnissaqarfi¦k	N	–up, –it
peqqinnissaqarne¦q	N	–rup, –rit
peqqi¦ppoq	V	–nngilaq
peqqissaane¦q	N	–rup, –rit
peqqissaanngilaq	V	(no generation)
peqqissaannginne¦q	N	–rup, –rit
peqqissaanngits¦oq	N	–up, –ut
peqqi¦ssaarneq	N	{–ssaarnerup, –ttaarnerup}, {–ssaarnerit, –ttaarnerit}
peqqissaa¦rpoq	V	–nngilaq
peqqissaart¦oq	N	–up, –ut
peqqi¦ssaartoq	N	{–ssaartup, –ttaartup}, {–ssaartut, –ttaartut}
peqqissaarullua¦rpaa	V	–nngilaa
peqqissaarunneqassa¦aq	V	–nngilaq
peqqissaaru¦ppaa	V	–tinngilaa
peqqissaarussa¦q	N	–p, –t
peqqissaarussis¦oq	N	–up, –ut
peqqissaarussi¦voq	V	–nngilaq
peqqissaas¦oq	N	–up, –ut
peqqissaasoqarfi¦k	N	–up, –it
peqqissaasunngorniart¦oq	N	–up, –ut
peqqissaasuune¦q	N	–rup, –rit
peqqissaat	N	–ip, –it
peqqi¦ssaat	N	{–ssaatip, –ttaatip}, {–ssaatit, –ttaatit}
peqqissaaveqarfi¦k	N	–up, –it
peqqissaa¦veqarfik	N	{–ffeqarfiup, –veqarfiup}, {–ffeqarfiit, –veqarfiit}
peqqissaavi¦k	N	–up, –it
peqqissaa¦vik	N	{–ffiup, –viup}, {–ffiit, –viit}
peqqissarfi¦k	N	–up, –it
peqqi¦ssarfik	N	{–ssarfiup, –ttarfiup}, {–ssarfiit, –ttarfiit}
peqqissarne¦q	N	–rup, –rit
peqqi¦ssarneq	N	{–ssarnerup, –ttarnerup}, {–ssarnerit, –ttarnerit}
peqqissa¦rpaa	V	–nngilaa
peqqi¦ssarpoq	V	–ttanngilaq
peqqissartarfi¦k	N	–up, –it
peqqissartinne¦q	N	–rup, –rit
peqqissimilereeraluarpoq	V	(no generation)
peqqissimil¦erpoq	V	–inngilaq
peqqissimillua¦rpoq	V	–nngilaq
peqqissimine¦q	N	–rup, –rit
peqqissimissutig¦aa	V	–inngilaa
peqqissimi¦voq	V	–nngilaq
peqqissinart¦oq	N	–up, –ut
peqqissine¦q	N	–rup, –rit
peqqiss¦ipallappoq	V	{–erpallanngilaq, –ipallanngilaq}
peqqi¦ssipallappoq	V	{–ssipallanngilaq, –ssippallanngilaq, –tsipallanngilaq, –tsippallanngilaq}
peqqissisinnaanngits¦oq	N	–up, –ut
peqqissisinneqarsinnaas¦oq	N	–up, –ut
peqqissi¦voq	V	–nngilaq
peqqi¦ssoq	N	{–ssup, –ttup}, {–ssut, –ttut}
peqqissu¦seq	N	–tsip, –tsit
peqqissusilerine¦q	N	–rup, –rit
peqqoo¦raq	N	–qqap, –qqat
peqqort¦ooq	N	–uup, –uut
peqqu¦aa	V	–nngilaa
peqqua¦raq	N	–qqap, –qqat
peqquinna¦rpaa	V	–nngilaa
peqqu¦k	N	–up, –it
peqqukits¦oq	N	–up, –ut
peqqullua¦rpoq	V	–nngilaq
peqqumaa¦rpaa	V	–nngilaa
peqqumaas¦erpoq	V	–inngilaq
peqqumaa¦serpoq	V	{–sinngilaq, –tilinngilaq}
peqqumaasia¦q	N	–p, –t
peqqumaa¦siaq	N	{–siap, –tiliap}, {–siat, –tiliat}
peqqumaasi¦orpoq	V	–unngilaq
peqqumaa¦siorpoq	V	{–siunngilaq, –tiliunngilaq}
peqqumaasivi¦k	N	–up, –it
peqqumaasi¦voq	V	–nngilaq
peqqumaat	N	–ip, –it
peqqunart¦oq	N	–up, –ut
peqquneqarne¦q	N	–rup, –rit
peqqunngilaa	V	(no generation)
peqqunngisa¦q	N	–p, –t
peqqu¦ppaa	V	–tinngilaa
peqqu¦ppoq	V	–tinngilaq
peqqusaanngits¦oq	N	–up, –ut
peqqusaarajuppoq	V	(no generation)
peqqusaa¦rpaa	V	–nngilaa
peqqusaa¦rpoq	V	–nngilaq
peqqusaa¦voq	V	–nngilaq
peqqusa¦q	N	–p, –t
peqquserlunne¦q	N	–rup, –rit
peqquserlu¦ppoq	V	–nngilaq
peqquserlutsi¦ppaa	V	–nngilaa
peqquserlutsitsine¦q	N	–rup, –rit
peqquserluttaanna¦rpoq	V	–nngilaq
peqquserluttuliorne¦q	N	–rup, –rit
peqquserluusi¦orpoq	V	–unngilaq
peqquserluu¦siorpoq	V	{–siunngilaq, –tiliunngilaq}
peqquserluut	N	–ip, –it
peqquserluutaa¦voq	V	–nngilaq
peqquserluuteqarne¦q	N	–rup, –rit
peqquserluutig¦aa	V	–inngilaa
peqqusersiorfig¦aa	V	–inngilaa
peqqusersiorfiginninne¦q	N	–rup, –rit
peqqusersiorne¦q	N	–rup, –rit
peqqusersi¦orpoq	V	–unngilaq
peqqusersiortaanna¦rpoq	V	–nngilaq
peqqusers¦ooq	N	–uup, –uut
peqqusersooqaaq	V	(no generation)
peqqusersuilluinna¦rpoq	V	–nngilaq
peqqusersuinngilaq	V	(no generation)
peqqusersui¦ppoq	V	–nngilaq
peqqu¦sersuippoq	V	{–sersuinngilaq, –tilersuinngilaq}
peqqusersuitsuu¦voq	V	–nngilaq
peqqusersusaajui¦ppoq	V	–nngilaq
peqqusersusaa¦rpoq	V	–nngilaq
peqqusersuui¦k	N	–up, –it
peqqusersuusaa¦rpoq	V	–nngilaq
peqqu¦sersuusaarpoq	V	{–sersuusaanngilaq, –sertuusaanngilaq, –tilersuusaanngilaq, –tilertuusaanngilaq}
peqqusersuu¦voq	V	–nngilaq
peqqu¦sersuuvoq	V	{–sersuunngilaq, –sertuunngilaq, –tilersuunngilaq, –tilertuunngilaq}
peqqu¦seruseq	N	{–serutsip, –siutsip, –tilerutsip, –tiliutsip}, {–serutsit, –siutsit, –tilerutsit, –tiliutsit}
peqqusiileqissutig¦aa	V	–inngilaa
peqqusiileqi¦voq	V	–nngilaq
peqqusine¦q	N	–rup, –rit
peqqusi¦voq	V	–nngilaq
peqqussu¦aq	N	–up, –it
peqqussut	N	–ip, –it
peqqussuteqaat	N	–ip, –it
peqqussuteqarfig¦aa	V	–inngilaa
peqqussuteqa¦rpoq	V	–nngilaq
peqqussutig¦aa	V	–inngilaa
peqqussutit	N, pl.	-
peqqut	N	–ip, –it
peqqutaas¦oq	N	–up, –ut
peqqutaa¦voq	V	–nngilaq
peqqutig¦aa	V	–inngilaa
peqquti¦ppaa	V	–nngilaa
peqqut¦ippaa	V	{–inngilaa, –sinngilaa, –itinngilaa}
peqqutissarsi¦orpoq	V	–unngilaq
peqqutitsigaju¦ppoq	V	–nngilaq
peqqut¦itsigajuppoq	V	{–itsigajunngilaq, –sitsigajunngilaq}
peqqutitsi¦voq	V	–nngilaq
peqqut¦itsivoq	V	{–itsinngilaq, –sitsinngilaq}
peqquts¦erpoq	V	–inngilaq
peqqutsiataarpoq	V	(no generation)
peqqutta¦q	N	–p, –t
peqquua¦rpoq	V	–nngilaq
peqquusa¦q	N	–p, –t
pequ¦erpoq	V	–inngilaq
pequlia¦ppoq	V	–nngilaq
pequliassima¦voq	V	–nngilaq
pequliatsi¦ppaa	V	–nngilaa
pequngas¦oq	N	–up, –ut
pequsaava¦q	N	–p, –t
pequsa¦ppoq	V	–nngilaq
pequsa¦rpoq	V	–nngilaq
pequ¦sersorpaa	V	{–sersunngilaa, –tilersunngilaa}
pequsi¦orpoq	V	–unngilaq
pequ¦siorpoq	V	{–siunngilaq, –tiliunngilaq}
pequsiort¦oq	N	–up, –ut
pequ¦siortoq	N	{–siortup, –tiliortup}, {–siortut, –tiliortut}
pequt	N	–ip, –it
pequtaarniarfi¦k	N	–up, –it
pequtissat	N, pl.	-
pequusia¦q	N	–p, –t
pequu¦siaq	N	{–siap, –tiliap}, {–siat, –tiliat}
pequusi¦orpoq	V	–unngilaq
pequu¦siorpoq	V	{–siunngilaq, –tiliunngilaq}
pequusivi¦k	N	–up, –it
pequut	N	–ip, –it
pequuters¦orpoq	V	–unngilaq
pequ¦voq	V	–nngilaq
perataanngeqaaq	V	(no generation)
perataa¦rpoq	V	–nngilaq
peratarsinnaanng¦orpoq	V	–unngilaq
per¦eerpoq	V	–iinngilaq
pereersimasulikkersaarne¦q	N	–rup, –rit
periaa¦seq	N	–tsip, –tsit
periaaseqarne¦q	N	–rup, –rit
periagaa¦voq	V	–nngilaq
peria¦gaq	N	–kkap, –kkat
periagassa¦q	N	–p, –t
periallaqqi¦ppoq	V	–nngilaq
periarfeeru¦ppaa	V	–tinngilaa
periarfeeru¦ppoq	V	–tinngilaq
periarfeerussa¦q	N	–p, –t
periarfig¦aa	V	–inngilaa
periarfissal¦erpaa	V	–inngilaa
periarfissaliissut	N	–ip, –it
periarfissa¦q	N	–p, –t
periarfissaqarne¦q	N	–rup, –rit
periarfissaqart¦oq	N	–up, –ut
periarfissarititaagallart¦oq	N	–up, –ut
periarfissarsineqarsinnaassu¦seq	N	–tsip, –tsit
periarfissiine¦q	N	–rup, –rit
periarfissiissut	N	–ip, –it
periarfissi¦ppaa	V	–nngilaa
peria¦rpaa	V	–nngilaa
peria¦rpoq	V	–nngilaq
periarsinnaannginne¦q	N	–rup, –rit
periasaa¦rpoq	V	–nngilaq
periataallaqqi¦ppoq	V	–nngilaq
periataallaqqi¦ssoq	N	{–ssup, –ttup}, {–ssut, –ttut}
periataallaqqissu¦seq	N	–tsip, –tsit
periataarnerlu¦ppoq	V	–nngilaq
periataa¦rpoq	V	–nngilaq
periataarsinnaane¦q	N	–rup, –rit
periukkalua¦rpaa	V	–nngilaa
periu¦ppaa	V	–tinngilaa
periu¦seq	N	–tsip, –tsit
periusissaaru¦ppoq	V	–tinngilaq
periusissia¦q	N	–p, –t
periussaa¦voq	V	–nngilaq
periut	N	–ip, –it
periutissa¦q	N	–p, –t
perlaaja¦q	N	–p, –t
perlaa¦q	N	–p, –t
perlaar¦aa	V	–inngilaa
perlaa¦rpoq	V	–nngilaq
perlaasa¦q	N	–p, –t
perlaasinnaa¦voq	V	–nngilaq
perlaassa¦q	N	–p, –t
perlaassia¦q	N	–p, –t
perlaa¦vaa	V	–nngilaa
perlaavi¦k	N	–up, –it
perlaa¦vik	N	{–ffiup, –viup}, {–ffiit, –viit}
perlaa¦voq	V	–nngilaq
perlagaasa¦q	N	–p, –t
perla¦gaq	N	–kkap, –kkat
perlarne¦q	N	–rup, –rit
perla¦rpaa	V	–nngilaa
perlasi¦voq	V	–nngilaq
perla¦sserpaa	V	{–alinngilaa, –ssinngilaa}
perlass¦erpoq	V	–inngilaq
perlataanngilaq	V	(no generation)
perlataarajuppoq	V	(no generation)
perlataa¦rpoq	V	–nngilaq
perlequjaaju¦voq	V	–nngilaq
perlequjaa¦q	N	–p, –t
perlequjaa¦voq	V	–nngilaq
perler¦aa	V	–inngilaa
perlerfi¦k	N	–up, –it
perlernaveeqqut	N	–ip, –it
perlernaveeqqut¦aannaq	N	{–aannaap, –iinnaap}, {–aannaat, –iinnaat}
perlerne¦q	N	–rup, –rit
perlerorne¦q	N	–rup, –rit
perler¦orpoq	V	–unngilaq
perlerort¦oq	N	–up, –ut
perlerortoqarajuppoq	V	(no generation)
perl¦erpoq	V	–inngilaq
perlerserpaa	V	(no generation)
perlertoqassaa¦rpoq	V	–nngilaq
perler¦toqassaarpoq	V	{–soqassaanngilaq, –toqassaanngilaq}
perleruusarne¦q	N	–rup, –rit
perlilerne¦q	N	–rup, –rit
perlil¦erpoq	V	–inngilaq
perlim¦oorpoq	V	–uunngilaq
perlimoort¦oq	N	–up, –ut
perlingajatt¦oq	N	–up, –ut
perlipatt¦oq	N	–up, –ut
perl¦oorpaa	V	–uunngilaa
perloqqu¦aa	V	–nngilaa
perloqqusaa¦voq	V	–nngilaq
perloqqusi¦voq	V	–nngilaq
perloqqussut	N	–ip, –it
perloqqussut	N, pl.	-
perlu¦k	N	–up, –it
perlukkajuppoq	V	(no generation)
perluk¦oq	N	–up, –ut
perluku¦iaaneq	N	{–ajaanerup, –iaanerup}, {–ajaanerit, –iaanerit}
perlulioqatigiinniarne¦q	N	–rup, –rit
perluli¦orpoq	V	–unngilaq
perluliortaanna¦rpoq	V	–nngilaq
perluliortitsi¦voq	V	–nngilaq
perlu¦ppoq	V	–nngilaq
perlussi¦orpoq	V	–unngilaq
perluss¦iorpoq	V	{–iunngilaq, –aliunngilaq}
perlussiort¦oq	N	–up, –ut
perluss¦iortoq	N	{–iortup, –aliortup}, {–iortut, –aliortut}
perlussi¦voq	V	–nngilaq
perlussu¦aq	N	–up, –it
perlusuut	N	–ip, –it
perlusuuteqa¦rpoq	V	–nngilaq
perlutsi¦ppaa	V	–nngilaa
perluus¦erpaa	V	–inngilaa
perluu¦serpaa	V	{–sinngilaa, –tilinngilaa}
perluut	N	–ip, –it
pernaa¦q	N	–p, –t
pernaat	N	–ip, –it
pernaat	N, pl.	-
pernaataa¦voq	V	–nngilaq
pernaa¦voq	V	–nngilaq
perna¦q	N	–p, –t
pernarnia¦rpoq	V	–nngilaq
perna¦rpoq	V	–nngilaq
pernartaa¦voq	V	–nngilaq
pernarta¦q	N	–p, –t
perne¦q	N	–rup, –rit
pernerliaqi¦voq	V	–nngilaq
pernermi¦ppaa	V	–nngilaa
pernermi¦ppoq	V	–nngilaq
pern¦erpaa	V	–inngilaa
pernertu¦voq	V	–nngilaq
perngaa¦q	N	–p, –t
perngaat	N	–ip, –it
perngaat	N, pl.	-
perngaataa¦voq	V	–nngilaq
perngaa¦voq	V	–nngilaq
perngarnia¦rpoq	V	–nngilaq
pernga¦rpoq	V	–nngilaq
perngartaa¦voq	V	–nngilaq
perngarta¦q	N	–p, –t
peroorlua¦rpaa	V	–nngilaa
per¦oorpaa	V	–uunngilaa
per¦oorpoq	V	–uunngilaq
peroorti¦ppaa	V	–nngilaa
peroriartorne¦q	N	–rup, –rit
peroriart¦orpoq	V	–unngilaq
perorlua¦rpoq	V	–nngilaq
per¦orpoq	V	–unngilaq
perorsaane¦q	N	–rup, –rit
perorsaas¦oq	N	–up, –ut
perorsaasussaaleqine¦q	N	–rup, –rit
perorsaat	N	–ip, –it
perorsaavi¦k	N	–up, –it
perorsaa¦vik	N	{–ffiup, –viup}, {–ffiit, –viit}
perorsaa¦voq	V	–nngilaq
perorsagaane¦q	N	–rup, –rit
perorsarlua¦gaq	N	–kkap, –kkat
perorsa¦rpaa	V	–nngilaa
perorsarsimarpalunngits¦oq	N	–up, –ut
perorsarsimarpalutt¦oq	N	–up, –ut
perorsarsimas¦oq	N	–up, –ut
perorsarsimassu¦seq	N	–tsip, –tsit
perpalaanngu¦aq	N	–up, –it
perpalaa¦q	N	–p, –t
perpalaaqaaq	V	(no generation)
perpaluisa¦ppoq	V	–nngilaq
perpalu¦k	N	–up, –it
perpalunne¦q	N	–rup, –rit
perpalunnersu¦aq	N	–up, –it
perpalu¦ppoq	V	–nngilaq
perpalussu¦aq	N	–up, –it
perpalutsitsi¦voq	V	–nngilaq
perpaluut	N	–ip, –it
perraalli¦voq	V	–nngilaq
perraappallaaqaaq	V	(no generation)
perraa¦ppoq	V	{–nngilaq, –tinngilaq}
perralisaa¦rpoq	V	–nngilaq
perranna¦rpoq	V	–nngilaq
perra¦ppoq	V	–nngilaq
perrassaat	N	–ip, –it
perratsippoq	V	(no generation)
perrattuinnaa¦voq	V	–nngilaq
perravi¦ppoq	V	–nngilaq
perra¦voq	V	–nngilaq
perris¦oorpoq	V	–uunngilaq
perrivi¦k	N	–up, –it
perri¦voq	V	–nngilaq
perr¦oorpoq	V	–uunngilaq
perroorsaa¦rpaa	V	–nngilaa
perroort¦oq	N	–up, –ut
perroorutig¦aa	V	–inngilaa
perrortu¦voq	V	–nngilaq
perru¦ppaa	V	–tinngilaa
perrussaa¦voq	V	–nngilaq
perruualaa¦rpoq	V	–nngilaq
perruumaataarajuppoq	V	(no generation)
perruumaataa¦rpoq	V	–nngilaq
perruussalaa¦rpoq	V	–nngilaq
perruussu¦seq	N	–tsip, –tsit
perruutsa¦ppoq	V	–nngilaq
perruutu¦voq	V	–nngilaq
persali¦voq	V	–nngilaq
persaqqu¦ppaa	V	{–nngilaa, –tinngilaa}
persaqqutaa¦voq	V	–nngilaq
persaqqu¦taavoq	V	{–taanngilaq, –ssaanngilaq}
persaqquta¦q	N	–p, –t
persaqqu¦taq	N	{–ssap, –tap}, {–ssat, –tat}
persaqqutig¦aa	V	–inngilaa
persaqu¦serpaa	V	{–sinngilaa, –tilinngilaa}
persaqu¦sersorpaa	V	{–sersunngilaa, –tilersunngilaa}
persaqut	N	–ip, –it
persaqutaa¦voq	V	–nngilaq
persaqutig¦aa	V	–inngilaa
persar¦aa	V	–inngilaa
persariti¦ppoq	V	–nngilaq
persatar¦aa	V	–inngilaa
pers¦eq	N	–ip, –it
perserala¦voq	V	–nngilaq
pers¦erpoq	V	–inngilaq
persersorsuu¦voq	V	–nngilaq
persersorsu¦uvoq	V	{–aanngilaq, –unngilaq}
perser¦sorsuuvoq	V	{–sorsuaanngilaq, –sorsuunngilaq, –torsuaanngilaq, –torsuunngilaq}
Persiam¦eersoq	N	{–eersup, –eertup, –inngaanneersup, –inngaanneertup}, {–eersut, –eertut, –inngaanneersut, –inngaanneertut}
Persiamioq	N	(no generation)
Persiamiu	N	–p, –t
persinganngilaq	V	(no generation)
persinga¦voq	V	–nngilaq
persinnil¦ik	N	{–iup, –lip, –lup}, –lit
persi¦ppaa	V	–nngilaa
pers¦oq	N	–up, –ut
persor¦aa	V	–inngilaa
persoralaa¦q	N	–p, –t
persoralasorsuu¦voq	V	–nngilaq
persori	N	–p, –t
persoringaja¦ppoq	V	–nngilaq
persorisi¦orpoq	V	–unngilaq
persorisorsuu¦voq	V	–nngilaq
persorisorsu¦uvoq	V	{–aanngilaq, –unngilaq}
persorivallaanngilaq	V	(no generation)
persori¦voq	V	–nngilaq
pers¦orpoq	V	–unngilaq
persorsi¦orpoq	V	–unngilaq
persualane¦q	N	–rup, –rit
persualiu¦ppaa	V	–tinngilaa
persuanartuerut¦ippaa	V	{–inngilaa, –sinngilaa, –itinngilaa}
persu¦aq	N	–up, –it
persuarnart¦oq	N	–up, –ut
persua¦rpaa	V	–nngilaa
persuarsiorpalaart¦oq	N	–up, –ut
persuarsi¦orpalaartoq	N	{–orpalaartup, –upalaartup}, {–orpalaartut, –upalaartut}
persuarsi¦orpoq	V	–unngilaq
persu¦ppaa	V	–tinngilaa
persuttaane¦q	N	–rup, –rit
persuttaanne¦q	N	–rup, –rit
persuttaasarne¦q	N	–rup, –rit
persuttaasimas¦oq	N	–up, –ut
persuttagaas¦oq	N	–up, –ut
persutta¦rpaa	V	–nngilaa
persuu¦ppaa	V	–tinngilaa
persuusiar¦aa	V	–inngilaa
persuusiari¦voq	V	–nngilaq
persuussa¦q	N	–p, –t
pertanngu¦aq	N	–up, –it
perta¦q	N	–p, –t
pert¦erpaa	V	–inngilaa
pertiteqqissaa¦rpaa	V	–nngilaa
pertit¦erpaa	V	–inngilaa
pertiti¦gaq	N	–kkap, –kkat
pertujaa¦ppoq	V	–nngilaq
pertujaavi¦ppoq	V	–nngilaq
pertujasorujussuu¦voq	V	–nngilaq
pertujasorujussu¦uvoq	V	{–aanngilaq, –unngilaq}
pertuja¦voq	V	–nngilaq
peru	N	–p, –t
peru¦aa	V	–nngilaa
peru¦erpaa	V	–inngilaa
peru¦erpoq	V	–inngilaq
peruersi¦ppaa	V	–nngilaa
peruers¦oorpoq	V	–uunngilaq
perug¦aa	V	–inngilaa
perugiti¦ppaa	V	–nngilaa
peruia¦rpaa	V	–nngilaa
peru¦iarpaa	V	{–ajanngilaa, –ianngilaa}
perujuia¦rpaa	V	–nngilaa
peruju¦k	N	–up, –it
perujuni¦ppoq	V	–nngilaq
peruki¦ppoq	V	–nngilaq
perullu¦k	N	–up, –it
perulluliorne¦q	N	–rup, –rit
perulluli¦orpoq	V	–unngilaq
perulluliortitsis¦oq	N	–up, –ut
perulluliort¦oq	N	–up, –ut
perulukkunnaa¦rpoq	V	–nngilaq
perulu¦ppoq	V	–nngilaq
peruluut	N	–ip, –it
peruluutaanngits¦oq	N	–up, –ut
peruluutaa¦voq	V	–nngilaq
perusaa¦rpoq	V	–nngilaq
perusaa¦voq	V	–nngilaq
perusa¦q	N	–p, –t
peru¦seq	N	–tsip, –tsit
peruseqaqaaq	V	(no generation)
perusi¦voq	V	–nngilaq
perusoqanngilaq	V	(no generation)
perusoqanngissu¦seq	N	–tsip, –tsit
perusoqanngits¦oq	N	–up, –ut
perusu¦erpoq	V	–inngilaq
perusuersa¦rpoq	V	–nngilaq
perusuersartarfi¦k	N	–up, –it
perusuersartariaqal¦erpoq	V	–inngilaq
perusuisa¦ppoq	V	–nngilaq
perusuivi¦ppoq	V	–nngilaq
perusukkunnaanngilaq	V	(no generation)
perusungaart¦oq	N	–up, –ut
peru¦sungaartoq	N	{–sungaartup, –tungaartup}, {–sungaartut, –tungaartut}
perusu¦ppoq	V	–nngilaq
perusussu¦seq	N	–tsip, –tsit
peru¦sussuseq	N	{–sussutsip, –tussutsip}, {–sussutsit, –tussutsit}
perusutt¦oq	N	–up, –ut
perusuttua¦rpoq	V	–nngilaq
peruti¦ppoq	V	–nngilaq
peruttorfi¦k	N	–up, –it
peruttulerfi¦k	N	–up, –it
peruttul¦erpoq	V	–inngilaq
peruugaa¦voq	V	–nngilaq
peruu¦gaq	N	–kkap, –kkat
peruusaa¦rpoq	V	–nngilaq
peruusa¦rpoq	V	–nngilaq
peruu¦voq	V	–nngilaq
petruuliu	N	–p, –t
pi	N	–p, {–it, –t}
piaa¦ppoq	V	–nngilaq
piaaqqusia¦q	N	–p, –t
piaaqqusiar¦aa	V	–inngilaa
piaar¦aaq	V	–inngilaq
piaaralun¦eerpoq	V	–iinngilaq
piaaraluneersima¦voq	V	–nngilaq
piaaraluniinngilaq	V	(no generation)
piaariits¦oorpoq	V	–uunngilaq
piaarinaats¦oorpoq	V	–uunngilaq
piaarine¦q	N	–rup, –rit
piaarinngilaq	V	(no generation)
piaari¦voq	V	–nngilaq
piaarpallaanngilaq	V	(no generation)
piaarpallaaqaaq	V	(no generation)
piaa¦rpoq	V	–nngilaq
piaart¦oq	N	–up, –ut
pialuit	N, pl.	-
pianersaa¦voq	V	–nngilaq
piaqqeri¦voq	V	–nngilaq
piaqqi¦orpoq	V	–unngilaq
piaqqisa¦rpoq	V	–nngilaq
piaqqivi¦k	N	–up, –it
piaqqi¦voq	V	–nngilaq
piaraa¦voq	V	–nngilaq
piaral¦ik	N	{–iup, –lip, –lup}, –lit
pia¦raq	N	–qqap, –qqat
piaravi¦k	N	–up, –it
piar¦eerpaa	V	–iinngilaa
piar¦eerpoq	V	–iinngilaq
piareersaane¦q	N	–rup, –rit
piareersaasart¦oq	N	–up, –ut
piareersaas¦oq	N	–up, –ut
piareersaat	N	–ip, –it
piareersaataas¦oq	N	–up, –ut
piareersaatit	N, pl.	-
piareersaa¦voq	V	–nngilaq
piareersarluagaas¦oq	N	–up, –ut
piareersarne¦q	N	–rup, –rit
piareersa¦rpaa	V	–nngilaa
piareersa¦rpoq	V	–nngilaq
piareersarsimas¦oq	N	–up, –ut
piareersimaanna¦rpoq	V	–nngilaq
piareersimane¦q	N	–rup, –rit
piareersimas¦oq	N	–up, –ut
piareersimatitsine¦q	N	–rup, –rit
piareersima¦voq	V	–nngilaq
piariinngikkallarpoq	V	(no generation)
piarsuit	N, pl.	-
piarsu¦k	N	–up, –it
piarsunngu¦aq	N	–up, –it
piartorne¦q	N	–rup, –rit
piart¦orpoq	V	–unngilaq
piartorti¦ppaa	V	–nngilaa
piartortuarsinnarpoq	V	(no generation)
piartuut	N	–ip, –it
piartuutaa¦voq	V	–nngilaq
piartuutig¦aa	V	–inngilaa
piartuutigiinna¦rpaa	V	–nngilaa
piavallaanngilaq	V	(no generation)
piffeeru¦ppaa	V	–tinngilaa
piffeerutivi¦ppaa	V	–nngilaa
piffeerut¦ivippaa	V	{–ivinngilaa, –sivinngilaa}
piffeqanngilaq	V	(no generation)
piffigeqqusa¦q	N	–p, –t
piffi¦k	N	–up, –it
piffilerut	N	–ip, –it
piffissaajaat	N	–ip, –it
piffissaajarna¦rpoq	V	–nngilaq
piffissaaleqine¦q	N	–rup, –rit
piffissaaleqi¦voq	V	–nngilaq
piffissaanngilaq	V	(no generation)
piffissaanngits¦oq	N	–up, –ut
piffissaaru¦ppoq	V	–tinngilaq
piffissaasua¦voq	V	–nngilaq
piffissakkaart¦oq	N	–up, –ut
piffissalerii¦gaq	N	–kkap, –kkat
piffissalersu¦gaq	N	–kkap, –kkat
piffissaler¦suussineq	N	{–suussinerup, –tuussinerup}, {–suussinerit, –tuussinerit}
piffissaliine¦q	N	–rup, –rit
piffissanngulinnginnerpoq	V	(no generation)
piffissa¦q	N	–p, –t
piffissaqanngilaq	V	(no generation)
piffissaqa¦rpoq	V	–nngilaq
piffissaqarti¦ppaa	V	–nngilaa
piffissaritita¦q	N	–p, –t
piffissinngilaa	V	(no generation)
piffiunngilaq	V	(no generation)
piffiu¦voq	V	–nngilaq
pig¦aa	V	–inngilaa
pigaa¦ppaa	V	–tinngilaa
pigaa¦q	N	–p, –t
pigaarfi¦k	N	–up, –it
pigaarne¦q	N	–rup, –rit
pigaarpallaaqaaq	V	(no generation)
pigaa¦rpoq	V	–nngilaq
pigaart¦oq	N	–up, –ut
pigaartuune¦q	N	–rup, –rit
pigaartuus¦oq	N	–up, –ut
pigaassis¦oq	N	–up, –ut
pigaassi¦voq	V	–nngilaq
pigaju¦ppoq	V	–nngilaq
pigajutt¦oq	N	–up, –ut
pigaluartaa¦voq	V	–nngilaq
pigaluarta¦q	N	–p, –t
pigasaa¦rpoq	V	–nngilaq
pigerii¦gaq	N	–kkap, –kkat
pigganne¦q	N	–rup, –rit
pigga¦ppaa	V	–tinngilaa
piggart¦ooq	N	–uup, –uut
piggartoorsu¦aq	N	–up, –it
piggartuallaaqaaq	V	(no generation)
piggartunersaa¦voq	V	–nngilaq
piggartu¦voq	V	–nngilaq
piggassa¦q	N	–p, –t
piggassine¦q	N	–rup, –rit
piggassi¦vik	N	{–ffiup, –viup}, {–ffiit, –viit}
piggassi¦voq	V	–nngilaq
piggata¦q	N	–p, –t
piggatig¦aa	V	–inngilaa
piggattuarpaa	V	(no generation)
pigil¦erpaa	V	–inngilaa
pigiliukkiart¦orpaa	V	–unngilaa
pigiliu¦ppaa	V	–tinngilaa
pigiliussa¦q	N	–p, –t
pigiliussine¦q	N	–rup, –rit
pigiliussi¦voq	V	–nngilaq
pigineqanngits¦oq	N	–up, –ut
pigineqa¦rpoq	V	–nngilaq
pigineqart¦oq	N	–up, –ut
piginnaaffigisa¦q	N	–p, –t
piginnaalaa¦rpoq	V	–nngilaq
piginnaallua¦rpoq	V	–nngilaq
piginnaaneerut¦sippaa	V	{–inngilaa, –sinngilaa, –itinngilaa}
piginnaane¦q	N	–rup, –rit
piginnaaneqaler¦sippaa	V	{–sinngilaa, –tinngilaa}
piginnaaneqarfi¦k	N	–up, –it
piginnaaneqarne¦q	N	–rup, –rit
piginnaanersaa¦voq	V	–nngilaq
piginnaanert¦ooq	N	–uup, –uut
piginnaanertoqaaq	V	(no generation)
piginnaanertu¦voq	V	–nngilaq
piginnaanikitsuu¦voq	V	–nngilaq
piginnaaniligaane¦q	N	–rup, –rit
piginnaaniligaas¦oq	N	–up, –ut
piginnaanil¦ik	N	{–iup, –lip, –lup}, –lit
piginnaanilissu¦aq	N	–up, –it
piginnaanng¦orpoq	V	–unngilaq
piginnaanngorsaaqqinne¦q	N	–rup, –rit
piginnaanngorsaaqqi¦ssut	N, pl.	{–ssut, –ttut}
piginnaanngorsaqqiine¦q	N	–rup, –rit
piginnaanngorsaqqinne¦q	N	–rup, –rit
piginnaanngorsarne¦q	N	–rup, –rit
piginnaanngorsa¦rpaa	V	–nngilaa
piginnaanngorsa¦rpoq	V	–nngilaq
piginnaasali¦gaq	N	–kkap, –kkat
piginnaasa¦q	N	–p, –t
piginnaasaqarfi¦k	N	–up, –it
piginnaasaqarne¦q	N	–rup, –rit
piginnaasaqarneruler¦sitsiniarneq	N	{–sitsiniarnerup, –titsiniarnerup}, {–sitsiniarnerit, –titsiniarnerit}
piginnaasaqassu¦seq	N	–tsip, –tsit
piginnaas¦oq	N	–up, –ut
piginnaassu¦seq	N	–tsip, –tsit
piginnaassuseqaqaaq	V	(no generation)
piginnaassuseqarlua¦rpoq	V	–nngilaq
piginnaassuseqarluart¦oq	N	–up, –ut
piginnaassuseqarne¦q	N	–rup, –rit
piginnaassuseqartitaane¦q	N	–rup, –rit
piginnaassuseqartitaas¦oq	N	–up, –ut
piginnaassuseqartitaassut	N	–ip, –it
piginnaassuseqartuune¦q	N	–rup, –rit
piginnaassusiligaassut	N	–ip, –it
piginnaatinneqarne¦q	N	–rup, –rit
piginnaati¦ppaa	V	–nngilaa
piginnaatitaaffeqarne¦q	N	–rup, –rit
piginnaatitaaffiit	N, pl.	-
piginnaatitaaffi¦k	N	–up, –it
piginnaatitaane¦q	N	–rup, –rit
piginnaatitaas¦oq	N	–up, –ut
piginnaatita¦q	N	–p, –t
piginnaatitsine¦q	N	–rup, –rit
piginnaatitsissut	N	–ip, –it
piginnaa¦voq	V	–nngilaq
piginneqataas¦oq	N	–up, –ut
piginneqataassut	N	–ip, –it
piginneqataassuteqarne¦q	N	–rup, –rit
piginneqataassutil¦ik	N	{–iup, –lip, –lup}, –lit
piginneqataavi¦ssut	N, pl.	{–ssut, –ttut}
piginneqateqarne¦q	N	–rup, –rit
piginneqatigiiffiit	N, pl.	-
piginneqatigiiffi¦k	N	–up, –it
piginneqatigiit	N, pl.	-
piginngilaa	V	(no generation)
piginnilerne¦q	N	–rup, –rit
piginninne¦q	N	–rup, –rit
piginni¦ppoq	V	–nngilaq
piginnittooqataane¦q	N	–rup, –rit
piginnitt¦oq	N	–up, –ut
piginnittussaane¦q	N	–rup, –rit
piginnittussaassu¦seq	N	–tsip, –tsit
piginnittussaatitaane¦q	N	–rup, –rit
piginnittuune¦q	N	–rup, –rit
piginnittuusinnaane¦q	N	–rup, –rit
piginnittuussu¦seq	N	–tsip, –tsit
pigi¦ppoq	V	–nngilaq
pigisaats¦oq	N	–up, –ut
pigisa¦q	N	–p, –t
pigisaqanngits¦oq	N	–up, –ut
pigisaqaqaaq	V	(no generation)
pigisaqaqatigiinne¦q	N	–rup, –rit
pigisaqarne¦q	N	–rup, –rit
pigisaqart¦oq	N	–up, –ut
pigisassanngorti¦ppaa	V	–nngilaa
pigisassanngortitsine¦q	N	–rup, –rit
pigisat	N, pl.	-
pigissaa¦rpoq	V	–nngilaq
pigissaart¦oq	N	–up, –ut
pigi¦ssaartoq	N	{–ssaartup, –ttaartup}, {–ssaartut, –ttaartut}
pigissaartuunngits¦oq	N	–up, –ut
pigi¦ssaartuunngitsoq	N	{–ssaartuunngitsup, –ttaartuunngitsup}, {–ssaartuunngitsut, –ttaartuunngitsut}
pigissaartuu¦voq	V	–nngilaq
pigi¦ssaartuuvoq	V	{–ssaartuunngilaq, –ttaartuunngilaq}
pigissiart¦orpoq	V	–unngilaq
pigissi¦voq	V	–nngilaq
pigiti¦ppaa	V	–nngilaa
pigitita¦q	N	–p, –t
pigiumajunnaarpaa	V	(no generation)
pigiunnaarniarpaa	V	(no generation)
pigiunnaa¦rpaa	V	–nngilaa
pigu¦erpoq	V	–inngilaq
piguersaatig¦aa	V	–inngilaa
piguer¦saatigaa	V	{–saatiginngilaa, –taatiginngilaa}
pigu¦ppoq	V	–nngilaq
piguttua¦rpoq	V	–nngilaq
piiaaffig¦aa	V	–inngilaa
piiaaffigillu¦innarpaa	V	{–aannanngilaa, –innanngilaa}
piiaaffiginninne¦q	N	–rup, –rit
piiaaffi¦k	N	–up, –it
piiaaginna¦rpoq	V	–nngilaq
piiaalluinna¦rpoq	V	–nngilaq
piiaane¦q	N	–rup, –rit
piiaa¦ppoq	V	–nngilaq
piiaas¦oq	N	–up, –ut
piiaasussaatitaane¦q	N	–rup, –rit
piiaat	N	–ip, –it
piiaataa¦voq	V	–nngilaq
piiaatig¦aa	V	–inngilaa
piiaatigiinna¦rpaa	V	–nngilaa
piiaa¦vik	N	{–ffiup, –viup}, {–ffiit, –viit}
piiaa¦voq	V	–nngilaq
piia¦gaq	N	–kkap, –kkat
piiagassa¦q	N	–p, –t
piiaqaaq	V	(no generation)
piia¦rpaa	V	–nngilaa
piiartuarpaa	V	(no generation)
piia¦voq	V	–nngilaq
piigaa¦voq	V	–nngilaq
piikulasuunngilaq	V	(no generation)
piikula¦voq	V	–nngilaq
piikulla¦ppoq	V	–nngilaq
piikullatsi¦ppaa	V	–nngilaa
piilatsinaqaaq	V	(no generation)
piilatsinngilaq	V	(no generation)
piilatsi¦voq	V	–nngilaq
piillas¦oq	N	–up, –ut
piillasu¦k	N	–up, –it
piinaalutaa¦voq	V	–nngilaq
piinaalut¦aq	N	{–ap, –tap}, {–at, –tat}
piinaalutar¦aa	V	–inngilaa
piinsi	N	–p, –t
piinsilerisut	N, pl.	-
piinsisi¦orpoq	V	–unngilaq
piinsisiut	N	–ip, –it
piinsisiutaa¦voq	V	–nngilaq
piipipiarsu¦k	N	–up, –it
piisaarfi¦k	N	–up, –it
piisaarnaqaaq	V	(no generation)
piisaarna¦rpoq	V	–nngilaq
piisaarne¦q	N	–rup, –rit
piisaarnersu¦aq	N	–up, –it
piisaarpallaarne¦q	N	–rup, –rit
piisaa¦rpoq	V	–nngilaq
piisaartorsu¦aq	N	–up, –it
piisaartorsu¦uvoq	V	{–aanngilaq, –unngilaq}
piisa¦ppoq	V	–nngilaq
piisatsi¦ppoq	V	–nngilaq
piisatsivi¦ppoq	V	–nngilaq
pi¦it	N, pl.	{–it, –t}
piitaajuinnersaa¦voq	V	–nngilaq
piitaajui¦ppoq	V	–nngilaq
piitaajuissu¦seq	N	–tsip, –tsit
piitaajuits¦oq	N	–up, –ut
piitaalliorfig¦aa	V	–inngilaa
piitaalli¦orpoq	V	–unngilaq
piitaalliortaanna¦rpoq	V	–nngilaq
piitaanna¦rpoq	V	–nngilaq
piitaa¦ppoq	V	–nngilaq
piitaarsorfig¦aa	V	–inngilaa
piitaarsorne¦q	N	–rup, –rit
piitaars¦orpoq	V	–unngilaq
piitaarsorumat¦ooq	N	–uup, –uut
piitaats¦oq	N	–up, –ut
piitaatsuunngilaq	V	(no generation)
piitaatsuunngits¦oq	N	–up, –ut
piitangeraluttuinna¦rpoq	V	–nngilaq
piitang¦erpoq	V	–inngilaq
piitangissutig¦aa	V	–inngilaa
piitanngatig¦aa	V	–inngilaa
piitsak¦oq	N	–up, –ut
piitsakorsi¦orpoq	V	–unngilaq
piits¦oq	N	–up, –ut
piitsoqarfi¦k	N	–up, –it
piitsoqqi¦k	N	–up, –it
piitsorsuu¦voq	V	–nngilaq
piitsorsu¦uvoq	V	{–aanngilaq, –unngilaq}
piitsuiu¦voq	V	–nngilaq
piitsunngornik¦oq	N	–up, –ut
piitsunngu¦aq	N	–up, –it
piitsuune¦q	N	–rup, –rit
piitsuussu¦seq	N	–tsip, –tsit
piitsuu¦voq	V	–nngilaq
pikaalaqaaq	V	(no generation)
pikaala¦voq	V	–nngilaq
pikallisaa¦voq	V	–nngilaq
pikallisig¦aa	V	–inngilaa
pikalli¦sigaa	V	–tiginngilaa
pikallisit	N, pl.	-
pikalli¦t	N	–sip, –sit
pikalli¦voq	V	–nngilaq
pikanii¦ppoq	V	–nngilaq
pikanii¦tippaa	V	{–sinngilaa, –tinngilaa, –tsinngilaa}
pikaniitt¦oq	N	–up, –ut
pikas¦eerpaa	V	–iinngilaa
pikataa¦ppaa	V	–tinngilaa
pikataavallaaqaaq	V	(no generation)
pikataa¦voq	V	–nngilaq
pikata¦k	N	–ap, –at
pikata¦ppoq	V	–nngilaq
pikatassu¦aq	N	–up, –it
pikatsivig¦aa	V	–inngilaa
pikatsi¦voq	V	–nngilaq
pikeria¦rpoq	V	–nngilaq
pikerujuppoq	V	(no generation)
pikialaarne¦q	N	–rup, –rit
pikialaa¦rpoq	V	–nngilaq
pikialaartitsine¦q	N	–rup, –rit
pikiala¦voq	V	–nngilaq
pikia¦rpoq	V	–nngilaq
pikiarsaa¦rpoq	V	–nngilaq
pikila¦voq	V	–nngilaq
pikil¦erpoq	V	–inngilaq
pikine¦q	N	–rup, –rit
piki¦ppoq	V	–nngilaq
pikisuu¦voq	V	–nngilaq
piki¦tsippaa	V	{–ssinngilaa, –tsinngilaa}
pikitsitsigajussu¦seq	N	–tsip, –tsit
piki¦tsitsigajussuseq	N	{–ssitsigajussutsip, –tsitsigajussutsip}, {–ssitsigajussutsit, –tsitsigajussutsit}
pikitsitsilerne¦q	N	–rup, –rit
piki¦tsitsilerneq	N	{–ssitsilernerup, –tsitsilernerup}, {–ssitsilernerit, –tsitsilernerit}
pikitsitsine¦q	N	–rup, –rit
piki¦tsitsineq	N	{–ssitsinerup, –tsitsinerup}, {–ssitsinerit, –tsitsinerit}
pikitsitsinia¦q	N	–p, –t
piki¦tsitsiniaq	N	{–ssitsiniap, –tsitsiniap}, {–ssitsiniat, –tsitsiniat}
pikitsitsis¦oq	N	–up, –ut
piki¦tsitsisoq	N	{–ssitsisup, –tsitsisup}, {–ssitsisut, –tsitsisut}
pikitsitsi¦voq	V	–nngilaq
piki¦tsitsivoq	V	{–ssitsinngilaq, –tsitsinngilaq}
pikittorujussuu¦voq	V	–nngilaq
pikittorujussu¦uvoq	V	{–aanngilaq, –unngilaq}
piki¦ttorujussuuvoq	V	{–ssorujussuaanngilaq, –ssorujussuunngilaq, –ttorujussuaanngilaq, –ttorujussuunngilaq}
pikittuaanna¦rpoq	V	–nngilaq
pikiu¦ppaa	V	–tinngilaa
pikiussi¦voq	V	–nngilaq
piki¦voq	V	–nngilaq
pikkaa¦voq	V	–nngilaq
pikkagaa¦voq	V	–nngilaq
pikkalua¦rpaa	V	–nngilaa
pikkaluarta¦q	N	–p, –t
pikkari¦ppoq	V	–nngilaq
pikkarissaa¦rpoq	V	–nngilaq
pikkarissi¦voq	V	–nngilaq
pikkarli¦orpoq	V	–unngilaq
pikkarliortaanna¦rpoq	V	–nngilaq
pikka¦rpaa	V	–nngilaa
pikka¦rpoq	V	–nngilaq
pikkataa¦rpoq	V	–nngilaq
pikkattaat	N	–ip, –it
pikkattaataa¦voq	V	–nngilaq
pikkattaatig¦aa	V	–inngilaa
pikk¦eerpaa	V	–iinngilaa
pikk¦eq	N	–ip, –it
pikkiliallappoq	V	(no generation)
pikkinanngits¦oq	N	–up, –ut
pikkina¦rpoq	V	–nngilaq
pikki¦ppaa	V	–nngilaa
pikki¦vaa	V	–nngilaa
pikkivi¦k	N	–up, –it
pikkorilluinnarpoq	V	(no generation)
pikkorilluinnart¦oq	N	–up, –ut
pikkorinnera¦rpaa	V	–nngilaa
pikkorinnersa¦q	N	–p, –t
pikkori¦ppoq	V	–nngilaq
pikkorissaa¦rpoq	V	–nngilaq
pikkorissarne¦q	N	–rup, –rit
pikkori¦ssarneq	N	{–ssarnerup, –ttarnerup}, {–ssarnerit, –ttarnerit}
pikkori¦ssarpoq	V	–ttanngilaq
pikkorissi¦voq	V	–nngilaq
pikkori¦ssoq	N	{–ssup, –ttup}, {–ssut, –ttut}
pikkorissu¦seq	N	–tsip, –tsit
pikkorissuseqarne¦q	N	–rup, –rit
pikkori¦ssuugaluarpoq	V	{–ssuugaluanngilaq, –ttuugaluanngilaq}
pikkorliorajuppoq	V	(no generation)
pikkorliorne¦q	N	–rup, –rit
pikkorli¦orpoq	V	–unngilaq
pikkorliortua¦rpoq	V	–nngilaq
pikkorlu¦ppoq	V	–nngilaq
pikkorlussi¦voq	V	–nngilaq
pikkorlutt¦oq	N	–up, –ut
pikkorluttuiu¦voq	V	–nngilaq
pikkorluttuu¦voq	V	–nngilaq
pikku	Pron, pl.	–a
pikkug¦aa	V	–inngilaa
pikkuginngilaa	V	(no generation)
pikkulu¦erpoq	V	–inngilaq
pikkuluersaa¦rpoq	V	–nngilaq
pikkuminaqaaq	V	(no generation)
pikkumina¦rpoq	V	–nngilaq
pikkunaalli¦orpoq	V	–unngilaq
pikkunaalli¦voq	V	–nngilaq
pikkunaa¦ppoq	V	–nngilaq
pikkunaat	N	–ip, –it
pikkunaataa¦voq	V	–nngilaq
pikkunaatig¦aa	V	–inngilaa
pikkunaats¦oorpoq	V	–uunngilaq
pikkunaats¦oq	N	–up, –ut
pikkunar¦aa	V	–inngilaa
pikkuna¦rpoq	V	–nngilaq
pikkunarsaa¦rpaa	V	–nngilaa
pikkunarsaa¦rpoq	V	–nngilaq
pikkunarsi¦voq	V	–nngilaq
pikkunart¦oq	N	–up, –ut
pikkunartort¦orpoq	V	–unngilaq
pikkunartor¦torpoq	V	{–sunngilaq, –tunngilaq}
pikkunassu¦seq	N	–tsip, –tsit
pikku¦ppaa	V	–nngilaa
pikku¦ppoq	V	–nngilaq
pikkus¦erpoq	V	–inngilaq
pikku¦serpoq	V	{–sinngilaq, –tilinngilaq}
pikkuserujussua¦rpoq	V	–nngilaq
pikkusu¦ppoq	V	–nngilaq
pikkusuttorujussuu¦voq	V	–nngilaq
pikkusuttorujussu¦uvoq	V	{–aanngilaq, –unngilaq}
pikkusuutig¦aa	V	–inngilaa
pikkut	N	–ip, –it
pikkutaa¦voq	V	–nngilaq
pikkutig¦aa	V	–inngilaa
pikkutiui¦ppoq	V	–nngilaq
pikkutiuits¦oq	N	–up, –ut
pikkutsaataa¦voq	V	–nngilaq
pikkutsaatig¦aa	V	–inngilaa
pikkutsaatiginngilaa	V	(no generation)
pikkutsajui¦ppoq	V	–nngilaq
pikkutsanne¦q	N	–rup, –rit
pikkutsa¦ppoq	V	–nngilaq
pikkuttaanna¦rpoq	V	–nngilaq
pikoorfi¦k	N	–up, –it
pik¦oorpoq	V	–uunngilaq
pik¦oq	N	–up, –ut
pikoqaqaaq	V	(no generation)
pikor¦aa	V	–inngilaa
piku	N	–p, –t
pikug¦aa	V	–inngilaa
pikull¦erpoq	V	–inngilaq
pikullersaanna¦rpoq	V	–nngilaq
pikulu¦k	N	–up, –it
pikulukkunnaa¦rpoq	V	–nngilaq
pikulu¦ppoq	V	–nngilaq
pikulussu¦aq	N	–up, –it
pikuluttaanna¦rpoq	V	–nngilaq
pikungaanna¦rpoq	V	–nngilaq
pikungakaa¦ppaa	V	–tinngilaa
pikungakaassi¦voq	V	–nngilaq
pikunnaa¦ppaa	V	–tinngilaa
pikunna¦rpoq	V	–nngilaq
pikunnerarpaa	V	(no generation)
pikunn¦erpaa	V	–inngilaa
pikunnga¦rpoq	V	–nngilaq
pikunng¦orpoq	V	–unngilaq
piku¦ppaa	V	–nngilaa
pikusu¦k	N	–up, –it
pikuunaqqu¦ppoq	V	–tinngilaq
pikuu¦voq	V	–nngilaq
pilaakk¦erpoq	V	–inngilaq
pilaane¦q	N	–rup, –rit
pilaa¦ppoq	V	–tinngilaq
pilaa¦q	N	–p, –t
pilaarnaqaaq	V	(no generation)
pilaarpallaanngilaq	V	(no generation)
pilaa¦rpoq	V	–nngilaq
pilaarti¦ppaa	V	–nngilaa
pilaart¦oq	N	–up, –ut
pilaaru¦ppaa	V	–tinngilaa
pilaarussi¦voq	V	–nngilaq
pilaatal¦ik	N	{–iup, –lip, –lup}, –lit
pilaat¦aq	N	{–ap, –tap}, {–at, –tat}
pilaatsi¦ppoq	V	–nngilaq
pilaatt¦oorpoq	V	–uunngilaq
pilaa¦voq	V	–nngilaq
pilaffi¦k	N	–up, –it
pila¦gaq	N	–kkap, –kkat
pilagassaaru¦ppoq	V	–tinngilaq
pilakataa¦rpoq	V	–nngilaq
pilakkia¦rpoq	V	–nngilaq
pilanga¦voq	V	–nngilaq
pilanne¦q	N	–rup, –rit
pila¦ppaa	V	–nngilaa
pila¦ppoq	V	–nngilaq
pilarrartu¦voq	V	–nngilaq
pilassi¦vaa	V	–nngilaa
pilassi¦voq	V	–nngilaq
pilatsi¦ppoq	V	–nngilaq
pilattaane¦q	N	–rup, –rit
pilattaanna¦rpoq	V	–nngilaq
pilattaasarfi¦k	N	–up, –it
pilattaasart¦oq	N	–up, –ut
pilattaa¦voq	V	–nngilaq
pilatta¦rpaa	V	–nngilaa
pilattorfi¦k	N	–up, –it
pilattorne¦q	N	–rup, –rit
pilattornerlukut	N, pl.	-
pilatt¦orpaa	V	–unngilaa
pilatt¦orpoq	V	–unngilaq
pilattorti¦ppoq	V	–nngilaq
pilattugaane¦q	N	–rup, –rit
pilattu¦gaq	N	–kkap, –kkat
pilattugassarsi¦voq	V	–nngilaq
pilattuine¦q	N	–rup, –rit
pilattui¦voq	V	–nngilaq
pilattuus¦erpoq	V	–inngilaq
pilattuu¦serpoq	V	{–sinngilaq, –tilinngilaq}
pilattuussu¦aq	N	–up, –it
pilattuut	N	–ip, –it
pilattuutee¦raq	N	–qqap, –qqat
pilattuutissaqqi¦ppoq	V	–nngilaq
pileqqaa¦q	N	–p, –t
pileqqaarpaa	V	(no generation)
pileqqaa¦rpoq	V	–nngilaq
pileqqaat	N	–ip, –it
pileqqaat	N, pl.	-
piler¦aaq	V	–inngilaq
pileraluttuinna¦rpoq	V	–nngilaq
pilerfi¦k	N	–up, –it
pilerfius¦oq	N	–up, –ut
pileriallarpaa	V	(no generation)
pileria¦rpaa	V	–nngilaa
pileriartorne¦q	N	–rup, –rit
pilerig¦aa	V	–inngilaa
pilerigeqaa	V	(no generation)
pilerigisa¦q	N	–p, –t
pilerinanngikkaluaqaaq	V	(no generation)
pilerinaraluaqaaq	V	(no generation)
pilerina¦rpoq	V	–nngilaq
pilerinart¦oq	N	–up, –ut
pilerinassu¦seq	N	–tsip, –tsit
pilerisaarine¦q	N	–rup, –rit
pilerisaa¦rpaa	V	–nngilaa
pilerisaarut	N	–ip, –it
pilerisaarutig¦aa	V	–inngilaa
pilerisaarutiginni¦ppoq	V	–nngilaq
pileris¦oq	N	–up, –ut
pilerissu¦seq	N	–tsip, –tsit
pilerisu¦ppoq	V	–nngilaq
pilerit¦ooq	N	–uup, –uut
pileritsaa¦ppaa	V	–tinngilaa
pileritsanne¦q	N	–rup, –rit
pileritsa¦ppoq	V	–nngilaq
pileritsatsinnia¦rpaa	V	–nngilaa
pileritsatsitsisuu¦voq	V	–nngilaq
pileritsattaleraluttuinnarpoq	V	(no generation)
pileritt¦orpoq	V	–unngilaq
pilerituallaanngilaq	V	(no generation)
pilerituuallaa¦rpoq	V	–nngilaq
pilerituuallaart¦oq	N	–up, –ut
pilerituu¦voq	V	–nngilaq
pileritu¦voq	V	–nngilaq
pileri¦voq	V	–nngilaq
pilerlaaju¦voq	V	–nngilaq
pilerlaa¦q	N	–p, –t
pilerlaas¦oq	N	–up, –ut
pilerlaavallaa¦rpoq	V	–nngilaq
pilerlaa¦voq	V	–nngilaq
pilerngune¦q	N	–rup, –rit
pilerngunneqart¦oq	N	–up, –ut
pilerngu¦ppaa	V	–tinngilaa
pilerngussaa¦voq	V	–nngilaq
pilerngussi¦voq	V	–nngilaq
pilerngut¦ooq	N	–uup, –uut
pilerngu¦voq	V	–nngilaq
pilernune¦q	N	–rup, –rit
pilernu¦ppaa	V	–tinngilaa
pilernussaassutig¦aa	V	–inngilaa
pilernussaa¦voq	V	–nngilaq
pilernussi¦voq	V	–nngilaq
pilernut¦ooq	N	–uup, –uut
pilernutu¦voq	V	–nngilaq
pilernu¦voq	V	–nngilaq
pil¦erpaa	V	–inngilaa
pil¦erpoq	V	–inngilaq
pilersaanngilaq	V	(no generation)
pilersaaqatigiipiloqataas¦oq	N	–up, –ut
piler¦saaqatigiipiloqataasoq	N	{–saaqatigiipiloqataasup, –taaqatigiipiloqataasup}, {–saaqatigiipiloqataasut, –taaqatigiipiloqataasut}
pilersaaqatigiipilunne¦q	N	–rup, –rit
piler¦saaqatigiipilunneq	N	{–saaqatigiipilunnerup, –taaqatigiipilunnerup}, {–saaqatigiipilunnerit, –taaqatigiipilunnerit}
pilersaaqatigiipiluttoqarsorinninne¦q	N	–rup, –rit
piler¦saaqatigiipiluttoqarsorinninneq	N	{–saaqatigiipiluttoqarsorinninnerup, –taaqatigiipiluttoqarsorinninnerup}, {–saaqatigiipiluttoqarsorinninnerit, –taaqatigiipiluttoqarsorinninnerit}
pilersaarfig¦aa	V	–inngilaa
piler¦saarfigaa	V	{–saarfiginngilaa, –taarfiginngilaa}
pilersaa¦rpoq	V	–nngilaq
pilersaarusia¦q	N	–p, –t
pilersaaru¦siaq	N	{–siap, –tiliap}, {–siat, –tiliat}
pilersaarusioriaa¦seq	N	–tsip, –tsit
pilersaarusiorne¦q	N	–rup, –rit
pilersaarusi¦orpaa	V	–unngilaa
pilersaarusiortarfi¦k	N	–up, –it
pilersaarussu¦aq	N	–up, –it
pilersaarut	N	–ip, –it
pilersaarutaas¦oq	N	–up, –ut
pilersaarutaa¦voq	V	–nngilaq
pilersaarutig¦aa	V	–inngilaa
pilerseqqi¦ppaa	V	–nngilaa
pilersikkaluttuarpaa	V	(no generation)
piler¦sinneqarlaaq	N	{–sinneqarlaap, –tinneqarlaap}, {–sinneqarlaat, –tinneqarlaat}
piler¦sinneqarpoq	V	{–sinneqanngilaq, –tinneqanngilaq}
piler¦sinneqarsinnaavoq	V	{–sinneqarsinnaanngilaq, –tinneqarsinnaanngilaq}
piler¦sippaa	V	{–sinngilaa, –tinngilaa}
piler¦sitaaqqammersoq	N	{–sitaaqqammersup, –sitaaqqammertup, –titaaqqammersup, –titaaqqammertup}, {–sitaaqqammersut, –sitaaqqammertut, –titaaqqammersut, –titaaqqammertut}
piler¦sitaasoq	N	{–sitaasup, –titaasup}, {–sitaasut, –titaasut}
piler¦sitaq	N	{–sitap, –titap}, {–sitat, –titat}
piler¦sitaqarluartoq	N	{–sitaqarluartup, –titaqarluartup}, {–sitaqarluartut, –titaqarluartut}
piler¦sitseqataasoq	N	{–sitseqataasup, –titseqataasup, –siteqataasup}, {–sitseqataasut, –titseqataasut, –siteqataasut}
piler¦sitseqqinneq	N	{–sitseqqinnerup, –titseqqinnerup}, {–sitseqqinnerit, –titseqqinnerit}
piler¦sitsineq	N	{–sitsinerup, –titsinerup}, {–sitsinerit, –titsinerit}
piler¦sitsinissaq	N	{–sitsinissap, –titsinissap}, {–sitsinissat, –titsinissat}
piler¦sitsisinnaasoq	N	{–sitsisinnaasup, –titsisinnaasup}, {–sitsisinnaasut, –titsisinnaasut}
piler¦sitsisinnaassuseq	N	{–sitsisinnaassutsip, –titsisinnaassutsip}, {–sitsisinnaassutsit, –titsisinnaassutsit}
piler¦sitsisoq	N	{–sitsisup, –titsisup}, {–sitsisut, –titsisut}
piler¦sitsivoq	V	{–sitsinngilaq, –titsinngilaq}
pilersoqatigii¦ttussaatitaaneq	N	{–ssussaatitaanerup, –ttussaatitaanerup}, {–ssussaatitaanerit, –ttussaatitaanerit}
piler¦soqatigiittussaatitaaneq	N	{–soqatigiissussaatitaanerup, –soqatigiittussaatitaanerup, –toqatigiissussaatitaanerup, –toqatigiittussaatitaanerup}, {–soqatigiissussaatitaanerit, –soqatigiittussaatitaanerit, –toqatigiissussaatitaanerit, –toqatigiittussaatitaanerit}
pilersorneqarne¦q	N	–rup, –rit
pilers¦orpaa	V	–unngilaa
pilersorpoq	V	(no generation)
pilersortariaqa¦rpaa	V	–nngilaa
pilersu¦gaq	N	–kkap, –kkat
Pilersuiffi¦k	N	–up, –it
pilersuine¦q	N	–rup, –rit
pilersuis¦oq	N	–up, –ut
pilersuisussaane¦q	N	–rup, –rit
pilersuisussaatitaane¦q	N	–rup, –rit
pilersuisuunngits¦oq	N	–up, –ut
piler¦suisuunngitsoq	N	{–suisuunngitsup, –tuisuunngitsup}, {–suisuunngitsut, –tuisuunngitsut}
pil¦ersuisuunngitsoq	N	{–ersuisuunngitsup, –issuisuunngitsup}, {–ersuisuunngitsut, –issuisuunngitsut}
pilersui¦vik	N	{–ffiup, –viup}, {–ffiit, –viit}
pilersui¦voq	V	–nngilaq
pilersussa¦vaa	V	–nngilaa
pilersuu¦ppaa	V	–tinngilaa
pilersuu¦ppoq	V	–tinngilaq
pilersuussi¦voq	V	–nngilaq
piler¦suussivoq	V	{–suussinngilaq, –tuussinngilaq}
pilersuut	N	–ip, –it
piler¦suut	N	{–suutip, –tuutip}, {–suutit, –tuutit}
pilersuutaaru¦ppoq	V	–tinngilaq
piler¦suutaaruppoq	V	{–suutaarutinngilaq, –tuutaarutinngilaq}
pilersuutig¦aa	V	–inngilaa
piler¦suutigaa	V	{–suutiginngilaa, –tuutiginngilaa}
pilersuutinngilaa	V	(no generation)
pilersuutissaaru¦ppoq	V	–tinngilaq
piler¦suutissaaruppoq	V	{–suutissaarutinngilaq, –tuutissaarutinngilaq}
pilertorna¦rpoq	V	–nngilaq
pilert¦orpaa	V	–unngilaa
pilert¦orpoq	V	–unngilaq
pilertorsinnaa¦voq	V	–nngilaq
pilertortitsiniarne¦q	N	–rup, –rit
pilertort¦oq	N	–up, –ut
pilertussu¦seq	N	–tsip, –tsit
piliapilu¦k	N	–up, –it
pilia¦q	N	–p, –t
piliaqaqaaq	V	(no generation)
piliar¦aa	V	–inngilaa
piliarinnitt¦oq	N	–up, –ut
piliartu¦voq	V	–nngilaq
piliat	N, pl.	-
pil¦ik	N	{–iup, –lip, –lup}, –lit
pilikaa¦q	N	–p, –t
pilikakkajuppoq	V	(no generation)
pilikanne¦q	N	–rup, –rit
pilika¦ppoq	V	–nngilaq
pilikkat	N	–ip, –it
pilikkat	N, pl.	-
pilikkataa¦voq	V	–nngilaq
pilikkatig¦aa	V	–inngilaa
pilikki	N	(no generation)
pilikkiiaavik	N	(no generation)
pilikkilivi¦k	N	–up, –it
pilikkiusaq	N	(no generation)
pilimaniart¦oq	N	–up, –ut
pilimas¦oq	N	–up, –ut
pilimasuu¦voq	V	–nngilaq
pilima¦voq	V	–nngilaq
pilinia¦rpoq	V	–nngilaq
piliorfi¦k	N	–up, –it
piliorne¦q	N	–rup, –rit
pili¦orpoq	V	–unngilaq
piliort¦oq	N	–up, –ut
pili¦ppaa	V	–nngilaa
pilissu¦aq	N	–up, –it
pil¦issuaq	N	{–ersuup, –issuup}, {–ersuit, –issuit}
pilissu¦ppaa	V	–tinngilaa
pilissuu¦voq	V	–nngilaq
pilissu¦uvoq	V	{–aanngilaq, –unngilaq}
pil¦issuuvoq	V	{–ersuaanngilaq, –ersuunngilaq, –issuaanngilaq, –issuunngilaq}
pilittaa¦voq	V	–nngilaq
pilit¦taavoq	V	{–aanngilaq, –taanngilaq}
pilitta¦q	N	–p, –t
pilit¦taq	N	{–ap, –tap}, {–at, –tat}
piliumat¦ooq	N	–uup, –uut
piliu¦ppaa	V	–tinngilaa
piliussaa¦voq	V	–nngilaq
piliuss¦orpaa	V	–unngilaa
pilivi¦k	N	–up, –it
pili¦voq	V	–nngilaq
pillaane¦q	N	–rup, –rit
pillaa¦serpaa	V	{–sinngilaa, –tilinngilaa}
pillaat	N	–ip, –it
pillaataa¦voq	V	–nngilaq
pillagaane¦q	N	–rup, –rit
pillagaa¦voq	V	–nngilaq
pilla¦gaq	N	–kkap, –kkat
pillagassaajunnaar¦sippaa	V	{–sinngilaa, –tinngilaa}
pillagassaatitaas¦oq	N	–up, –ut
pillagassaatitaa¦voq	V	–nngilaq
pillagassaatita¦q	N	–p, –t
pillagassaa¦voq	V	–nngilaq
pillagassa¦q	N	–p, –t
pillagiaaru¦ppoq	V	–tinngilaq
pillagiilli¦voq	V	–nngilaq
pillagii¦ppoq	V	–nngilaq
pillagunaatig¦aa	V	–inngilaa
pillaguna¦rpoq	V	–nngilaq
pillagunart¦oq	N	–up, –ut
pillagunartorsu¦uvoq	V	{–aanngilaq, –unngilaq}
pillak¦oq	N	–up, –ut
pillammaa¦voq	V	–nngilaq
pillamma¦k	N	–ap, –at
pillammassu¦aq	N	–up, –it
pillaqqi¦ppoq	V	–nngilaq
pillaqqu¦aa	V	–nngilaa
pillarluk¦oq	N	–up, –ut
pillarlukoqaqaaq	V	(no generation)
pillarluku	N	–p, –t
pillarneqaat	N	–ip, –it
pillarneqaataasussa¦q	N	–p, –t
pillarneqaqqu¦aa	V	–nngilaa
pillarneqa¦rpoq	V	–nngilaq
pilla¦rpaa	V	–nngilaa
pillartaannarpaa	V	(no generation)
pillarti¦ppoq	V	–nngilaq
pillas¦erpaa	V	–inngilaa
pilla¦serpaa	V	{–sinngilaa, –tilinngilaa}
pillas¦erpoq	V	–inngilaq
pilla¦serpoq	V	{–sinngilaq, –tilinngilaq}
pillat	N	–ip, –it
pillatig¦aa	V	–inngilaa
pillatissa¦q	N	–p, –t
pillatsiaat	N	–ip, –it
pillatsiaataa¦voq	V	–nngilaq
pillatsia¦rpaa	V	–nngilaa
pillattaa¦rpoq	V	–nngilaq
pillattaart¦oq	N	–up, –ut
pillattaarutig¦aa	V	–inngilaa
pillequjaa¦q	N	–p, –t
pillequjaarsu¦aq	N	–up, –it
pillequjaavi¦k	N	–up, –it
pillequjaa¦voq	V	–nngilaq
pillerfig¦aa	V	–inngilaa
pillerorne¦q	N	–rup, –rit
piller¦orpoq	V	–unngilaq
pillerorsima¦voq	V	–nngilaq
pillerort¦oq	N	–up, –ut
pill¦erpaa	V	–inngilaa
pill¦erpoq	V	–inngilaq
pillersaat	N	–ip, –it
piller¦saat	N	{–saatip, –taatip}, {–saatit, –taatit}
pillersaataa¦voq	V	–nngilaq
piller¦saataavoq	V	{–saataanngilaq, –taataanngilaq}
pillersa¦rpoq	V	–nngilaq
pillersuutsajas¦oq	N	–up, –ut
pillersuutsaja¦voq	V	–nngilaq
pillersuutsa¦ppoq	V	–nngilaq
pillertaanna¦rpoq	V	–nngilaq
pillerta¦q	N	–p, –t
pilli	N	–p, –t
pilliaa¦voq	V	–nngilaq
pillia¦q	N	–p, –t
pilliar¦aa	V	–inngilaa
pilliarisaa¦voq	V	–nngilaq
pillia¦rpoq	V	–nngilaq
pilliassa¦q	N	–p, –t
pilliine¦q	N	–rup, –rit
pilliivi¦k	N	–up, –it
pillii¦vik	N	{–ffiup, –viup}, {–ffiit, –viit}
pillii¦voq	V	–nngilaq
pillingaarine¦q	N	–rup, –rit
pillingaarnia¦rpaa	V	–nngilaa
pillingaarnia¦rpoq	V	–nngilaq
pillingaa¦rpaa	V	–nngilaa
pillingaa¦rpoq	V	–nngilaq
pillingaarsar¦aa	V	–inngilaa
pillingaatig¦aa	V	–inngilaa
pillingajaa¦voq	V	–nngilaq
pillingaja¦k	N	–ap, –at
pillinngaters¦orpoq	V	–unngilaq
pilli¦orpoq	V	–unngilaq
pillitsinaqaaq	V	(no generation)
pillitsi¦voq	V	–nngilaq
pilliunne¦q	N	–rup, –rit
pilliu¦ppoq	V	–tinngilaq
pilliut	N	–ip, –it
pilliutaa¦voq	V	–nngilaq
pilliutig¦aa	V	–inngilaa
pilliutig¦aaq	V	–inngilaq
pilliutiinna¦rpoq	V	–nngilaq
pilliut¦iinnarpoq	V	{–iinnanngilaq, –siinnanngilaq}
pilliutissa¦q	N	–p, –t
pilliu¦voq	V	–nngilaq
pilloqutsinaqaaq	V	(no generation)
pilloqutsi¦vaa	V	–nngilaa
pilloqutsi¦voq	V	–nngilaq
pillori¦ppoq	V	–nngilaq
pillorissaa¦rpoq	V	–nngilaq
pillorissaas¦oq	N	–up, –ut
pillorissi¦voq	V	–nngilaq
pilluaa¦ppoq	V	–nngilaq
pilluaat	N	–ip, –it
pilluaataa¦voq	V	–nngilaq
pilluaatig¦aa	V	–inngilaa
pilluaatsuiu¦voq	V	–nngilaq
pilluaatsuu¦voq	V	–nngilaq
pilluagu¦ppoq	V	–nngilaq
pilluanngilaq	V	(no generation)
pilluaqqu¦aa	V	–nngilaa
pilluaqqusiartort¦oq	N	–up, –ut
pilluaqqusine¦q	N	–rup, –rit
pilluaqqusis¦oq	N	–up, –ut
pilluaqqusi¦voq	V	–nngilaq
pilluaqqussut	N	–ip, –it
pilluaqqussuteqarne¦q	N	–rup, –rit
pilluarfi¦k	N	–up, –it
pilluarna¦rpoq	V	–nngilaq
pilluarne¦q	N	–rup, –rit
Pilluarneq Ersigiunnaarpara	Prop	–p
pilluarnera¦rpaa	V	–nngilaa
pillua¦rpoq	V	–nngilaq
pilluarsa¦rpaa	V	–nngilaa
pilluarti¦ppaa	V	–nngilaa
pilluassu¦seq	N	–tsip, –tsit
pilluataa¦rpoq	V	–nngilaq
pilluigaju¦ppoq	V	–nngilaq
pillui¦voq	V	–nngilaq
pillukaassi¦vaa	V	–nngilaa
pillukaa¦voq	V	–nngilaq
pillukarne¦q	N	–rup, –rit
pilluka¦rpaa	V	–nngilaa
pilluka¦rpoq	V	–nngilaq
pillukarti¦ppaa	V	–nngilaa
pillukartitsine¦q	N	–rup, –rit
pillungajappoq	V	(no generation)
pillu¦ppaa	V	–tinngilaa
pillu¦ppoq	V	–nngilaq
pillutsi¦ppaa	V	–nngilaa
pillut¦sippaa	V	{–sinngilaa, –itinngilaa}
pilluttoorne¦q	N	–rup, –rit
pillutt¦oq	N	–up, –ut
pilluut	N	–ip, –it
pilluutaa¦voq	V	–nngilaq
pilluutig¦aa	V	–inngilaa
piloqu¦serpaa	V	{–sinngilaa, –tilinngilaa}
piloqut	N	–ip, –it
piloqutit	N, pl.	-
pilorsu¦aq	N	–up, –it
pilorsuit	N, pl.	-
piluar¦aa	V	–inngilaa
piluarisa¦q	N	–p, –t
pilua¦rpoq	V	–nngilaq
piluartarne¦q	N	–rup, –rit
piluart¦oq	N	–up, –ut
piluka¦ppoq	V	–nngilaq
pilukkunnaa¦rpoq	V	–nngilaq
pilulia¦rpoq	V	–nngilaq
pilu¦ppoq	V	–nngilaq
pilussinna¦rpoq	V	–nngilaq
pilutakkaa¦q	N	–p, –t
Pilut¦aq	N	{–ap, –tap}, {–at, –tat}
pilut¦aq	N	{–ap, –tap}, {–at, –tat}
pilutaqal¦erpoq	V	–inngilaq
pilutaria¦rpoq	V	–nngilaq
pilutarmiu	N	–p, –t
piluta¦rpoq	V	–nngilaq
pilutart¦ooq	N	–uup, –uut
piluttaa¦rpoq	V	–nngilaq
pilut¦tat	N, pl.	{–at, –tat}
piluttuaanna¦rpoq	V	–nngilaq
piluusaarpoq	V	(no generation)
piluusat	N, pl.	-
pimaa¦rpoq	V	–nngilaq
pimaartaanna¦rpoq	V	–nngilaq
pimas¦oq	N	–up, –ut
pima¦voq	V	–nngilaq
pim¦eerpoq	V	{–iinngilaq, –inngaanniinngilaq}
pim¦eerpoq	V	–iinngilaq
pimiusorsuu¦voq	V	–nngilaq
pimiusorsu¦uvoq	V	{–aanngilaq, –unngilaq}
pimiu¦voq	V	–nngilaq
pimmaasaa¦rpoq	V	–nngilaq
pimmaa¦voq	V	–nngilaq
pimmag¦aa	V	–inngilaa
pimmaginngilaa	V	(no generation)
pimmaginngisa¦q	N	–p, –t
pimma¦k	N	–ap, –at
pimmars¦orpoq	V	–unngilaq
pimmassu¦aq	N	–up, –it
pimmat	N	–ip, –it
pimmataa¦voq	V	–nngilaq
pimmatig¦aa	V	–inngilaa
pimmatiginninne¦q	N	–rup, –rit
pimmati¦ginninneq	N	{–ginninnerup, –lliinerup}, {–ginninnerit, –lliinerit}
pimooru¦ppaa	V	–tinngilaa
pimoorussilaarusuppoq	V	(no generation)
pimoorussine¦q	N	–rup, –rit
pimoorussis¦oq	N	–up, –ut
pinaaffig¦aa	V	–inngilaa
pinaaffigiuarpaa	V	(no generation)
pinaakkajuppoq	V	(no generation)
pinaa¦ppoq	V	–nngilaq
pinaaserne¦q	N	–rup, –rit
pinaas¦erpoq	V	–inngilaq
pinaassutig¦aa	V	–inngilaa
pinaats¦oq	N	–up, –ut
pinaava¦rpoq	V	–nngilaq
pinanngits¦oq	N	–up, –ut
pina¦rpoq	V	–nngilaq
pinart¦oq	N	–up, –ut
pinartoqanngilaq	V	(no generation)
pinasaanngilaq	V	(no generation)
pinasaa¦rpoq	V	–nngilaq
pinasua¦rpoq	V	–nngilaq
pinasuartariaqart¦oq	N	–up, –ut
pinasuartart¦oq	N	–up, –ut
pinasuart¦oq	N	–up, –ut
pinasugitsaatig¦aa	V	–inngilaa
pinasugitsa¦ppoq	V	–nngilaq
pinattori¦ppoq	V	–nngilaq
pinattorissuu¦voq	V	–nngilaq
pinattori¦ssuuvoq	V	{–ssuunngilaq, –ttuunngilaq}
pinattorlu¦ppoq	V	–nngilaq
pinaveersaalerne¦q	N	–rup, –rit
pinaveersaarne¦q	N	–rup, –rit
pinaveer¦saarneq	N	{–saarnerup, –taarnerup}, {–saarnerit, –taarnerit}
pinaveersaa¦rpaa	V	–nngilaa
pinaveersaa¦rpoq	V	–nngilaq
pinaveersaarti¦ppaa	V	–nngilaa
pinaveersaartitsine¦q	N	–rup, –rit
pinaveersaartitsiniarne¦q	N	–rup, –rit
pinaveersaartitsiniutit	N, pl.	-
pinaveersaartitsi¦voq	V	–nngilaq
pinaveersaart¦oq	N	–up, –ut
pinaveer¦saartoq	N	{–saartup, –taartup}, {–saartut, –taartut}
pinavianngilaq	V	(no generation)
pinavia¦rpoq	V	–nngilaq
pine¦q	N	–rup, –rit
pineqaat	N	–ip, –it
pineqaataasinnaas¦oq	N	–up, –ut
pineqaatissartal¦erpaa	V	–inngilaa
pineqaatissiine¦q	N	–rup, –rit
pineqaatiss¦iineq	N	{–aliinerup, –iinerup}, {–aliinerit, –iinerit}
pineqaatissiissut	N	–ip, –it
pineqaatiss¦iissut	N	{–aliissutip, –iissutip}, {–aliissutit, –iissutit}
pineqaatissiissutaa¦voq	V	–nngilaq
pineqaatiss¦iissutaavoq	V	{–aliissutaanngilaq, –iissutaanngilaq}
pineqaatiss¦iivigaa	V	{–aliiffiginngilaa, –aliiviginngilaa, –iiffiginngilaa, –iiviginngilaa}
pineqaatiss¦iivik	N	{–aliiffiup, –aliiviup, –iiffiup, –iiviup}, {–aliiffiit, –aliiviit, –iiffiit, –iiviit}
pineqaatissinneqarsimas¦oq	N	–up, –ut
pineqaatissinneqart¦oq	N	–up, –ut
pineqarne¦q	N	–rup, –rit
pineqa¦rpoq	V	–nngilaq
pineqartaali¦vaa	V	–nngilaa
pineqart¦oq	N	–up, –ut
pineqartui¦k	N	–up, –it
pineqattaali¦vaa	V	–nngilaa
pinerliine¦q	N	–rup, –rit
pinerlineqanngits¦oq	N	–up, –ut
pinerlineqart¦oq	N	–up, –ut
pinerlinia¦rpaa	V	–nngilaa
pinerli¦orpoq	V	–unngilaq
pinerliort¦oq	N	–up, –ut
pinerlitsaali¦vaa	V	–nngilaa
pinerli¦vaa	V	–nngilaa
pinerli¦voq	V	–nngilaq
pinerluffig¦aa	V	–inngilaa
pinerluk¦oq	N	–up, –ut
pinerlunne¦q	N	–rup, –rit
pinerlunnersu¦aq	N	–up, –it
pinerlunneru¦voq	V	–nngilaq
pinerlunniaqatigiit	N, pl.	-
pinerlu¦ppoq	V	–nngilaq
pinerluttaali¦sitsiniarneq	N	{–sitsiniarnerup, –titsiniarnerup}, {–sitsiniarnerit, –titsiniarnerit}
pinerluttaalisitsis¦oq	N	–up, –ut
pinerluttaali¦sitsisoq	N	{–sitsisup, –titsisup}, {–sitsisut, –titsisut}
pinerluttaalisitsisut	N, pl.	-
pinerluttaali¦sitsisut	N, pl.	{–sitsisut, –titsisut}
pinerluttaali¦vaa	V	–nngilaa
pinerlutt¦oq	N	–up, –ut
pinerluttorsi¦orpoq	V	–unngilaq
pinerluttulerine¦q	N	–rup, –rit
pinerluttulersaarut	N	–ip, –it
pinerluttulersaarutit	N, pl.	-
pinerluttuliorne¦q	N	–rup, –rit
pinerluttuliortarne¦q	N	–rup, –rit
pinerluttuliort¦oq	N	–up, –ut
pinerluttuusorineqart¦oq	N	–up, –ut
pinerluttuusorisa¦q	N	–p, –t
pinerluusi¦orpoq	V	–unngilaq
pinerluu¦siorpoq	V	{–siunngilaq, –tiliunngilaq}
pinerluut	N	–ip, –it
pinerluutaa¦voq	V	–nngilaq
pinerluuteqangaart¦oq	N	–up, –ut
pinerluuteqanngits¦oq	N	–up, –ut
pinerluuteqarsimas¦oq	N	–up, –ut
pin¦erpaa	V	–inngilaa
pinerpoq	V	(no generation)
pinerrari¦ppoq	V	–nngilaq
pinerrarlu¦ppoq	V	–nngilaq
pinerrarlussi¦voq	V	–nngilaq
pinerrarluttuu¦voq	V	–nngilaq
pinert¦ooq	N	–uup, –uut
pinertoorsuu¦voq	V	–nngilaq
pinertoorsu¦uvoq	V	{–aanngilaq, –unngilaq}
pinert¦orpoq	V	–unngilaq
pinertuallaanngilaq	V	(no generation)
pinertune¦q	N	–rup, –rit
pinertusaallaqqi¦ppoq	V	–nngilaq
pinertusaa¦rpoq	V	–nngilaq
pinertussu¦seq	N	–tsip, –tsit
pinertu¦voq	V	–nngilaq
pingaakuju¦ppoq	V	–nngilaq
pingaakujutt¦oq	N	–up, –ut
pingaakujuutig¦aa	V	–inngilaa
pingaanngilaq	V	(no generation)
pingaannginnerus¦oq	N	–up, –ut
pingaanngits¦oq	N	–up, –ut
pingaanngivallaaqaaq	V	(no generation)
pingaarluinnart¦oq	N	–up, –ut
pingaarnaa¦ppoq	V	–nngilaq
pingaarne¦q	N	–rup, –rit
pingaarnerpaa¦q	N	–p, –t
pingaarnerpaa¦tinneqartuartariaqartoq	N	{–jutinneqartuartariaqartup, –jutinneqatuartariaqartup, –tinneqartuartariaqartup, –tinneqatuartariaqartup}, {–jutinneqartuartariaqartut, –jutinneqatuartariaqartut, –tinneqartuartariaqartut, –tinneqatuartariaqartut}
pingaarnersiuinna¦gaq	N	–kkap, –kkat
pingaarnerullu¦innartoq	N	{–aannartup, –innartup}, {–aannartut, –innartut}
pingaarnerus¦oq	N	–up, –ut
pingaarnerusorine¦q	N	–rup, –rit
pingaarnerussu¦seq	N	–tsip, –tsit
pingaarneruti¦ppaa	V	–nngilaa
pingaarnerutitsine¦q	N	–rup, –rit
pingaarneru¦voq	V	–nngilaq
pingaarnia¦rpoq	V	–nngilaq
pingaarniart¦oq	N	–up, –ut
pingaarniartuunngissu¦seq	N	–tsip, –tsit
pingaarniartuunngits¦oq	N	–up, –ut
pingaarniut	N	–ip, –it
pingaa¦rpoq	V	–nngilaq
pingaartinnart¦oq	N	–up, –ut
pingaartinneqa¦rpoq	V	–nngilaq
pingaarti¦ppaa	V	–nngilaa
pingaartita¦q	N	–p, –t
pingaartitsingaarne¦q	N	–rup, –rit
pingaartitsis¦oq	N	–up, –ut
pingaartitsi¦voq	V	–nngilaq
pingaart¦oq	N	–up, –ut
pingaartorsi¦orpoq	V	–unngilaq
pingaartorsiort¦oq	N	–up, –ut
pingaartorsuu¦voq	V	–nngilaq
pingaartorsu¦uvoq	V	{–aanngilaq, –unngilaq}
pingaartutuaas¦oq	N	–up, –ut
pingaartuu¦voq	V	–nngilaq
pingaaruteqannginnerus¦oq	N	–up, –ut
pingaaruteqanngits¦oq	N	–up, –ut
pingaaruteqarnerpaa¦q	N	–p, –t
pingaaruteqa¦rpoq	V	–nngilaq
pingaaruteqart¦oq	N	–up, –ut
pingaaruteqassu¦seq	N	–tsip, –tsit
pingaarutil¦ik	N	{–iup, –lip, –lup}, –lit
pingaassu¦seq	N	–tsip, –tsit
pingaj¦oq	N	–up, –ut
pingajoqqat	N, pl.	-
pingajoraa¦rpoq	V	–nngilaq
pingajoraat	N	–ip, –it
pingajorarterut	N	–ip, –it
pingajussaan¦eerpaa	V	–iinngilaa
pingajussaan¦eerpoq	V	{–iinngilaq, –inngaanniinngilaq}
pingajussaan¦eerpoq	V	–iinngilaq
pingajussaanerpoq	V	(no generation)
pingajussaat	N	–ip, –it
pingarngutu¦voq	V	–nngilaq
pingarnutu¦voq	V	–nngilaq
pingas¦ooq	N	–uup, –uut
pingasoraa¦rpoq	V	–nngilaq
pingasoria¦rpaa	V	–nngilaa
pingasorusat	N, pl.	-
pingasuli¦aq	N	{–ap, –ssap}, {–at, –ssat}
pingasuli¦at	N, pl.	{–at, –ssat}
pingasul¦ik	N	{–iup, –lip, –lup}, –lit
pingasulissat	N, pl.	-
pingasuli¦ssat	N, pl.	{–at, –ssat}
pingasunngorne¦q	N	–rup, –rit
pingasunngorneru¦voq	V	–nngilaq
pingasunngornikkut	N, pl.	-
pingasunng¦orpoq	V	–unngilaq
pingasunngort¦oq	N	–up, –ut
pingasut	Num, pl.	-
pingatsii¦voq	V	–nngilaq
pingatsiu¦ppaa	V	–tinngilaa
ping¦eq	N	–ip, –it
pinginnaa¦rpaa	V	–nngilaa
pinginnaars¦orpaa	V	–unngilaa
pingoorneqa¦rpoq	V	–nngilaq
ping¦oorpaa	V	–uunngilaa
pingoqa¦rpoq	V	–nngilaq
ping¦orpoq	V	–unngilaq
pingorsu¦aq	N	–up, –it
pingort¦oorpoq	V	–uunngilaq
pingu	N	–p, –t
pingu¦aa	V	–nngilaa
pinguja¦k	N	–ap, –at
pinguja¦q	N	–rup, –rit
pinguja¦rpaa	V	–nngilaa
pingunngu¦aq	N	–up, –it
pingunnguaqa¦rpoq	V	–nngilaq
pingu¦ppaa	V	–nngilaa
pingusa¦rpaa	V	–nngilaa
pingusine¦q	N	–rup, –rit
pingusinert¦ooq	N	–uup, –uut
pingusi¦voq	V	–nngilaq
pingutsi¦ppoq	V	–nngilaq
pinguttaa¦voq	V	–nngilaq
pingutta¦k	N	–ap, –at
pinguttanngu¦aq	N	–up, –it
pinguttaqaqaaq	V	(no generation)
pingutta¦rpaa	V	–nngilaa
piniaa¦q	N	–p, –t
piniaar¦aa	V	–inngilaa
piniaarisaa¦voq	V	–nngilaq
piniaa¦seq	N	–tsip, –tsit
piniaaseqa¦rpoq	V	–nngilaq
pinia¦gaq	N	–kkap, –kkat
piniagassaarukkiart¦orpoq	V	–unngilaq
piniagassaaru¦ppoq	V	–tinngilaq
piniagassa¦q	N	–p, –t
piniagassat	N, pl.	-
piniakkersaarajuppoq	V	(no generation)
piniakkersaa¦rpoq	V	–nngilaq
pinialu¦ppoq	V	–nngilaq
pinialuttart¦oq	N	–up, –ut
piniaqqissaart¦oq	N	–up, –ut
piniaqqusaanngiffi¦k	N	–up, –it
piniarfi¦k	N	–up, –it
piniariarfi¦k	N	–up, –it
piniariarne¦q	N	–rup, –rit
piniaria¦rpoq	V	–nngilaq
piniariartarfi¦k	N	–up, –it
piniarlua¦rpoq	V	–nngilaq
piniarluart¦oq	N	–up, –ut
piniarne¦q	N	–rup, –rit
piniarniarfi¦k	N	–up, –it
piniarnilersaarut	N	–ip, –it
piniarnilersaarutit	N, pl.	-
pinia¦rpaa	V	–nngilaa
pinia¦rpoq	V	–nngilaq
piniarsaar¦aa	V	–inngilaa
piniarsar¦aa	V	–inngilaa
piniarsarinni¦ppoq	V	–nngilaq
piniartaa¦voq	V	–nngilaq
piniarteqa¦rpoq	V	–nngilaq
piniarti	N	–p, –t
piniartig¦aa	V	–inngilaa
piniartiu¦voq	V	–nngilaq
piniart¦oq	N	–up, –ut
piniartoqarfi¦k	N	–up, –it
piniartorsu¦aq	N	–up, –it
piniartuune¦q	N	–rup, –rit
piniataa¦rpoq	V	–nngilaq
pinikkaluttuinna¦rpoq	V	–nngilaq
pinissaaru¦ppoq	V	–tinngilaq
pinissarsi¦voq	V	–nngilaq
pinissarta¦rpoq	V	–nngilaq
pinissat	N, pl.	-
pinissia¦rpoq	V	–nngilaq
pinissiartaanna¦rpoq	V	–nngilaq
pinissiarti¦ppaa	V	–nngilaa
piniu¦ppaa	V	–tinngilaa
piniussaa¦voq	V	–nngilaq
piniussine¦q	N	–rup, –rit
piniussis¦oq	N	–up, –ut
piniussi¦voq	V	–nngilaq
piniut	N	–ip, –it
piniutaars¦erpoq	V	–inngilaq
piniutaa¦voq	V	–nngilaq
piniutilu¦ppoq	V	–nngilaq
piniutissaa¦rpaa	V	–nngilaa
pinnaanne¦q	N	–rup, –rit
pinnapia¦rpaa	V	–nngilaa
pinna¦ppoq	V	–nngilaq
pinnar¦aa	V	–inngilaa
pinnarina¦rpoq	V	–nngilaq
pinnarits¦erpoq	V	–inngilaq
pinnarivi¦ppaa	V	–nngilaa
pinnarna¦q	N	–rup, –rit
pinnarsa¦rpoq	V	–nngilaq
pinnars¦orpaa	V	–unngilaa
pinnasu¦ppaa	V	–tinngilaa
pinnasu¦ppoq	V	–nngilaq
pinnata¦q	N	–p, –t
pinnattaa¦q	N	–p, –t
pinnatt¦oq	N	–up, –ut
pinnattori¦ppoq	V	–nngilaq
pinne¦q	N	–rup, –rit
pinneqaaq	V	(no generation)
pinnequtig¦aa	V	–inngilaa
pinnerluinnarpoq	V	(no generation)
pinnerluinnart¦oq	N	–up, –ut
pinnernar¦aa	V	–inngilaa
pinnerneqqisaanne¦q	N	–rup, –rit
pinn¦erpoq	V	–inngilaq
pinnersaaqqu¦sersorpaa	V	{–sersunngilaa, –tilersunngilaa}
pinnersaaqqut	N	–ip, –it
pinnersaas¦erpoq	V	–inngilaq
pinnersaa¦serpoq	V	{–sinngilaq, –tilinngilaq}
pinner¦saaserpoq	V	{–saasinngilaq, –saatilinngilaq, –taasinngilaq, –taatilinngilaq}
pinnersaasiassa¦q	N	–p, –t
pinnersaa¦siassaq	N	{–siassap, –tiliassap}, {–siassat, –tiliassat}
pinner¦saasiassaq	N	{–saasiassap, –saatiliassap, –taasiassap, –taatiliassap}, {–saasiassat, –saatiliassat, –taasiassat, –taatiliassat}
pinnersaasiassat	N, pl.	-
pinnersaa¦siassat	N, pl.	{–siassat, –tiliassat}
pinner¦saasiassat	N, pl.	{–saasiassat, –saatiliassat, –taasiassat, –taatiliassat}
pinnersaat	N	–ip, –it
pinner¦saat	N	{–saatip, –taatip}, {–saatit, –taatit}
pinnersaatissat	N, pl.	-
pinner¦saatissat	N, pl.	{–saatissat, –taatissat}
pinnersaa¦voq	V	–nngilaq
pinnersa¦rpaa	V	–nngilaa
pinnersa¦rpoq	V	–nngilaq
pinnersi¦voq	V	–nngilaq
pinner¦soq	N	{–sup, –tup}, {–sut, –tut}
pinner¦sorsuaq	N	{–sorsuup, –torsuup}, {–sorsuit, –torsuit}
pinner¦sortaarukkiartorneq	N	{–sortaarukkiartornerup, –tortaarukkiartornerup}, {–sortaarukkiartornerit, –tortaarukkiartornerit}
pinner¦sortaarutilerneq	N	{–sortaarutilernerup, –tortaarutilernerup, –sortaarutsilernerup, –tortaarutsilernerup, –sortaarusernerup, –tortaarusernerup}, {–sortaarutilernerit, –tortaarutilernerit, –sortaarutsilernerit, –tortaarutsilernerit, –sortaarusernerit, –tortaarusernerit}
pi¦nnga	Pron	–ssuma, {–kku, –kkua}
pinngannannia¦rpoq	V	–nngilaq
pinngars¦orpoq	V	–unngilaq
pinngernaveersaarne¦q	N	–rup, –rit
pinngernaveersaart¦oq	N	–up, –ut
pinngilaq	V	(no generation)
pinngisaa¦ppoq	V	{–nngilaq, –tinngilaq}
pinngisinnia¦rpaa	V	–nngilaa
pinngitsaaliine¦q	N	–rup, –rit
pinngitsaaliisaanna¦rpoq	V	–nngilaq
pinngitsaaliissut	N	–ip, –it
pinngitsaalii¦voq	V	–nngilaq
pinngitsaalisaane¦q	N	–rup, –rit
pinngitsaalisaannginne¦q	N	–rup, –rit
pinngitsaalisaa¦voq	V	–nngilaq
pinngitsaalisa¦q	N	–p, –t
pinngitsaali¦vaa	V	–nngilaa
pinngitsaalivi¦ppaa	V	–nngilaa
pinngitsoorne¦q	N	–rup, –rit
pinngits¦oorpaa	V	–uunngilaa
pinngits¦oorpoq	V	–uunngilaq
pinngitsoorsinnaatitaane¦q	N	–rup, –rit
pinngitsoorti¦ppaa	V	–nngilaa
pinngitsoortitaa¦voq	V	–nngilaq
pinngitsoortitsine¦q	N	–rup, –rit
pinngitsoortitsiniarne¦q	N	–rup, –rit
pinngits¦oq	N	–up, –ut
pinngitsorsiut	N	–ip, –it
pinngitsorsiutaas¦oq	N	–up, –ut
pinngitsuuine¦q	N	–rup, –rit
pinngitsuuisinnaajunnaaqataas¦oq	N	–up, –ut
pinngitsuuisinnaajunnaarne¦q	N	–rup, –rit
pinngitsuunera¦rpaa	V	–nngilaa
pinngitsuunerarpoq	V	(no generation)
pinngitsuusaa¦rpoq	V	–nngilaq
pinngitsuus¦oq	N	–up, –ut
pinngitsuussu¦seq	N	–tsip, –tsit
pinngitsuuti¦ppaa	V	–nngilaa
pinngitsuutitaasimas¦oq	N	–up, –ut
pinngitsuutitaa¦voq	V	–nngilaq
pinngitsuutitsine¦q	N	–rup, –rit
pinngitsuu¦voq	V	–nngilaq
pinngoqqaart¦oq	N	–up, –ut
pinngoqqaat	N	–ip, –it
pinngoqqaatit	N, pl.	-
pinngorfi¦k	N	–up, –it
pinngoriartorne¦q	N	–rup, –rit
pinngoriartuaarpoq	V	(no generation)
pinngoriartuaarsimavoq	V	(no generation)
pinng¦orpoq	V	–unngilaq
pinngorsarfi¦k	N	–up, –it
pinngorsa¦rpaa	V	–nngilaa
pinngorsima¦voq	V	–nngilaq
pinngorti¦ppaa	V	–nngilaa
pinngortitaane¦q	N	–rup, –rit
Pinngortitaleriffi¦k	N	–up, –it
Pinngortitaleriffi¦k	Prop	–up, –it
pinngortitaleriffi¦k	N	–up, –it
pinngortitaleris¦oq	N	–up, –ut
pinngortita¦q	N	–p, –t
pinngortitarsu¦aq	N	–up, –it
pinngortitsine¦q	N	–rup, –rit
Pinngortitsis¦oq	N	–up, –ut
pinngortitsis¦oq	N	–up, –ut
pinngort¦oorpoq	V	–uunngilaq
pinngortussa¦q	N	–p, –t
pinnguaasi¦orpoq	V	–unngilaq
pinnguaa¦siorpoq	V	{–siunngilaq, –tiliunngilaq}
pinnguaat	N	–ip, –it
pinnguaatili¦orpoq	V	–unngilaq
pinnguaa¦tiliorpoq	V	{–siunngilaq, –tiliunngilaq}
pinnguajaa¦q	N	–p, –t
pinnguajaa¦rpoq	V	–nngilaq
pinngu¦aq	N	–ssap, –ssat
pinnguaqatig¦aa	V	–inngilaa
pinnguar¦aa	V	–inngilaa
pinnguarfissa¦q	N	–p, –t
pinnguarne¦q	N	–rup, –rit
pinnguarpallaaqaaq	V	(no generation)
pinngua¦rpoq	V	–nngilaq
pinnguartarfi¦k	N	–up, –it
pinnguarumatoqaaq	V	(no generation)
pinnguisitsi¦voq	V	–nngilaq
pinngui¦sitsivoq	V	{–sitsinngilaq, –titsinngilaq}
pinngui¦vaa	V	–nngilaa
pinngui¦voq	V	–nngilaq
pinngunart¦oq	N	–up, –ut
pinngussi¦orpoq	V	–unngilaq
pinngussiortaanna¦rpoq	V	–nngilaq
pinngussiortuu¦voq	V	–nngilaq
pinnguukkiart¦orpoq	V	–unngilaq
pinnguu¦ppoq	V	–tinngilaq
pinnguutivi¦ppoq	V	–nngilaq
pinngu¦voq	V	–nngilaq
pinniig¦aa	V	–inngilaa
pinniigisaa¦voq	V	–nngilaq
pinniigivi¦ppaa	V	–nngilaa
pinniilikaa¦rpoq	V	–nngilaq
pinniilli¦voq	V	–nngilaq
pinniinnar¦aa	V	–inngilaa
pinn¦iinnaraa	V	{–erinnarinngilaa, –iinnarinngilaa}
pinniippallaarnera¦rpaa	V	–nngilaa
pinnii¦ppoq	V	–nngilaq
pinniissu¦seq	N	–tsip, –tsit
pinni¦issuseq	N	{–issutsip, –nngaanniissutsip}, {–issutsit, –nngaanniissutsit}
pinniits¦oq	N	–up, –ut
pinniivi¦ppoq	V	–nngilaq
pinni¦ivippoq	V	{–ivinngilaq, –nngaanniivinngilaq}
pinninngeqis¦oq	N	–up, –ut
pinnipia¦rpaa	V	–nngilaa
pinnissuseerutil¦erpoq	V	–inngilaq
pinnittuuma¦voq	V	–nngilaq
pinnivi¦ppoq	V	–nngilaq
pinnivissu¦uvoq	V	{–aanngilaq, –unngilaq}
pinnivi¦ssuuvoq	V	{–ssuunngilaq, –ttuunngilaq}
pioqqilersi¦ppaa	V	–nngilaa
pioqqu¦erpoq	V	–inngilaq
pioqug¦aa	V	–inngilaa
piorfissa¦q	N	–p, –t
pi¦orpaa	V	–unngilaa
pi¦orpoq	V	–unngilaq
piorsaane¦q	N	–rup, –rit
piorsaaqqinne¦q	N	–rup, –rit
piorsaas¦oq	N	–up, –ut
piorsaa¦voq	V	–nngilaq
piorsagaa¦voq	V	–nngilaq
piorsar¦aa	V	–inngilaa
piorsa¦rpaa	V	–nngilaa
piorsa¦rpoq	V	–nngilaq
piorsarsimanngissu¦seq	N	–tsip, –tsit
piorsarsimassu¦seq	N	–tsip, –tsit
piorsarsimassuseqarluart¦oq	N	–up, –ut
piorsuaalli¦orpoq	V	–unngilaq
piorsu¦aalliorpoq	V	{–aalliunngilaq, –ulliunngilaq}
piorsuaa¦ppoq	V	–nngilaq
piorsui¦ppoq	V	–nngilaq
pior¦suippoq	V	{–suinngilaq, –tuinngilaq}
piorsu¦ppoq	V	–nngilaq
piort¦orpoq	V	–unngilaq
pior¦torpoq	V	{–sunngilaq, –tunngilaq}
pipalla¦gaq	N	–kkap, –kkat
pipallakkajuppoq	V	(no generation)
pipallanne¦q	N	–rup, –rit
pipalla¦ppaa	V	–nngilaa
pipallappallaaqaaq	V	(no generation)
pipalla¦ppoq	V	–nngilaq
pipi¦ppoq	V	–nngilaq
pipit¦erpaa	V	–inngilaa
pisaagaju¦ppoq	V	–nngilaq
pisaajui¦ppoq	V	–nngilaq
pisaaju¦voq	V	–nngilaq
pisaa¦q	N	–p, –t
pisaar¦aa	V	–inngilaa
pisaarne¦q	N	–rup, –rit
pisaa¦rpoq	V	–nngilaq
pisaartaanna¦rpoq	V	–nngilaq
pisaart¦orpoq	V	–unngilaq
pisaar¦torpoq	V	{–sunngilaq, –tunngilaq}
pisaasaanna¦rpoq	V	–nngilaq
pisaa¦seq	N	–tsip, –tsit
pisaaseqanngits¦oq	N	–up, –ut
pisaaseqarne¦q	N	–rup, –rit
pisaaseqart¦oq	N	–up, –ut
pisaassa¦q	N	–p, –t
pisaa¦voq	V	–nngilaq
pisakkersaa¦rpoq	V	–nngilaq
pisakkersaarutig¦aa	V	–inngilaa
pisannakkaju¦ppoq	V	–nngilaq
pisanna¦ppoq	V	–nngilaq
pisannattaa¦q	N	–p, –t
pisa¦q	N	–p, –t
pisaqama¦voq	V	–nngilaq
pisaqa¦rpoq	V	–nngilaq
pisaqarsinnaanngilaq	V	(no generation)
pisaqartaanna¦rpoq	V	–nngilaq
pisar¦aa	V	–inngilaa
pisareeq¦ut	N	{–qutip, –utip}, {–qutit, –utit}
pisareeq¦utaavoq	V	{–qutaanngilaq, –utaanngilaq}
pisar¦eerpaa	V	–iinngilaa
pisar¦eerpoq	V	–iinngilaq
pisareersa¦rpaa	V	–nngilaa
pisariaaru¦ppoq	V	–tinngilaq
pisariaarut¦ippaa	V	{–inngilaa, –sinngilaa}
pisariaki¦ppoq	V	–nngilaq
pisarial¦ik	N	{–iup, –lip, –lup}, –lit
pisariaqa¦gaq	N	–kkap, –kkat
pisariaqaler¦sippaa	V	{–sinngilaa, –tinngilaa}
pisariaqanngits¦oq	N	–up, –ut
pisariaqarlu¦innarpoq	V	{–innanngilaq, –aannanngilaq}
pisariaqa¦rpoq	V	–nngilaq
pisariaqarsor¦aa	V	–inngilaa
pisariaqarti¦ppaa	V	–nngilaa
pisariaqartissimasa¦q	N	–p, –t
pisariaqartita¦q	N	–p, –t
pisariaqartitsine¦q	N	–rup, –rit
pisariaqart¦oq	N	–up, –ut
pisariaqartunngorti¦ppaa	V	–nngilaa
pisariaqavi¦ssoq	N	{–ssup, –ttup}, {–ssut, –ttut}
pisariaqavissuunngilaq	V	(no generation)
pisariillisaane¦q	N	–rup, –rit
pisariillisa¦rpaa	V	–nngilaa
pisariinaa¦rpaa	V	–nngilaa
pisarii¦ppoq	V	–nngilaq
pisariitsuli¦orpoq	V	–unngilaq
pisarii¦tsuliorpoq	V	{–ssuliunngilaq, –tsuliunngilaq, –ttuliunngilaq}
pisarissersorneqanngits¦oq	N	–up, –ut
pisarissers¦orpaa	V	–unngilaa
pisarissers¦orpoq	V	–unngilaq
pisarissersuutaa¦voq	V	–nngilaq
pisarisuukkat	N, pl.	-
pisariuallaaqaaq	V	(no generation)
pisariunersaa¦voq	V	–nngilaq
pisariunngilaq	V	(no generation)
pisarius¦oq	N	–up, –ut
pisariusoqanngilaq	V	(no generation)
pisariussu¦seq	N	–tsip, –tsit
pisariu¦voq	V	–nngilaq
pisarne¦q	N	–rup, –rit
pisarnermisoort¦oq	N	–up, –ut
pisarninaa¦rpaa	V	–nngilaa
pisa¦rpoq	V	–nngilaq
pisartagaat	N	–ip, –it
pisartagal¦ik	N	{–iup, –lip, –lup}, –lit
pisarta¦gaq	N	–kkap, –kkat
pisartagaqalerne¦q	N	–rup, –rit
pisartagaqarne¦q	N	–rup, –rit
pisartagaqa¦rpoq	V	–nngilaq
pisartagaqartussaas¦oq	N	–up, –ut
pisartagar¦aa	V	–inngilaa
pisartakkat	N, pl.	-
pisassaanngilaq	V	(no generation)
pisassal¦ik	N	{–iup, –lip, –lup}, –lit
pisassanngortitsine¦q	N	–rup, –rit
pisassa¦q	N	–p, –t
pisassaqaqaaq	V	(no generation)
pisassaqarti¦ppaa	V	–nngilaa
pisassaqart¦oq	N	–up, –ut
pisassaqartussaatitaas¦oq	N	–up, –ut
pisassar¦aa	V	–inngilaa
pisassarinngilaa	V	(no generation)
pisassarisa¦q	N	–p, –t
pisassarititat	N, pl.	-
pisassariumaarpaa	V	(no generation)
pisassat	N, pl.	-
pisassiissut	N	–ip, –it
pisassiissutit	N, pl.	-
pisassi¦ppaa	V	–nngilaa
pisat	N, pl.	-
pisataaru¦ppoq	V	–tinngilaq
pisatalers¦orpaa	V	–unngilaa
pisatalersuine¦q	N	–rup, –rit
pisatanngueru¦ppaa	V	–tinngilaa
pisatanngueru¦ppoq	V	–tinngilaq
pisat¦aq	N	{–ap, –tap}, {–at, –tat}
pisataqanngilaq	V	(no generation)
pisatarilluart¦oq	N	–up, –ut
pisatartoqaaq	V	(no generation)
pisats¦erpaa	V	–inngilaa
pisatsers¦orpaa	V	–unngilaa
pisatsiu¦ppaa	V	–tinngilaa
pi¦seq	N	–tsip, –tsit
piseqqaartussaatitaane¦q	N	–rup, –rit
piser¦aa	V	–inngilaa
piseriaatig¦aa	V	–inngilaa
piseria¦rpaa	V	–nngilaa
piseria¦rpoq	V	–nngilaq
piserinerpaasa¦q	N	–p, –t
piserinerpaa¦saq	N	{–jusap, –sap}, {–jusat, –sat}
piserinerpaa¦vaa	V	–nngilaa
piseriullua¦rpaa	V	–nngilaa
piseriu¦ppaa	V	–tinngilaa
piseriussa¦q	N	–p, –t
piserlaarajuppoq	V	(no generation)
piserlaa¦rpoq	V	–nngilaq
piserpassuaqa¦rpoq	V	–nngilaq
piserulu¦ppoq	V	–nngilaq
pisi	N	–p, –t
pisiaa¦voq	V	–nngilaq
pisiannaa¦q	N	–p, –t
pisia¦q	N	–p, –t
pisiar¦aa	V	–inngilaa
pisiariti¦ppaa	V	–nngilaa
pisiart¦orpoq	V	–unngilaq
pisiar¦torpoq	V	{–sunngilaq, –tunngilaq}
pisiartu¦voq	V	–nngilaq
pisiassa¦q	N	–p, –t
pisiassat	N, pl.	-
pisiffig¦aa	V	–inngilaa
Pisiffi¦k	N	–up, –it
Pisiffi¦k	Prop	–up, –it
pisiffius¦oq	N	–up, –ut
pisig¦aa	V	–inngilaa
pisigillua¦rpaa	V	–nngilaa
pisikkaluttuinna¦rpoq	V	–nngilaq
pisimas¦oq	N	–up, –ut
pisimasorsiut	N	–ip, –it
pisimasortavi¦k	N	–up, –it
pisimasulersaarut	N	–ip, –it
pisimasuutita¦q	N	–p, –t
pisine¦q	N	–rup, –rit
pisinialuppoq	V	(no generation)
pisinia¦q	N	–p, –t
pisiniarfeqarfi¦k	N	–up, –it
pisiniarfigisarta¦gaq	N	–kkap, –kkat
pisiniarfi¦k	N	–up, –it
pisiniarfiliut	N	–ip, –it
pisiniarfissu¦aq	N	–up, –it
pisiniarne¦q	N	–rup, –rit
pisinia¦rpoq	V	–nngilaq
pisiniartart¦oq	N	–up, –ut
pisiniartitsis¦oq	N	–up, –ut
pisiniartitsi¦voq	V	–nngilaq
pisiniart¦oq	N	–up, –ut
pisinnaaffig¦aa	V	–inngilaa
pisinnaaffiit	N, pl.	-
pisinnaaffi¦k	N	–up, –it
pisinnaajunnaarne¦q	N	–rup, –rit
pisinnaajunnaa¦rpoq	V	–nngilaq
pisinnaajunnaar¦sippaa	V	{–sinngilaa, –tinngilaa}
pisinnaaler¦sippaa	V	{–sinngilaa, –tinngilaa}
pisinnaallua¦rpoq	V	–nngilaq
pisinnaalluart¦oq	N	–up, –ut
pisinnaanngilaq	V	(no generation)
pisinnaannginne¦q	N	–rup, –rit
pisinnaanngorlua¦rpoq	V	–nngilaq
pisinnaanng¦orpaa	V	–unngilaa
pisinnaanng¦orpoq	V	–unngilaq
pisinnaanngorsa¦rpaa	V	–nngilaa
pisinnaanngorsima¦voq	V	–nngilaq
pisinnaasa¦q	N	–p, –t
pisinnaasat	N, pl.	-
pisinnaas¦oq	N	–up, –ut
pisinnaassu¦seq	N	–tsip, –tsit
pisinnaati¦ppaa	V	–nngilaa
pisinnaatitaaffiiagaane¦q	N	–rup, –rit
pisinnaatitaaffiit	N, pl.	-
pisinnaatitaaffi¦k	N	–up, –it
pisinnaatitaane¦q	N	–rup, –rit
pisinnaatitaas¦oq	N	–up, –ut
pisinnaatita¦q	N	–p, –t
pisinnaatitsine¦q	N	–rup, –rit
pisinnaatitsissut	N	–ip, –it
pisinnaa¦voq	V	–nngilaq
pisinneqa¦rpoq	V	–nngilaq
pisiortorne¦q	N	–rup, –rit
pisiort¦orpoq	V	–unngilaq
pisiortortart¦oq	N	–up, –ut
pisiortort¦oq	N	–up, –ut
pisi¦ppaa	V	–nngilaa
pisi¦ppoq	V	–nngilaq
pisisart¦oq	N	–up, –ut
pisisartut	N, pl.	-
Pisisinnaassu¦seq	N	–tsip, –tsit
pisisi¦ppaa	V	–nngilaa
pisissaa¦rpaa	V	–nngilaa
pisissaa¦rpoq	V	–nngilaq
pisissaa¦vaa	V	–nngilaa
Pisissarfi¦k	N	–up, –it
Pisi¦ssarfik	N	{–ssarfiup, –ttarfiup}, {–ssarfiit, –ttarfiit}
pisissa¦rpoq	V	–nngilaq
pisi¦ssarpoq	V	–ttanngilaq
pisissart¦oq	N	–up, –ut
pisi¦ssartoq	N	{–ssartup, –ttartup}, {–ssartut, –ttartut}
pisisseeru¦ppoq	V	–tinngilaq
pisiss¦eq	N	–ip, –it
pisisseqa¦rpoq	V	–nngilaq
pisissi	N	–p, –t
pisissinnaanng¦orpoq	V	–unngilaq
pisissita¦q	N	–p, –t
pisi¦ssitaq	N	{–ssitap, –tsitap}, {–ssitat, –tsitat}
pisit	N	–ip, –it
pisit	N, pl.	-
pisitaa¦voq	V	–nngilaq
pisitsine¦q	N	–rup, –rit
pisitsis¦oq	N	–up, –ut
pisitsisuu¦voq	V	–nngilaq
pisitsi¦voq	V	–nngilaq
pisi¦voq	V	–nngilaq
pis¦ooq	N	–uup, –uut
pisooqaaq	V	(no generation)
pisooqataajumanngilaq	V	(no generation)
pisooqataa¦voq	V	–nngilaq
pisoorsu¦aq	N	–up, –it
pisoorsu¦uvoq	V	{–aanngilaq, –unngilaq}
pisoortaat	N	–ip, –it
pisoortaat	N, pl.	-
pisoortaa¦voq	V	–nngilaq
pisoorujussu¦aq	N	–up, –it
pis¦oq	N	–up, –ut
pisoqaane¦q	N	–rup, –rit
pisoqaaneru¦voq	V	–nngilaq
pisoqaaqaaq	V	(no generation)
pisoqaavinngilaq	V	(no generation)
pisoqaa¦voq	V	–nngilaq
pisoqalerne¦q	N	–rup, –rit
pisoqalisoorne¦q	N	–rup, –rit
pisoqali¦voq	V	–nngilaq
pisoqanngort¦oq	N	–up, –ut
pisoq¦aq	N	–qap, –qat
pisoqarnerpoq	V	(no generation)
pisoqarpalutt¦oq	N	–up, –ut
pisoqa¦rpoq	V	–nngilaq
pisoqarsu¦aq	N	–up, –it
pisoqasaanng¦orpoq	V	–unngilaq
pisoqasaa¦q	N	–p, –t
pisoqatig¦aa	V	–inngilaa
pisoqattaa¦rpoq	V	–nngilaq
pisorarta¦rpoq	V	–nngilaq
pisorartuutit	N, pl.	-
pisorataa¦rpoq	V	–nngilaq
pisorataarti¦ppaa	V	–nngilaa
pisorpalla¦k	N	–ap, –at
pisorpalla¦ppoq	V	–nngilaq
pisorpaluk	N	–up, –it
pisorpalu¦k	N	–up, –it
pisorpalunne¦q	N	–rup, –rit
pisorpaluppallaaqaaq	V	(no generation)
pisorpalu¦ppoq	V	–nngilaq
pisorpalussu¦aq	N	–up, –it
pisorpalutsitsine¦q	N	–rup, –rit
pisorpaluttorsuu¦voq	V	–nngilaq
pisorpaluttorsu¦uvoq	V	{–aanngilaq, –unngilaq}
pisorsu¦aq	N	–up, –it
pisortaaffig¦aa	V	–inngilaa
pisortaagallart¦oq	N	–up, –ut
pisortaagalu¦aq	N	{–ap, –up}, –it
pisortaajunnaar¦sippaa	V	{–sinngilaa, –tinngilaa}
pisortaal¦erpoq	V	–inngilaq
pisortaane¦q	N	–rup, –rit
pisortaaneqarfi¦k	N	–up, –it
pisortaas¦oq	N	–up, –ut
pisortaa¦voq	V	–nngilaq
pisorta¦q	N	–p, –t
pisortaqarfiit	N, pl.	-
pisortaqarfi¦k	N	–up, –it
pisortaqatigiit	N, pl.	-
pisortat	N, pl.	-
pisortatigoort¦oq	N	–up, –ut
pisortatiguunngits¦oq	N	–up, –ut
pisorujoorpoq	V	(no generation)
pissaaleqilerne¦q	N	–rup, –rit
pissaaleqinarfiu¦voq	V	–nngilaq
pissaaleqine¦q	N	–rup, –rit
pissaaleqis¦oq	N	–up, –ut
pissaaleqiunnaa¦rpoq	V	–nngilaq
pissaaleqi¦voq	V	–nngilaq
pissaane¦q	N	–rup, –rit
pissaaneqarne¦q	N	–rup, –rit
pissaaneqarneru¦voq	V	–nngilaq
pissaaneqarniunne¦q	N	–rup, –rit
pissaaneqartitaane¦q	N	–rup, –rit
pissaaneqartita¦q	N	–p, –t
pissaaneqassu¦seq	N	–tsip, –tsit
pissaanerpaa¦q	N	–p, –t
pissaanersaa¦voq	V	–nngilaq
pissaaniki¦ppoq	V	–nngilaq
pissaanil¦ik	N	{–iup, –lip, –lup}, –lit
pissaanngilaq	V	(no generation)
pissaanngilluinnarpoq	V	(no generation)
pissa¦aq	V	–nngilaq
pissaarluinna¦rpoq	V	–nngilaq
pissaa¦rpoq	V	–nngilaq
pissaarsima¦voq	V	–nngilaq
pissaaru¦ppaa	V	–tinngilaa
pissaaru¦ppoq	V	–tinngilaq
pissaarussi¦vaa	V	–nngilaa
pissaarutivinngilaq	V	(no generation)
pissaarutt¦oorpoq	V	–uunngilaq
pissaassu¦seq	N	–tsip, –tsit
pissaasua¦voq	V	–nngilaq
pissaat	N	–ip, –it
pissaataa¦voq	V	–nngilaq
pissaatig¦aa	V	–inngilaa
pissaatil¦ik	N	{–iup, –lip, –lup}, –lit
pissaa¦voq	V	–nngilaq
pissa¦gaq	N	–kkap, –kkat
pissakilli¦orpoq	V	–unngilaq
pissaki¦ppoq	V	–nngilaq
pissamaalernerpoq	V	(no generation)
pissamaal¦erpoq	V	–inngilaq
pissamaarnertu¦voq	V	–nngilaq
pissamaa¦rpoq	V	–nngilaq
pissamaarti¦ppaa	V	–nngilaa
pissamaart¦oq	N	–up, –ut
pissamaartuarpoq	V	(no generation)
pissamaaru¦siussineq	N	{–siussinerup, –tiliussinerup}, {–siussinerit, –tiliussinerit}
pissamaarut	N	–ip, –it
pissamaarutig¦aa	V	–inngilaa
pissamaarutit	N, pl.	-
pissamaa¦serpaa	V	{–sinngilaa, –tilinngilaa}
pissamaas¦erpoq	V	–inngilaq
pissamaa¦serpoq	V	{–sinngilaq, –tilinngilaq}
pissamaat	N	–ip, –it
pissamaateqaqaaq	V	(no generation)
pissamaateqarfi¦k	N	–up, –it
pissamaateqa¦rpoq	V	–nngilaq
pissameerfiu¦voq	V	–nngilaq
pissam¦eerfiuvoq	V	{–eerfiunngilaq, –inngaanneerfiunngilaq}, –eerfiunngilaq
pissam¦eerpoq	V	{–iinngilaq, –inngaanniinngilaq}, –iinngilaq
pissam¦eerpoq	V	–iinngilaq
pissamiinngilaq	V	(no generation)
pissanersorsiut	N	–ip, –it
pissangaleriartorne¦q	N	–rup, –rit
pissangana¦rpoq	V	–nngilaq
pissanganarsivi¦ppoq	V	–nngilaq
pissanganart¦oq	N	–up, –ut
pissanganartuliat	N, pl.	-
pissangane¦q	N	–rup, –rit
pissanganersu¦aq	N	–up, –it
pissangati¦ppaa	V	–nngilaa
pissangatsa¦ppoq	V	–nngilaq
pissanga¦voq	V	–nngilaq
pissanngaserluinna¦rpoq	V	–nngilaq
pissannga¦serluinnarpoq	V	{–serluaannanngilaq, –serluinnanngilaq, –tilerluaannanngilaq, –tilerluinnanngilaq}
pissanngas¦erpoq	V	–inngilaq
pissannga¦serpoq	V	{–sinngilaq, –tilinngilaq}
pissanngat	N	–ip, –it
pissanngatig¦aa	V	–inngilaa
pissanngatigiunnaa¦rpaa	V	–nngilaa
pissa¦ppaa	V	–nngilaa
pissa¦ppoq	V	–nngilaq
pissa¦q	N	–p, –t
pissaqaatig¦aa	V	–inngilaa
pissaqa¦rpoq	V	–nngilaq
pissaqartinneqarne¦q	N	–rup, –rit
pissaqartinngilaa	V	(no generation)
pissaqarti¦ppaa	V	–nngilaa
pissaqqaa¦rpoq	V	–nngilaq
pissar¦aa	V	–inngilaa
pissari¦ppoq	V	–nngilaq
pissarissaanngilaq	V	(no generation)
pissarissaa¦rpoq	V	–nngilaq
pissarissuu¦voq	V	–nngilaq
pissari¦ssuuvoq	V	{–ssuunngilaq, –ttuunngilaq}
pissarl¦erpoq	V	–inngilaq
pissarli¦orpoq	V	–unngilaq
pissarlu¦ppoq	V	–nngilaq
pissarsia¦q	N	–p, –t
pissarsiaqarluarfius¦oq	N	–up, –ut
pissarsiar¦aa	V	–inngilaa
pissarsiarerusu¦ppaa	V	–nngilaa
pissarsiat	N, pl.	-
pissarsine¦q	N	–rup, –rit
pissarsi¦orpaa	V	–unngilaa
pissarsi¦orpoq	V	–unngilaq
pissarsiuis¦oq	N	–up, –ut
pissarsiuu¦ppaa	V	–tinngilaa
pissarsi¦voq	V	–nngilaq
pissarsu¦aq	N	–up, –it
pissarsuu¦voq	V	–nngilaq
pissarsu¦uvoq	V	{–aanngilaq, –unngilaq}
pissartanngorniunne¦q	N	–rup, –rit
pissarta¦q	N	–p, –t
pissassaatig¦aa	V	–inngilaa
pissassarfi¦k	N	–up, –it
pissassa¦rpoq	V	–nngilaq
pissassartua¦rpoq	V	–nngilaq
pissata¦q	N	–p, –t
pissatsikkiart¦orpoq	V	–unngilaq
pissatsinneqa¦rpoq	V	–nngilaq
pissat¦sinneqarpoq	V	{–sinneqanngilaq, –inneqanngilaq}
pissatsi¦ppaa	V	–nngilaa
pissatsi¦ppoq	V	–nngilaq
pissatsissutig¦aa	V	–inngilaa
pissatsitaa¦voq	V	–nngilaq
pissat¦sitaavoq	V	{–sitaanngilaq, –itaanngilaq}
pissial¦ik	N	{–iup, –lip, –lup}, –lit
pissia¦q	N	–p, –t
pissiaqa¦rpoq	V	–nngilaq
pissiar¦aa	V	–inngilaa
pissiariit	N, pl.	-
pissiartaar¦aa	V	–inngilaa
pissiartaa¦rpoq	V	–nngilaq
pissiga¦rpoq	V	–nngilaq
pissigartua¦rpoq	V	–nngilaq
pissikaala¦voq	V	–nngilaq
pissikala¦voq	V	–nngilaq
pissika¦rpoq	V	–nngilaq
pissikkaluttuaqaaq	V	(no generation)
pissikkaluttuarpoq	V	(no generation)
pissikkiartoqqaarumagaluarpoq	V	(no generation)
pissikkiartoqqippoq	V	(no generation)
pissikkusulernikuunngilaq	V	(no generation)
pissi¦ppaa	V	–nngilaa
pissi¦ppoq	V	–nngilaq
pissisaannarpaa	V	(no generation)
pississaa¦rpoq	V	–nngilaq
pississaarut	N	–ip, –it
pississart¦oq	N	–up, –ut
pissi¦ssartoq	N	{–ssartup, –ttartup}, {–ssartut, –ttartut}
pissittuinnaa¦voq	V	–nngilaq
pissi¦ttuinnaavoq	V	{–ssuinnaanngilaq, –ttuinnaanngilaq}
pissi¦vaa	V	–nngilaa
pissuanart¦oq	N	–up, –ut
pissua¦voq	V	–nngilaq
pissunneqa¦rpoq	V	–nngilaq
pissu¦ppaa	V	–tinngilaa
pissu¦seq	N	–tsip, –tsit
pissuseqarfiginninne¦q	N	–rup, –rit
pissuseqarne¦q	N	–rup, –rit
pissuseqartitsiniaane¦q	N	–rup, –rit
pissuseqart¦oq	N	–up, –ut
pissuseqat	N	–ip, –it
pissu¦seqat	N	{–seqatip, –tileqatip}, {–seqatit, –tileqatit}
pissuseqataa	N	–p, –t
pissuseqataas¦oq	N	–up, –ut
pissu¦seqataasoq	N	{–seqataasup, –tileqataasup}, {–seqataasut, –tileqataasut}
pissu¦seqaterpiaq	N	{–seqaterpiap, –tileqaterpiap}, {–seqaterpiat, –tileqaterpiat}
pissuseqatigiinne¦q	N	–rup, –rit
pissu¦seqatigiinneq	N	{–seqatigiinnerup, –tileqatigiinnerup}, {–seqatigiinnerit, –tileqatigiinnerit}
pissuseqatigiit	N, pl.	-
pissu¦seqatigiit	N, pl.	{–seqatigiit, –tileqatigiit}
pissu¦seqqaaq	N	{–seqqaap, –tileqqaap}, {–seqqaat, –tileqqaat}
pissuser¦aa	V	–inngilaa
pissuseri¦ppoq	V	–nngilaq
pissuserissaa¦rpoq	V	–nngilaq
pissu¦serissaarpoq	V	{–serissaanngilaq, –tilerissaanngilaq}
pissuseriss¦oq	N	–up, –ut
pissuseri¦ssoq	N	{–ssup, –ttup}, {–ssut, –ttut}
pissusersiut	N	–ip, –it
pissusilerissut	N	–ip, –it
pissusilersorne¦q	N	–rup, –rit
pissusilersorumat¦ooq	N	–uup, –uut
pissusilersuut	N	–ip, –it
pissus¦ilersuut	N	{–erlersuutip, –erlertuutip, –ilersuutip, –ilertuutip}, {–erlersuutit, –erlertuutit, –ilersuutit, –ilertuutit}
pissu¦silersuut	N	{–silersuutip, –silertuutip, –tililersuutip, –tililertuutip}, {–silersuutit, –silertuutit, –tililersuutit, –tililertuutit}
pissusilersuuteqallaqqi¦ssoq	N	{–ssup, –ttup}, {–ssut, –ttut}
pissus¦ilersuuteqallaqqissoq	N	{–erlersuuteqallaqqissup, –erlersuuteqallaqqittup, –erlertuuteqallaqqissup, –erlertuuteqallaqqittup, –ilersuuteqallaqqissup, –ilersuuteqallaqqittup, –ilertuuteqallaqqissup, –ilertuuteqallaqqittup}, {–erlersuuteqallaqqissut, –erlersuuteqallaqqittut, –erlertuuteqallaqqissut, –erlertuuteqallaqqittut, –ilersuuteqallaqqissut, –ilersuuteqallaqqittut, –ilertuuteqallaqqissut, –ilertuuteqallaqqittut}
pissu¦silersuuteqallaqqissoq	N	{–silersuuteqallaqqissup, –silersuuteqallaqqittup, –silertuuteqallaqqissup, –silertuuteqallaqqittup, –tililersuuteqallaqqissup, –tililersuuteqallaqqittup, –tililertuuteqallaqqissup, –tililertuuteqallaqqittup}, {–silersuuteqallaqqissut, –silersuuteqallaqqittut, –silertuuteqallaqqissut, –silertuuteqallaqqittut, –tililersuuteqallaqqissut, –tililersuuteqallaqqittut, –tililertuuteqallaqqissut, –tililertuuteqallaqqittut}
pissusil¦ik	N	{–iup, –lip, –lup}, –lit
pissusilunnersuaq	N	(no generation)
pissusissamisoorne¦q	N	–rup, –rit
pissusissamisoort¦oq	N	–up, –ut
pissusissamisuunngits¦oq	N	–up, –ut
pissusitoq¦aq	N	–qap, –qat
pissusitoqar¦aa	V	–inngilaa
pissusiu¦juartoq	N	{–juartup, –tuartup}, {–juartut, –tuartut}
pissusiuler¦soq	N	{–sup, –tup}, {–sut, –tut}
pissu¦siulersoq	N	{–siulersup, –siulertup, –tiliulersup, –tiliulertup}, {–siulersut, –siulertut, –tiliulersut, –tiliulertut}
pissussaa¦voq	V	–nngilaq
pissut	N	–ip, –it
pissutaaqataas¦oq	N	–up, –ut
pissutaas¦oq	N	–up, –ut
pissutaa¦voq	V	–nngilaq
pissuteqa¦rpoq	V	–nngilaq
pissutig¦aa	V	–inngilaa
pissutigivi¦ppaa	V	–nngilaa
pissutissarsi¦orpoq	V	–unngilaq
pissutsit	N, pl.	-
pisuaa¦voq	V	–nngilaq
pisuar¦aa	V	–inngilaa
pisuatsiaa¦voq	V	–nngilaq
pisuatsi¦aavoq	V	{–aanngilaq, –unngilaq}
pisuatsianngort¦oq	N	–up, –ut
pisuatsia¦q	N	–p, –t
pisuatsi¦aq	N	–up, –it
pisuffi¦k	N	–up, –it
pisuinnaat	N	–ip, –it
pisuinnaat	N, pl.	-
pisuinna¦q	N	–ap, –at
pisuinnartarfi¦k	N	–up, –it
pisuinnart¦oq	N	–up, –ut
pisukatal¦erpoq	V	–inngilaq
pisukatalluinnalereerpoq	V	(no generation)
pisukatalluinnalerpoq	V	(no generation)
pisukatalluinna¦rpoq	V	–nngilaq
pisukata¦ppoq	V	–nngilaq
pisukatavi¦ppoq	V	–nngilaq
pisukkunnaa¦rpoq	V	–nngilaq
pisulerasuarpoq	V	(no generation)
pisullaqqi¦ppoq	V	–nngilaq
pisul¦oorpoq	V	–uunngilaq
pisuloortaanna¦rpoq	V	–nngilaq
pisunnguna¦rpoq	V	–nngilaq
pisunngunarsi¦voq	V	–nngilaq
pisu¦ppaa	V	–nngilaa
pisuppallaanngikkallarpoq	V	(no generation)
pisuppallaarnera¦rpaa	V	–nngilaa
pisuppallaarnikuu¦voq	V	–nngilaq
pisu¦ppoq	V	–nngilaq
pisussaaffeqarne¦q	N	–rup, –rit
pisussaaffig¦aa	V	–inngilaa
pisussaaffigil¦erpaa	V	–inngilaa
pisussaaffi¦k	N	–up, –it
pisussaaffili¦gaq	N	–kkap, –kkat
pisussaaffittal¦ik	N	{–iup, –lip, –lup}, –lit
pisussaajunnaar¦sippaa	V	{–sinngilaa, –tinngilaa}
pisussaajunnaar¦sitaaneq	N	{–sitaanerup, –titaanerup}, {–sitaanerit, –titaanerit}
pisussaane¦q	N	–rup, –rit
pisussaaru¦ppaa	V	–tinngilaa
pisussaaru¦ppoq	V	–tinngilaq
pisussaassu¦seq	N	–tsip, –tsit
pisu¦ssaassuseq	N	{–ssaassutsip, –ttaassutsip}, {–ssaassutsit, –ttaassutsit}
pisussaassuseqart¦oq	N	–up, –ut
pisu¦ssaassuseqartoq	N	{–ssaassuseqartup, –ttaassuseqartup}, {–ssaassuseqartut, –ttaassuseqartut}
pisussaatitaaffi¦k	N	–up, –it
pisussaatitaagallart¦oq	N	–up, –ut
pisussaatitaa¦voq	V	–nngilaq
pisussaa¦voq	V	–nngilaq
pisussangati¦ppaa	V	–nngilaa
pisussanga¦voq	V	–nngilaq
pisussanngorti¦ppaa	V	–nngilaa
pisussanngortitsine¦q	N	–rup, –rit
pisussa¦q	N	–p, –t
pisussaqa¦rpoq	V	–nngilaq
pisussinnaajunnaarpoq	V	(no generation)
pisussinnaa¦voq	V	–nngilaq
pisutsiarallarpoq	V	(no generation)
pisuttaat	N	–ip, –it
pisuttaat	N, pl.	-
pisuttariaqalersima¦voq	V	–nngilaq
pisutt¦orpoq	V	–unngilaq
pisuttorsaat	N	–ip, –it
pisuttorsa¦rpaa	V	–nngilaa
pisuttorsa¦rpoq	V	–nngilaq
pisut¦tuarneq	N	{–tuarnerup, –uarnerup}, {–tuarnerit, –uarnerit}
pisuttua¦rpoq	V	–nngilaq
pisuuju¦voq	V	–nngilaq
pisuune¦q	N	–rup, –rit
pisuunersaa¦voq	V	–nngilaq
pisuuneru¦voq	V	–nngilaq
pisuungaatsia¦rpoq	V	–nngilaq
pisuunngilaq	V	(no generation)
pisuunng¦orpoq	V	–unngilaq
pisuunngorsa¦rpaa	V	–nngilaa
pisuunnguallanne¦q	N	–rup, –rit
pisuusaa¦rpoq	V	–nngilaq
pisuusaartita¦q	N	–p, –t
pisuu¦seq	N	–tsip, –tsit
pisuuserlu¦ppoq	V	–nngilaq
pisuus¦oq	N	–up, –ut
pisuusorinart¦oq	N	–up, –ut
pisuussu¦seq	N	–tsip, –tsit
pisuussut	N	–ip, –it
pisuussutaa¦voq	V	–nngilaq
pisuussuteqanngits¦oq	N	–up, –ut
pisuussuteqart¦oq	N	–up, –ut
pisuussuterpassuit	N, pl.	-
pisuussutig¦aa	V	–inngilaa
pisuussutiginngilaa	V	(no generation)
pisuussutit	N, pl.	-
pisuut	N	–ip, –it
pisuut	N, pl.	-
pisuutinneqa¦rpoq	V	–nngilaq
pisuuti¦ppaa	V	–nngilaa
pisuutit	N, pl.	-
pisuutitaa¦voq	V	–nngilaq
pisuutita¦q	N	–p, –t
pisuutitassaanngits¦oq	N	–up, –ut
pisuutitsi¦voq	V	–nngilaq
pisuu¦voq	V	–nngilaq
pitarneqa¦rpoq	V	–nngilaq
pita¦rpaa	V	–nngilaa
pita¦rpoq	V	–nngilaq
pitarsima¦vaa	V	–nngilaa
pitarunnavianngilaq	V	(no generation)
pitaru¦ppoq	V	–tinngilaq
pitarutinngilaq	V	(no generation)
pitarutinngitsoorpoq	V	(no generation)
pite¦raq	N	–qqap, –qqat
piti¦ppaa	V	–nngilaa
pit¦oq	N	–up, –ut
pitoraa¦ppaa	V	–tinngilaa
pitoraassaa¦voq	V	–nngilaq
pito¦raq	N	–qqap, –qqat
pitora¦rpoq	V	–nngilaq
pitorarsa¦rpaa	V	–nngilaa
pitorartorsu¦uvoq	V	{–aanngilaq, –unngilaq}
pitsaag¦aa	V	–inngilaa
pitsaagiummerpaa	V	(no generation)
pitsaaguna¦rpoq	V	–nngilaq
pitsaajalla¦k	N	–ap, –at
pitsaaliine¦q	N	–rup, –rit
pitsaalineqanngits¦oq	N	–up, –ut
pitsaali¦orpaa	V	–unngilaa
pitsaalisaa¦voq	V	–nngilaq
pitsaaliuine¦q	N	–rup, –rit
pitsaaliui¦voq	V	–nngilaq
pitsaali¦vaa	V	–nngilaa
pitsaalluanngilaq	V	(no generation)
pitsaalluart¦oq	N	–up, –ut
pitsaalluassu¦seq	N	–tsip, –tsit
pitsaalluinna¦rpoq	V	–nngilaq
pitsaallu¦innartoq	N	{–aannartup, –innartup}, {–aannartut, –innartut}
pitsaane¦q	N	–rup, –rit
pitsaanersi¦orpaa	V	–unngilaa
pitsaanersi¦orpoq	V	–unngilaq
pitsaanerul¦erpoq	V	–inngilaq
pitsaaneruler¦soraa	V	{–sorinngilaa, –torinngilaa}
pitsaanerus¦oq	N	–up, –ut
pitsaanerusumii¦tinneqartoq	N	{–sinneqartup, –tinneqartup, –tsinneqartup}, {–sinneqartut, –tinneqartut, –tsinneqartut}
pitsaaneru¦voq	V	–nngilaq
pitsaangaart¦oq	N	–up, –ut
pitsaanngeqis¦oq	N	–up, –ut
pitsaanngilaq	V	(no generation)
pitsaanngilluinnassu¦seq	N	–tsip, –tsit
pitsaannginne¦q	N	–rup, –rit
pitsaannginnerpaa¦q	N	–p, –t
pitsaanngits¦oq	N	–up, –ut
pitsaanngitsorta¦q	N	–p, –t
pitsaaqaaq	V	(no generation)
pitsaaqis¦oq	N	–up, –ut
pitsaasaannginne¦q	N	–rup, –rit
pitsaasaarfig¦aa	V	–inngilaa
pitsaasaarluart¦oq	N	–up, –ut
pitsaasaa¦rpaa	V	–nngilaa
pitsaasaa¦rpoq	V	–nngilaq
pitsaasaart¦oq	N	–up, –ut
pitsaas¦oq	N	–up, –ut
pitsaassaguna¦rpoq	V	–nngilaq
pitsaassu¦seq	N	–tsip, –tsit
pitsaavallaarsorinngilaa	V	(no generation)
pitsaavi¦ppoq	V	–nngilaq
pitsaaviss¦orpoq	V	–unngilaq
pitsaa¦voq	V	–nngilaq
pitsa¦k	N	–ap, –at
pitsanng¦orpoq	V	–unngilaq
pitsanngorsaane¦q	N	–rup, –rit
pitsanngorsaat	N	–ip, –it
pitsanngorsa¦rpaa	V	–nngilaa
pitsanngorsii¦vaa	V	–nngilaa
pitsanngorsinnaanngilaq	V	(no generation)
pitsanngorti¦ppaa	V	–nngilaa
pitsannguut	N	–ip, –it
pitsa¦ppoq	V	–nngilaq
pitsassillua¦rpoq	V	–nngilaq
pitsassimaa¦rpoq	V	–nngilaq
pitsassi¦voq	V	–nngilaq
pitsassu¦aq	N	–up, –it
pitsassu¦ugaluaq	N	{–aagaluup, –ugaluup}, {–aagaluit, –ugaluit}
pitsassu¦uvoq	V	{–aanngilaq, –unngilaq}
pitsavi¦k	N	–up, –it
pitsaviunngits¦oq	N	–up, –ut
pitserianaa¦rpaa	V	–nngilaa
pitseria¦rpoq	V	–nngilaq
pitseriarsivi¦ppoq	V	–nngilaq
pitseriart¦oq	N	–up, –ut
pitseriassu¦seq	N	–tsip, –tsit
pitseriilli¦voq	V	–nngilaq
pitserii¦ppoq	V	–nngilaq
pitseriissu¦seq	N	–tsip, –tsit
pitseriits¦oq	N	–up, –ut
pitserii¦tsoq	N	{–ssup, –tsup, –ttup}, {–ssut, –tsut, –ttut}
pits¦erpaa	V	–inngilaa
pits¦erpoq	V	–inngilaq
pitsiaanna¦q	N	–ap, –at
pitsiaa¦voq	V	–nngilaq
pitsia¦q	N	–p, –t
pitsiatoq¦aq	N	{–qap, –ap}, {–qat, –at}
pitsiatoq¦aq	N	–qap, –qat
pitsiiginna¦rpaa	V	–nngilaa
pitsii¦vaa	V	–nngilaa
pitsikkuma¦vaa	V	–nngilaa
pi¦tsiorpoq	V	{–siliunngilaq, –tsiunngilaq}
pi¦tsiorsinnaavoq	V	{–siliorsinnaanngilaq, –tsiorsinnaanngilaq}
pitsiort¦oq	N	–up, –ut
pi¦tsiortoq	N	{–siliortup, –tsiortup}, {–siliortut, –tsiortut}
pitsiortuiu¦voq	V	–nngilaq
pi¦tsiortuiuvoq	V	{–siliortuiunngilaq, –tsiortuiunngilaq}
pitsi¦ppaa	V	–sinngilaa
pitsippoq	V	(no generation)
pitsissi¦voq	V	–nngilaq
pitsivig¦aa	V	–inngilaa
pitsivi¦k	N	–up, –it
pitsivissaa¦voq	V	–nngilaq
pitsivissaqqi¦ppoq	V	–nngilaq
pitsoqiallaanna¦rpoq	V	–nngilaq
pitsorikkunnaa¦rpoq	V	–nngilaq
pitsori¦ppoq	V	–nngilaq
pitsorissi¦voq	V	–nngilaq
pitsoriss¦oq	N	–up, –ut
pitsori¦ssoq	N	{–ssup, –ttup}, {–ssut, –ttut}
pitsorl¦erpoq	V	–inngilaq
pitsorli¦orpoq	V	–unngilaq
pitsorlivi¦ppoq	V	–nngilaq
pitsorluinna¦rpoq	V	–nngilaq
pitsorlu¦ppoq	V	–nngilaq
pitsorlutsi¦ppoq	V	–nngilaq
pitsorlutt¦oq	N	–up, –ut
pitsort¦ooq	N	–uup, –uut
pitsortoorsuu¦voq	V	–nngilaq
pitsortoorsu¦uvoq	V	{–aanngilaq, –unngilaq}
pitsortu¦voq	V	–nngilaq
pitsugaa¦voq	V	–nngilaq
pitsu¦gaq	N	–kkap, –kkat
pitsugar¦aa	V	–inngilaa
pitsuilli¦voq	V	–nngilaq
pitsui¦ppoq	V	–nngilaq
pitsu¦ppaa	V	–nngilaa
pitu	N	–p, –t
pituaas¦oq	N	–up, –ut
pitua¦q	N	–p, –t
Pituffi¦k	N	–up, –it
Pituffi¦k	Prop	–up
pituffi¦k	N	–up, –it
pituia¦rpaa	V	–nngilaa
pitu¦iarpaa	V	{–ajanngilaa, –ianngilaa}
pituia¦rpoq	V	–nngilaq
pitukulu¦ppoq	V	–nngilaq
pitukulutsi¦ppaa	V	–nngilaa
pitu¦ppaa	V	–nngilaa
pitu¦ppoq	V	–nngilaq
pitussimas¦oq	N	–up, –ut
pitussi¦voq	V	–nngilaq
pituta¦q	N	–p, –t
pitutta¦q	N	–p, –t
pitutt¦orpaa	V	–unngilaa
pituttorsimanngits¦oq	N	–up, –ut
pituttorsimas¦oq	N	–up, –ut
pituttui¦voq	V	–nngilaq
pituussaajaa¦voq	V	–nngilaq
pituussaarneqa¦rpoq	V	–nngilaq
pituussaa¦rpaa	V	–nngilaa
pituussaa¦rpoq	V	–nngilaq
pituussaarsima¦voq	V	–nngilaq
pituussaart¦oorpoq	V	–uunngilaq
pituutaaja¦rpaa	V	–nngilaa
pituutaars¦erpoq	V	–inngilaq
pituut¦aq	N	{–ap, –tap}, {–at, –tat}
pituutaqa¦rpoq	V	–nngilaq
pituutarsu¦aq	N	–up, –it
pituutassia¦q	N	–p, –t
pituuts¦erpaa	V	–inngilaa
pituut¦serpaa	V	{–alinngilaa, –sinngilaa}
pituut¦sersorpaa	V	{–alersunngilaa, –sersunngilaa}
pituut¦sersugaavoq	V	{–alersugaanngilaq, –sersugaanngilaq}
pituutsiu¦ppaa	V	–tinngilaa
pituut¦siuppaa	V	{–aliutinngilaa, –siutinngilaa}
piuaanna¦rpaa	V	–nngilaa
piuaannart¦oq	N	–up, –ut
piuaanne¦q	N	–rup, –rit
piuaa¦ppoq	V	–nngilaq
piuanngits¦oq	N	–up, –ut
piuaqqissaa¦rpoq	V	–nngilaq
piuarl¦erpaa	V	–inngilaa
piuarliar¦aa	V	–inngilaa
piuarli¦vaa	V	–nngilaa
piua¦rpaa	V	–nngilaa
piua¦rpoq	V	–nngilaq
piu¦gaq	N	–kkap, –kkat
piuinnarne¦q	N	–rup, –rit
piujuartitaas¦oq	N	–up, –ut
piujuartitsine¦q	N	–rup, –rit
piujuartitsis¦oq	N	–up, –ut
piujuartitsi¦voq	V	–nngilaq
piu¦juartoq	N	{–juartup, –tuartup}, {–juartut, –tuartut}
piujunnaa¦rpoq	V	–nngilaq
piukkooqaaq	V	(no generation)
piukk¦oorpoq	V	–uunngilaq
piukkoorti¦ppaa	V	–nngilaa
piukkoort¦oq	N	–up, –ut
piukkooru¦ppaa	V	–tinngilaa
piukkoorussi¦voq	V	–nngilaq
piukkunnaa¦ppoq	V	–nngilaq
piukkunnaat	N	–ip, –it
piukkunnaateqart¦oq	N	–up, –ut
piukkunnaatig¦aa	V	–inngilaa
piukkunnanngits¦oq	N	–up, –ut
piukkunnarluart¦oq	N	–up, –ut
piukkunna¦rpoq	V	–nngilaq
piukkunnarsarfi¦k	N	–up, –it
piukkunnarsarne¦q	N	–rup, –rit
piukkunnarsarpoq	V	(no generation)
piukkunnarsinnaa¦voq	V	–nngilaq
piukkunnart¦oq	N	–up, –ut
piukkunnartorsiortartut	N, pl.	-
piukkunnartussarsiorne¦q	N	–rup, –rit
piukkunnartussarsi¦orpoq	V	–unngilaq
piukkunnassu¦seq	N	–tsip, –tsit
piukku¦ppaa	V	–tinngilaa
piukku¦ppoq	V	–nngilaq
piukkussaa¦voq	V	–nngilaq
piukkussa¦q	N	–p, –t
piukkutt¦oq	N	–up, –ut
piulluanngilaq	V	(no generation)
piulluanngits¦oq	N	–up, –ut
piumaarnersaa¦voq	V	–nngilaq
piumaarnert¦ooq	N	–uup, –uut
piumaarnertuallaaqaaq	V	(no generation)
piumaarnertu¦voq	V	–nngilaq
piumaa¦rpoq	V	–nngilaq
piumaartussa¦q	N	–p, –t
piumaartussat	N, pl.	-
piumaataarne¦q	N	–rup, –rit
piumaataarnert¦ooq	N	–uup, –uut
piumaataa¦rpoq	V	–nngilaq
piumaataaru¦ppaa	V	–tinngilaa
piumaffiginninne¦q	N	–rup, –rit
piumagaluaqaaq	V	(no generation)
piumagalua¦rpoq	V	–nngilaq
piumallu¦innarpoq	V	{–innanngilaq, –aannanngilaq}
piumaneeru¦ppoq	V	–tinngilaq
piumaneqarneru¦voq	V	–nngilaq
piumaneqa¦rpoq	V	–nngilaq
piumaneqart¦oq	N	–up, –ut
piumaneqassu¦seq	N	–tsip, –tsit
piumania¦rpaa	V	–nngilaa
piumania¦rpoq	V	–nngilaq
piumanngilaq	V	(no generation)
piumanngits¦oq	N	–up, –ut
piumasaannali¦orpoq	V	–unngilaq
piumasaannarpoq	V	(no generation)
piumasaarsorne¦q	N	–rup, –rit
piumasaarsorpallaart¦oq	N	–up, –ut
piumasaars¦orpoq	V	–unngilaq
piumasaarsorumatussu¦seq	N	–tsip, –tsit
piumasaaru¦ppoq	V	–tinngilaq
piumasakkaali¦orpoq	V	–unngilaq
piumasakkaaliortaanna¦rpoq	V	–nngilaq
piumasa¦q	N	–p, –t
piumasaqaat	N	–ip, –it
piumasaqaataa¦voq	V	–nngilaq
piumasaqaateqannginne¦q	N	–rup, –rit
piumasaqaateqarne¦q	N	–rup, –rit
piumasaqaatit	N, pl.	-
piumasaqanngitsoorne¦q	N	–rup, –rit
piumasaqarne¦q	N	–rup, –rit
piumasaqa¦rpoq	V	–nngilaq
piumasar¦aa	V	–inngilaa
piumasarineqanngits¦oq	N	–up, –ut
piumasarinninne¦q	N	–rup, –rit
piumasarisa¦q	N	–p, –t
piumasarpassual¦ik	N	{–iup, –lip, –lup}, –lit
piumasarpassuaqa¦rpoq	V	–nngilaq
piumasars¦orpoq	V	–unngilaq
piumasar¦sorpoq	V	{–sunngilaq, –tunngilaq}
piumasarsupilunne¦q	N	–rup, –rit
piumasars¦upilunneq	N	{–oripilunnerup, –upilunnerup}, {–oripilunnerit, –upilunnerit}
piumasar¦supilunneq	N	{–soripilunnerup, –supilunnerup, –toripilunnerup, –tupilunnerup}, {–soripilunnerit, –supilunnerit, –toripilunnerit, –tupilunnerit}
piumasart¦ooq	N	–uup, –uut
piumas¦oq	N	–up, –ut
piumassu¦seq	N	–tsip, –tsit
piumassuseqanngits¦oq	N	–up, –ut
piumassuseqarluart¦oq	N	–up, –ut
piumassuseqarne¦q	N	–rup, –rit
piumassusil¦ik	N	{–iup, –lip, –lup}, –lit
piumassusipilu¦k	N	–up, –it
piumatigigaluarpoq	V	(no generation)
piumat¦ooq	N	–uup, –uut
piumatoorsu¦aq	N	–up, –it
piumatoqaaq	V	(no generation)
piumatsaa¦ppaa	V	–tinngilaa
piumatsannert¦ooq	N	–uup, –uut
piumatsa¦ppoq	V	–nngilaq
piumatussu¦seq	N	–tsip, –tsit
piumatuui¦k	N	–up, –it
piumatu¦voq	V	–nngilaq
piuma¦vaa	V	–nngilaa
piuma¦voq	V	–nngilaq
piuminaalli¦orpoq	V	–unngilaq
piuminaappallaaqaaq	V	(no generation)
piuminaa¦ppoq	V	–nngilaq
piuminaaqaaq	V	(no generation)
piuminaats¦oq	N	–up, –ut
piumina¦rpoq	V	–nngilaq
piuminarsi¦voq	V	–nngilaq
piuminart¦oq	N	–up, –ut
piuminavi¦ppoq	V	–nngilaq
piummaartunersaa¦voq	V	–nngilaq
piummaartu¦voq	V	–nngilaq
piummanneqaqaaq	V	(no generation)
piummart¦ooq	N	–uup, –uut
piummartussu¦seq	N	–tsip, –tsit
piuneerullu¦innarpaa	V	{–aannanngilaa, –innanngilaa}
piuneeru¦ppaa	V	–tinngilaa
piuneeru¦ppoq	V	–tinngilaq
piuneerussaa¦voq	V	–nngilaq
piuneerussi¦voq	V	–nngilaq
piuneerut¦ippaa	V	{–inngilaa, –sinngilaa, –itinngilaa}
piuneerutitaa¦voq	V	–nngilaq
piuneerut¦itaavoq	V	{–itaanngilaq, –sitaanngilaq}
piune¦q	N	–rup, –rit
piuneqanngilaq	V	(no generation)
piuneqanngits¦oq	N	–up, –ut
piunnaa¦rpoq	V	–nngilaq
piunnaarsa¦rpaa	V	–nngilaa
piunnal¦erpoq	V	–inngilaq
piunnanngilaa	V	(no generation)
piunnanngilaq	V	(no generation)
piunnanngisa¦q	N	–p, –t
piunnart¦oq	N	–up, –ut
piunngilaq	V	(no generation)
piunngissu¦seq	N	–tsip, –tsit
piunngits¦oq	N	–up, –ut
piunngitsuli¦orpoq	V	–unngilaq
piunngitsut	N, pl.	-
piunngitsuu¦voq	V	–nngilaq
piusaa¦rpoq	V	–nngilaq
piusaartitsi¦voq	V	–nngilaq
piusaatig¦aa	V	–inngilaa
piusar¦aa	V	–inngilaa
piusarnert¦ooq	N	–uup, –uut
piusa¦rpoq	V	–nngilaq
piusartuiu¦voq	V	–nngilaq
piu¦siaq	N	{–siap, –tiliap}, {–siat, –tiliat}
piusimane¦q	N	–rup, –rit
piusinnaassu¦seq	N	–tsip, –tsit
pius¦oq	N	–up, –ut
piusugittaa¦ppoq	V	–nngilaq
piusugitta¦rpoq	V	–nngilaq
piusuusaarne¦q	N	–rup, –rit
piusuusaa¦rpoq	V	–nngilaq
piusuusaartitsi¦voq	V	–nngilaq
piut	N	–ip, –it
piut	N, pl.	-
piutaa¦voq	V	–nngilaq
piutig¦aa	V	–inngilaa
piutserfig¦aa	V	–inngilaa
piut¦serfigaa	V	{–italerfiginngilaa, –serfiginngilaa}
piutserfiginninne¦q	N	–rup, –rit
piut¦serfiginninneq	N	{–italerfiginninnerup, –serfiginninnerup}, {–italerfiginninnerit, –serfiginninnerit}
piutserne¦q	N	–rup, –rit
piut¦serneq	N	{–italernerup, –sernerup}, {–italernerit, –sernerit}
piutserpallaa¦rpoq	V	–nngilaq
piut¦serpallaarpoq	V	{–italerpallaanngilaq, –serpallaanngilaq}
piuts¦erpoq	V	–inngilaq
piutsers¦oq	N	–up, –ut
piutser¦soq	N	{–sup, –tup}, {–sut, –tut}
piut¦sersoq	N	{–italersup, –italertup, –sersup, –sertup}, {–italersut, –italertut, –sersut, –sertut}
piu¦voq	V	–nngilaq
pi¦vaa	V	–nngilaa
pivar¦eerpoq	V	–iinngilaq
pivi¦ppoq	V	–nngilaq
piviunngits¦oq	N	–up, –ut
pivius¦oq	N	–up, –ut
piviusorsiorsinnaanngits¦oq	N	–up, –ut
piviusorsiort¦oq	N	–up, –ut
piviusorsiunngits¦oq	N	–up, –ut
piviussu¦seq	N	–tsip, –tsit
piviussusersiorne¦q	N	–rup, –rit
piviusulersaaru¦siaq	N	{–siap, –tiliap}, {–siat, –tiliat}
piviusulersaarut	N	–ip, –it
piviusungatita¦q	N	–p, –t
piviusunng¦orpoq	V	–unngilaq
piviusunngorti¦ppaa	V	–nngilaa
piviusunngortitsine¦q	N	–rup, –rit
piviusuusaaginnart¦oq	N	–up, –ut
piviusuu¦voq	V	–nngilaq
piviu¦voq	V	–nngilaq
pi¦voq	V	–nngilaq
pivorleerne¦q	N	–rup, –rit
pivorl¦eerpoq	V	–iinngilaq
pivorleersi¦ppaa	V	–nngilaa
pizza	N	–p, –t
plastikki	N	(no generation)
plussi	N	(no generation)
pokalinnanniunne¦q	N	–rup, –rit
pokalinna¦ppoq	V	–nngilaq
polit¦eeq	N	–iip, –iit
politeeqarfi¦k	N	–up, –it
politiit	N, pl.	-
politiiune¦q	N	–rup, –rit
politikkeqarneq	N	(no generation)
politikki	N	(no generation)
p¦ooq	N	–uup, –uut
pooqattaa¦raq	N	–qqap, –qqat
pooqatta¦q	N	–p, –t
pooqattarmi¦oq	N	–up, –ut
pooqattarsu¦aq	N	–up, –it
p¦oorpaa	V	–uunngilaa
p¦oorpoq	V	–uunngilaq
poorsimaa¦q	N	–p, –t
poorsimaat	N	–ip, –it
poorsimaat	N, pl.	-
poorsima¦voq	V	–nngilaq
poorsi¦voq	V	–nngilaq
poorski	N	–p, –t
poorskisi¦orpoq	V	–unngilaq
poorskisiut	N	–ip, –it
poorsu¦aq	N	–up, –it
poortal¦ik	N	{–iup, –lip, –lup}, –lit
poortali¦orpoq	V	–unngilaq
poorta¦q	N	–p, –t
poortartaa¦rpoq	V	–nngilaq
poortat	N, pl.	-
poort¦orpaa	V	–unngilaa
poortu¦gaq	N	–kkap, –kkat
poor¦tugaq	N	{–sukkap, –tukkap}, {–sukkat, –tukkat}
poortuillaqqi¦ppoq	V	–nngilaq
poortuine¦q	N	–rup, –rit
poortuissu¦ppaa	V	–tinngilaa
poortuisuu¦voq	V	–nngilaq
poortui¦voq	V	–nngilaq
poortuullua¦rpoq	V	–nngilaq
poortuu¦ppaa	V	–tinngilaa
poortuu¦ppoq	V	–tinngilaq
poortuusiort¦oq	N	–up, –ut
poortuu¦siortoq	N	{–siortup, –tiliortup}, {–siortut, –tiliortut}
poortuussima¦voq	V	–nngilaq
poortuut	N	–ip, –it
poortuut	N, pl.	-
poortuutaa¦voq	V	–nngilaq
poortuutik¦oq	N	–up, –ut
poortuutissia¦q	N	–p, –t
pooru¦seq	N	–tsip, –tsit
poorusermi¦oq	N	–up, –ut
poorusersu¦aq	N	–up, –it
poorutsi¦voq	V	–nngilaq
poqernersaa¦voq	V	–nngilaq
poq¦erpoq	V	–inngilaq
poqersi¦voq	V	–nngilaq
poqers¦oq	N	–up, –ut
poqer¦soq	N	{–sup, –tup}, {–sut, –tut}
poqersorsuu¦voq	V	–nngilaq
poqersorsu¦uvoq	V	{–aanngilaq, –unngilaq}
poqer¦sorsuuvoq	V	{–sorsuaanngilaq, –sorsuunngilaq, –torsuaanngilaq, –torsuunngilaq}
poqiilli¦orpoq	V	–unngilaq
poqiinne¦q	N	–rup, –rit
poqiinneru¦voq	V	–nngilaq
poqii¦ppoq	V	–nngilaq
poqiits¦oq	N	–up, –ut
poqii¦tsoq	N	{–ssup, –tsup, –ttup}, {–ssut, –tsut, –ttut}
poqiitsuu¦voq	V	–nngilaq
poqii¦tsuuvoq	V	{–ssuunngilaq, –tsuunngilaq, –ttuunngilaq}
poqissu¦seq	N	–tsip, –tsit
porpigaju¦ppoq	V	–nngilaq
porpi¦k	N	–up, –it
porpilaa¦rpoq	V	–nngilaq
porpi¦ppoq	V	–nngilaq
porpit¦ooq	N	–uup, –uut
porpitoorsu¦aq	N	–up, –it
porpi¦voq	V	–nngilaq
portoqis¦oq	N	–up, –ut
portuallaaqaaq	V	(no generation)
portuallaarsinnaavoq	V	(no generation)
portujaqi¦voq	V	–nngilaq
portune¦q	N	–rup, –rit
portusisi¦ppaa	V	–nngilaa
portusi¦voq	V	–nngilaq
portus¦ooq	N	–uup, –uut
portu¦sooq	N	{–suup, –tuup}, {–suut, –tuut}
portussu¦seq	N	–tsip, –tsit
portutsi¦ppoq	V	–nngilaq
portu¦voq	V	–nngilaq
praktikkerneq	N	(no generation)
prammi	N	(no generation)
programmi	N	(no generation)
programmiliorpoq	V	(no generation)
programmiliortoq	N	(no generation)
provsteqarfi¦k	N	–up, –it
pruffiiti	N	(no generation)
pruffiitioqqus¦erpoq	V	–inngilaq
pruffiitioqquser¦soq	N	{–sup, –tup}, {–sut, –tut}
pruffiitiu¦voq	V	–nngilaq
puaa¦q	N	–p, –t
puaarpalla¦k	N	–ap, –at
puaa¦rpoq	V	–nngilaq
puaasaarart¦oq	N	–up, –ut
puaasa¦q	N	–p, –t
puaasarnert¦ooq	N	–uup, –uut
puaasarpalu¦ppoq	V	–nngilaq
puaasa¦rpoq	V	–nngilaq
puaasarsi¦orpaa	V	–unngilaa
puaasartuinnaa¦voq	V	–nngilaq
puaasar¦tuinnaavoq	V	{–tuinnaanngilaq, –suinnaanngilaq}
puaatsoorne¦q	N	–rup, –rit
puaats¦oorpoq	V	–uunngilaq
puaatsoorti¦ppaa	V	–nngilaa
puaatsoort¦oq	N	–up, –ut
puagi¦ppoq	V	–nngilaq
pua¦k	N	–ap, –at
pualakkaa¦q	N	–p, –t
pualakkaa¦voq	V	{–junngilaq, –nngilaq}
pualakkaa¦voq	V	–nngilaq
pualakka¦k	N	–ap, –at
pualakulla¦k	N	–ap, –at
pualallarpoq	V	(no generation)
pualangaatsiart¦oq	N	–up, –ut
pualaqaaq	V	(no generation)
pualas¦ooq	N	–uup, –uut
puala¦sooq	N	{–suup, –tuup}, {–suut, –tuut}
pualavallaarne¦q	N	–rup, –rit
pualavi¦ppoq	V	–nngilaq
pualavissuunngilaq	V	(no generation)
puala¦voq	V	–nngilaq
puallaari¦ppoq	V	–nngilaq
puallaariss¦oq	N	–up, –ut
puallaari¦ssoq	N	{–ssup, –ttup}, {–ssut, –ttut}
puallaarissu¦seq	N	–tsip, –tsit
puallariart¦orpoq	V	–unngilaq
puallari¦ppoq	V	–nngilaq
puallarne¦q	N	–rup, –rit
puallarpallaa¦rpoq	V	–nngilaq
pualla¦rpoq	V	–nngilaq
puallarsa¦rpaa	V	–nngilaa
puallars¦erpoq	V	–inngilaq
puallunne¦q	N	–rup, –rit
puallu¦ppoq	V	–nngilaq
pualu¦k	N	–up, –it
puatt¦orpoq	V	–unngilaq
pueqattaa¦rpoq	V	–nngilaq
pueqq¦oq	N	–up, –ut
pueqqoqarfi¦k	N	–up, –it
pueqq¦orpoq	V	–unngilaq
pueqqorti¦ppoq	V	–nngilaq
pueqquisa¦ppoq	V	–nngilaq
pueqquisatsikkiart¦orpoq	V	–unngilaq
pueraasa¦rpoq	V	–nngilaq
pueralaanna¦rpoq	V	–nngilaq
puerala¦voq	V	–nngilaq
pue¦raq	N	–qqap, –qqat
puerfi¦k	N	–up, –it
puerlu¦ppoq	V	–nngilaq
puerni¦ppoq	V	–nngilaq
Puernitt¦oq	N	{–up, –up}, {–ut, –ut}
Puernitt¦oq	Prop	–up
pu¦erpaa	V	–inngilaa
pu¦erpoq	V	–inngilaq
puersaa¦voq	V	–nngilaq
puersa¦q	N	–p, –t
puersi¦ppoq	V	–nngilaq
puersitsi¦voq	V	–nngilaq
puers¦orpaa	V	–unngilaa
puffaakkiart¦orpaa	V	–unngilaa
puffaalluinna¦rpaa	V	–nngilaa
puffaallu¦innarpaa	V	{–aannanngilaa, –innanngilaa}
puffaammerne¦q	N	–rup, –rit
puffaa¦ppaa	V	–tinngilaa
puffaat	N	–ip, –it
puffaataa¦voq	V	–nngilaq
puffaatig¦aa	V	–inngilaa
puffajas¦ooq	N	–uup, –uut
puffajas¦oq	N	–up, –ut
puffajasorsu¦aq	N	–up, –it
puffajassu¦seq	N	–tsip, –tsit
puffaja¦voq	V	–nngilaq
puffanne¦q	N	–rup, –rit
puffa¦ppoq	V	–nngilaq
puffassaari¦voq	V	–nngilaq
puffassaa¦rpaa	V	–nngilaa
puffassimaa¦rpoq	V	–nngilaq
puffassimaart¦oq	N	–up, –ut
puffig¦aa	V	–inngilaa
puffinne¦q	N	–rup, –rit
puffi¦ppaa	V	–nngilaa
puffi¦ppoq	V	–nngilaq
puffissi¦voq	V	–nngilaq
pugg¦erpoq	V	–inngilaq
puggut	N	–ip, –it
pui	N	–p, –t
puiaa¦q	N	–p, –t
puiaa¦rpoq	V	–nngilaq
puiaasaa¦raq	N	–qqap, –qqat
puiaasa¦q	N	–p, –t
puiaat	N	–ip, –it
puiaat	N, pl.	-
puialinne¦q	N	–rup, –rit
puiali¦ppoq	V	–nngilaq
puialits¦erpoq	V	–inngilaq
puialitsi¦ppoq	V	–nngilaq
puiani¦ppoq	V	–nngilaq
puia¦q	N	–p, –t
puiarfi¦k	N	–up, –it
puia¦rpoq	V	–nngilaq
puiartu¦voq	V	–nngilaq
puigoqqajaasarpaa	V	(no generation)
puigorluinna¦rpaa	V	–nngilaa
puigorlu¦innarpaa	V	{–aannanngilaa, –innanngilaa}
puigorluinna¦rpoq	V	–nngilaq
puigorlu¦innarpoq	V	{–innanngilaq, –aannanngilaq}
puigorne¦q	N	–rup, –rit
puig¦orpaa	V	–unngilaa
puig¦orpoq	V	–unngilaq
puigorsaat	N	–ip, –it
puigorsima¦vaa	V	–nngilaa
puigorsima¦voq	V	–nngilaq
puigortaa¦rpoq	V	–nngilaq
puigortoorne¦q	N	–rup, –rit
puigortunng¦orpoq	V	–unngilaq
puigortunngort¦oq	N	–up, –ut
puigugaane¦q	N	–rup, –rit
puigugaavi¦ppoq	V	–nngilaq
puigugaa¦voq	V	–nngilaq
puigu¦gaq	N	–kkap, –kkat
puiguikkaa¦rpoq	V	–nngilaq
puiguikkiullua¦rpaa	V	–nngilaa
puiguikkiunneqa¦rpoq	V	–nngilaq
puiguikkiu¦ppaa	V	–tinngilaa
puiguikkiussi¦voq	V	–nngilaq
puigui¦ppaa	V	–nngilaa
puigui¦voq	V	–nngilaq
puigujuilluinnarpoq	V	(no generation)
puigujui¦ppoq	V	–nngilaq
puigujuissu¦seq	N	–tsip, –tsit
puigunaa¦ppoq	V	–nngilaq
puigunaats¦oq	N	–up, –ut
puigunaatsorsiar¦aa	V	–inngilaa
puigussaa¦rpoq	V	–nngilaq
puigut¦ooq	N	–uup, –uut
puigutoorsu¦aq	N	–up, –it
puiguttorne¦q	N	–rup, –rit
puigutt¦orpoq	V	–unngilaq
puiguttorsima¦voq	V	–nngilaq
puiguttort¦oq	N	–up, –ut
puigutuallaaqaaq	V	(no generation)
puigutune¦q	N	–rup, –rit
puigutunersaa¦voq	V	–nngilaq
puigutus¦oq	N	–up, –ut
puigutu¦voq	V	–nngilaq
pui¦k	N	–up, –it
puikkarne¦q	N	–rup, –rit
puikka¦rpoq	V	–nngilaq
puikkartit¦erpoq	V	–inngilaq
puilaa¦rpoq	V	–nngilaq
puilallua¦rpoq	V	–nngilaq
puilas¦oq	N	–up, –ut
puilasoqarfi¦k	N	–up, –it
puilasoqa¦rpoq	V	–nngilaq
puilasulia¦q	N	–p, –t
puilasuli¦orpoq	V	–unngilaq
puila¦voq	V	–nngilaq
puilert¦orpoq	V	–unngilaq
puillaat	N	–ip, –it
puilla¦rpaa	V	–nngilaa
puillartuu¦ppaa	V	–tinngilaa
puillartuut	N	–ip, –it
puine¦q	N	–rup, –rit
puinermii¦ppoq	V	–nngilaq
puinersu¦aq	N	–up, –it
puinnassi¦voq	V	–nngilaq
puinne¦q	N	–rup, –rit
puiorluinna¦rpaa	V	–nngilaa
puiorlu¦innarpaa	V	{–aannanngilaa, –innanngilaa}
puiorluinna¦rpoq	V	–nngilaq
puiorlu¦innarpoq	V	{–innanngilaq, –aannanngilaq}
puiorne¦q	N	–rup, –rit
pui¦orpaa	V	–unngilaa
pui¦orpoq	V	–unngilaq
puiorsaat	N	–ip, –it
puiorsima¦vaa	V	–nngilaa
puiorsima¦voq	V	–nngilaq
puiortaa¦rpaa	V	–nngilaa
puiortaa¦rpoq	V	–nngilaq
puiortunngort¦oq	N	–up, –ut
pui¦ppoq	V	–nngilaq
puisaannerul¦erpoq	V	–inngilaq
puisaa¦ppoq	V	–nngilaq
puisaa¦q	N	–p, –t
puisaarpoq	V	(no generation)
puisaarukkiart¦orpoq	V	–unngilaq
puisaaru¦ppoq	V	–tinngilaq
puisaarussi¦vaa	V	–nngilaa
puisaasa¦ppoq	V	–nngilaq
puisaasatsikkiart¦orpoq	V	–unngilaq
puisaasatsippoq	V	(no generation)
puisa¦rpaa	V	–nngilaa
puisartig¦aa	V	–inngilaa
puisarti¦ppoq	V	–nngilaq
puiseqaanna¦rpoq	V	–nngilaq
puiseqanngilaq	V	(no generation)
puiseqa¦rpoq	V	–nngilaq
puisi	N	–p, –t
puisilissu¦uvoq	V	{–aanngilaq, –unngilaq}
puisinniaqataa¦voq	V	–nngilaq
pui¦sinniaqataavoq	V	{–sinniaqataanngilaq, –tinniaqataanngilaq}
puisinniarne¦q	N	–rup, –rit
pui¦sinniarneq	N	{–sinniarnerup, –tinniarnerup}, {–sinniarnerit, –tinniarnerit}
puisinnia¦rpoq	V	–nngilaq
puisinniartarne¦q	N	–rup, –rit
pui¦sinniartarneq	N	{–sinniartarnerup, –tinniartarnerup}, {–sinniartarnerit, –tinniartarnerit}
puisi¦ppoq	V	–nngilaq
pui¦sippoq	V	{–sinngilaq, –tinngilaq}
puisisillattaa¦rpoq	V	–nngilaq
puisisi¦orpoq	V	–unngilaq
puisisi¦voq	V	–nngilaq
puisissaa¦rpoq	V	–nngilaq
puisit	N, pl.	-
puisita¦q	N	–p, –t
pui¦sitaq	N	{–sitap, –titap}, {–sitat, –titat}
puisitaqarnersaa¦voq	V	–nngilaq
pui¦sitaqarnersaavoq	V	{–sitaqarnersaanngilaq, –titaqarnersaanngilaq}
puisittuaanna¦rpoq	V	–nngilaq
puisiusa¦q	N	–p, –t
puisi¦vaa	V	–nngilaa
puissaa¦rpoq	V	–nngilaq
puitserpoq	V	(no generation)
puiugaas¦oq	N	–up, –ut
puiugaavi¦ppoq	V	–nngilaq
puiugaa¦voq	V	–nngilaq
puiu¦gaq	N	–kkap, –kkat
puiuikkaarnerlu¦ppaa	V	–nngilaa
puiuikkaa¦rpaa	V	–nngilaa
puiuikkaa¦rpoq	V	–nngilaq
puiuikkiullua¦rpaa	V	–nngilaa
puiuikkiunneqa¦rpoq	V	–nngilaq
puiuikkiu¦ppaa	V	–tinngilaa
puiuikkiussi¦voq	V	–nngilaq
puiui¦ppaa	V	–nngilaa
puiujuilluinnarpoq	V	(no generation)
puiujui¦ppoq	V	–nngilaq
puiunaa¦ppoq	V	–nngilaq
puiunaatsorsiar¦aa	V	–inngilaa
puiusi¦vaa	V	–nngilaa
puiussaa¦rpoq	V	–nngilaq
puiut¦ooq	N	–uup, –uut
puiutoorsu¦aq	N	–up, –it
puiuttorne¦q	N	–rup, –rit
puiutt¦orpoq	V	–unngilaq
puiuttorsima¦voq	V	–nngilaq
puiuttort¦oq	N	–up, –ut
puiutuallaaqaaq	V	(no generation)
puiutune¦q	N	–rup, –rit
puiutunersaa¦voq	V	–nngilaq
puiutus¦oq	N	–up, –ut
puiutu¦voq	V	–nngilaq
pui¦voq	V	–nngilaq
puja	N	–p, –t
pujaalli¦voq	V	–nngilaq
pujaa¦ppoq	V	–nngilaq
pujaats¦oorpoq	V	–uunngilaq
pujakkisaa¦rpoq	V	–nngilaq
pujanna¦rpoq	V	–nngilaq
pujannart¦oq	N	–up, –ut
pujannartunng¦orpoq	V	–unngilaq
puja¦ppoq	V	–nngilaq
pujar¦orpoq	V	–unngilaq
pujarorsa¦rpaa	V	–nngilaa
pujaru¦ppoq	V	–tinngilaq
pujas¦oorpoq	V	–uunngilaq
pujassaat	N	–ip, –it
pujassa¦rpaa	V	–nngilaa
pujassu¦seq	N	–tsip, –tsit
pujasunni¦ppoq	V	–nngilaq
pujat¦erpaa	V	–inngilaa
pujatsi¦ppoq	V	–nngilaq
pujatt¦oq	N	–up, –ut
pujavi¦ppoq	V	–nngilaq
puja¦voq	V	–nngilaq
pujoorfi¦k	N	–up, –it
pujoor¦ineq	N	{–inerup, –sinerup}, {–inerit, –sinerit}
pujoor¦isarpoq	V	{–isanngilaq, –sisanngilaq}
pujooris¦oq	N	–up, –ut
pujoor¦isoq	N	{–isup, –sisup}, {–isut, –sisut}
pujooriuarpoq	V	(no generation)
pujoorivi¦k	N	–up, –it
pujoor¦ivoq	V	{–inngilaq, –sinngilaq}
pujoorlua¦rpaa	V	–nngilaa
puj¦oorpaa	V	–uunngilaa
puj¦oorpoq	V	–uunngilaq
pujoor¦sivoq	V	{–inngilaq, –sinngilaq}
pujoortitsi¦voq	V	–nngilaq
pu¦joq	N	{–ggup, –tsup}, –tsut
pujoqq¦erpoq	V	–inngilaq
pujoqqersorsuu¦voq	V	–nngilaq
pujoqqersorsu¦uvoq	V	{–aanngilaq, –unngilaq}
pujoqqer¦sorsuuvoq	V	{–sorsuaanngilaq, –sorsuunngilaq, –torsuaanngilaq, –torsuunngilaq}
pujoqqiorajuppoq	V	(no generation)
pujoqqiorne¦q	N	–rup, –rit
pujoqqi¦orpoq	V	–unngilaq
pujor¦aa	V	–inngilaa
pujoraasa¦q	N	–p, –t
pujoraasa¦rpoq	V	–nngilaq
pujorajuppoq	V	(no generation)
pujora¦k	N	–ap, –at
pujoralaajaat	N	–ip, –it
pujoralaajaa¦voq	V	–nngilaq
pujoralaaja¦rpaa	V	–nngilaa
pujoralaasaanna¦q	N	–ap, –at
pujorala¦k	N	–ap, –at
pujorall¦erpoq	V	–inngilaq
pujora¦ppoq	V	–nngilaq
pujorassu¦aq	N	–up, –it
pujorattorsuu¦voq	V	–nngilaq
pujorattorsu¦uvoq	V	{–aanngilaq, –unngilaq}
pujoriinna¦rpaa	V	–nngilaa
puj¦orpoq	V	–unngilaq
pujorsarne¦q	N	–rup, –rit
pujorsarn¦erpoq	V	–inngilaq
pujorsi¦orpoq	V	–unngilaq
pujorsiut	N	–ip, –it
pujorsu¦aq	N	–up, –it
pujorsunni	N	–p, –t
pujorsunni¦ppoq	V	–nngilaq
pujortaama¦voq	V	–nngilaq
pujortaas¦erpoq	V	–inngilaq
pujortaa¦serpoq	V	{–sinngilaq, –tilinngilaq}
pujortaassu¦aq	N	–up, –it
pujortaat	N	–ip, –it
pujortaat	N, pl.	-
pujortaatee¦raq	N	–qqap, –qqat
pujortaatisunni¦ppoq	V	–nngilaq
pujorta¦gaq	N	–kkap, –kkat
pujorta¦q	N	–p, –t
pujortarne¦q	N	–rup, –rit
pujorta¦rpoq	V	–nngilaq
pujortartarfi¦k	N	–up, –it
pujortarta¦rpoq	V	–nngilaq
pujortartart¦oq	N	–up, –ut
pujortartoqassanngilaq	V	(no generation)
pujortarumat¦ooq	N	–uup, –uut
pujortarunnaarne¦q	N	–rup, –rit
pujortarunnaa¦rpoq	V	–nngilaq
pujortataa¦rpoq	V	–nngilaq
pujortorsu¦uvoq	V	{–aanngilaq, –unngilaq}
pujortua¦raq	N	–qqap, –qqat
pujortuleeraa¦raq	N	–qqap, –qqat
pujortul¦eeraaraq	N	{–eeraaqqap, –iaraaqqap}, {–eeraaqqat, –iaraaqqat}
pujortulee¦raq	N	–qqap, –qqat
pujortul¦eeraq	N	{–eeqqap, –iaqqap}, {–eeqqat, –iaqqat}
pujortuleera¦rpoq	V	–nngilaq
pujortuleerarsi¦voq	V	–nngilaq
pujortul¦eerarsivoq	V	{–eerarsinngilaq, –iararsinngilaq}
pujortuleerartaa¦rpoq	V	–nngilaq
pujortul¦eerartaarpoq	V	{–eerartaanngilaq, –iarartaanngilaq}
pujortul¦ik	N	{–iup, –lip, –lup}, –lit
pujortulissu¦aq	N	–up, –it
pujortul¦issuaq	N	{–ersuup, –issuup}, {–ersuit, –issuit}
pujuaa¦rpoq	V	–nngilaq
pujualaannaa¦voq	V	–nngilaq
pujualaa¦voq	V	–nngilaq
pujuala¦k	N	–ap, –at
pujuallangaa¦rpoq	V	–nngilaq
pujualla¦ppoq	V	–nngilaq
pujuallattaa¦rpoq	V	–nngilaq
pujuanngu¦aq	N	–up, –it
pujuarpalu¦ppoq	V	–nngilaq
pujuarpaluttuinnaa¦voq	V	–nngilaq
pujuarpalu¦ttuinnaavoq	V	{–ssuinnaanngilaq, –ttuinnaanngilaq}
puju¦gaq	N	–kkap, –kkat
pujuinnaa¦voq	V	–nngilaq
pujuinna¦q	N	–ap, –at
pujunngakkiart¦orpoq	V	–unngilaq
pujunnga¦ppoq	V	–nngilaq
pujunnguu¦ppoq	V	–tinngilaq
pujuugaa¦voq	V	–nngilaq
pujuu¦gaq	N	–kkap, –kkat
pujuugarsunni¦ppoq	V	–nngilaq
pujuugassa¦q	N	–p, –t
pujuusat	N, pl.	-
pukaarpalu¦ppoq	V	–nngilaq
pukaarpaluttoqa¦rpoq	V	–nngilaq
pukagu¦ppaa	V	–tinngilaa
puka¦k	N	–ap, –at
puka¦ppoq	V	–nngilaq
pukassu¦aq	N	–up, –it
pukattorsuu¦voq	V	–nngilaq
pukattorsu¦uvoq	V	{–aanngilaq, –unngilaq}
puk¦eerpaa	V	–iinngilaa
puk¦eq	N	–ip, –it
pukeri¦ppoq	V	–nngilaq
pukert¦ooq	N	–uup, –uut
puki¦ppaa	V	–nngilaa
pukitsi¦voq	V	–nngilaq
pukkilialla¦k	N	–ap, –at
pukkilisi¦ppaa	V	–nngilaa
pukkili¦voq	V	–nngilaq
pukkilualla¦k	N	–ap, –at
pukkippallaal¦erpoq	V	–inngilaq
pukkippallaalersimaguna¦rpoq	V	–nngilaq
pukkippallaarsinnaavoq	V	(no generation)
pukki¦ppoq	V	–nngilaq
pukkits¦oq	N	–up, –ut
pukkitsormi¦oq	N	–up, –ut
pukkitsormiu	N	–p, –t
pukkitsuajaa¦q	N	–p, –t
pukkitsuli¦voq	V	–nngilaq
pukkitsut	N, pl.	-
pukk¦oq	N	–up, –ut
pukkul¦erpaa	V	–inngilaa
pukkutiinna¦rpaa	V	–nngilaa
pukkuti¦ppaa	V	–nngilaa
pukku¦voq	V	–nngilaq
puk¦oorpoq	V	–uunngilaq
pukukkat	N	–ip, –it
pukulugiani¦ppoq	V	–nngilaq
pukulugi¦aq	N	–ssap, –ssat
pukulungiani¦ppoq	V	–nngilaq
pukulungi¦aq	N	–ssap, –ssat
pukulungissat	N, pl.	-
pukulu¦ppoq	V	–nngilaq
pukulutsi¦ppaa	V	–nngilaa
pukulu¦tsippaa	V	{–ssinngilaa, –tsinngilaa}
pukuluttua¦rpoq	V	–nngilaq
pukunia¦rpoq	V	–nngilaq
puku¦ppaa	V	–nngilaa
puku¦ppoq	V	–nngilaq
pukussi¦voq	V	–nngilaq
pukusuttoqaaq	V	(no generation)
pukutsi¦voq	V	–nngilaq
pukutsuj¦oorpoq	V	–uunngilaq
pulaaffig¦aa	V	–inngilaa
pulaakatappoq	V	(no generation)
pulaalaa¦rpaa	V	–nngilaa
pulaalla¦ppoq	V	–nngilaq
pulaallatsiarpoq	V	(no generation)
pulaallatuarpoq	V	(no generation)
pulaaqattaa¦rpoq	V	–nngilaq
pulaarajuppoq	V	(no generation)
pulaarfig¦aa	V	–inngilaa
pulaarfissa¦q	N	–p, –t
pulaarne¦q	N	–rup, –rit
pulaarnia¦rpaa	V	–nngilaa
pulaa¦rpaa	V	–nngilaa
pulaa¦rpoq	V	–nngilaq
pulaarti¦ppaa	V	–nngilaa
pulaartitsine¦q	N	–rup, –rit
pulaartitsi¦voq	V	–nngilaq
pulaart¦oq	N	–up, –ut
pulaartoqa¦rpoq	V	–nngilaq
pulaaru¦ppaa	V	–tinngilaa
pulaassaa¦rpaa	V	–nngilaa
pulaa¦voq	V	–nngilaq
pulaffig¦aa	V	–inngilaa
pulaffigitinne¦q	N	–rup, –rit
pulajart¦orpoq	V	–unngilaq
pulakattarnaqaaq	V	(no generation)
pulakatta¦rpoq	V	–nngilaq
pulakkarna¦rpoq	V	–nngilaq
pulakkarne¦q	N	–rup, –rit
pulakka¦rpoq	V	–nngilaq
pulamajunnaa¦rpoq	V	–nngilaq
pulamasorsuu¦voq	V	–nngilaq
pulamasorsu¦uvoq	V	{–aanngilaq, –unngilaq}
pulama¦voq	V	–nngilaq
pulameqqajaavoq	V	(no generation)
pulameqqaja¦rpoq	V	–nngilaq
pulamingaja¦ppoq	V	–nngilaq
pulami¦ppoq	V	–nngilaq
pulamiti¦ppaa	V	–nngilaa
pulammagiaa¦voq	V	–nngilaq
pulammagi¦aq	N	–ssap, –ssat
pulammagiaqa¦rpoq	V	–nngilaq
pulamma¦ppoq	V	–nngilaq
pulaqqavi¦k	N	–up, –it
pulaqqavinnaa¦q	N	–p, –t
pulaqqaviu¦voq	V	–nngilaq
pulaqqa¦voq	V	–nngilaq
pular¦orpaa	V	–unngilaa
pular¦orpoq	V	–unngilaq
pularorsa¦rpaa	V	–nngilaa
pularrartoqaaq	V	(no generation)
pularrartu¦voq	V	–nngilaq
pulasa¦q	N	–p, –t
pulasarfi¦k	N	–up, –it
pulasa¦rpoq	V	–nngilaq
pulasine¦q	N	–rup, –rit
pulasi¦vaa	V	–nngilaa
pulasi¦voq	V	–nngilaq
pulas¦orpoq	V	–unngilaq
pulasorta¦q	N	–p, –t
pulassari¦ppoq	V	–nngilaq
pulassarivi¦ppoq	V	–nngilaq
pulateriaarsu¦k	N	–up, –it
pulateriaarsuusa¦q	N	–p, –t
pulateri¦aq	N	–ssap, –ssat
pulatiteri¦voq	V	–nngilaq
pulattaqqavi¦k	N	–up, –it
pulattarfeqa¦rpoq	V	–nngilaq
pulattarfi¦k	N	–up, –it
pulattarfiu¦voq	V	–nngilaq
pulatta¦rpoq	V	–nngilaq
pula¦vaa	V	–nngilaa
pula¦voq	V	–nngilaq
pullaa	N	–p, –t
pullaari¦ppoq	V	–nngilaq
pullaarnerit	N, pl.	-
pullaa¦rpaa	V	–nngilaa
pullaarpalla¦ppoq	V	–nngilaq
pullaa¦rpallappoq	V	{–pallanngilaq, –rpallanngilaq}
pullaa¦rpoq	V	–nngilaq
pullaaru¦ppoq	V	–tinngilaq
pullaase¦raq	N	–qqap, –qqat
pullaasera¦rpoq	V	–nngilaq
pullaat	N	–ip, –it
pullaat	N, pl.	-
pullal¦ik	N	{–iup, –lip, –lup}, –lit
pullalissu¦aq	N	–up, –it
pullal¦issuaq	N	{–ersuup, –issuup}, {–ersuit, –issuit}
pullangagaju¦ppoq	V	–nngilaq
pullangassaa¦rpoq	V	–nngilaq
pullanga¦voq	V	–nngilaq
pullanne¦q	N	–rup, –rit
pullanni¦ppoq	V	–nngilaq
pullannitsuu¦voq	V	–nngilaq
pullanni¦tsuuvoq	V	{–ssuunngilaq, –tsuunngilaq, –ttuunngilaq}
pulla¦ppaa	V	–nngilaa
pullap¦pallappoq	V	{–allanngilaq, –pallanngilaq}
pulla¦ppoq	V	–nngilaq
pulla¦q	N	–p, –t
pullaqanngilaq	V	(no generation)
pullaqa¦rpoq	V	–nngilaq
pullaqine¦q	N	–rup, –rit
pullaqi¦voq	V	–nngilaq
pullari¦ppoq	V	–nngilaq
pullartaartinne¦q	N	–rup, –rit
pullartaaru¦ppoq	V	–tinngilaq
pullartaasa¦q	N	–p, –t
pullartaninne¦q	N	–rup, –rit
pullarta¦q	N	–p, –t
pullas¦erpoq	V	–inngilaq
pulla¦serpoq	V	{–sinngilaq, –tilinngilaq}
pullasers¦orpoq	V	–unngilaq
pulla¦sersorpoq	V	{–sersunngilaq, –tilersunngilaq}
pullasia¦rpoq	V	–nngilaq
pullasi¦orpoq	V	–unngilaq
pulla¦siorpoq	V	{–siunngilaq, –tiliunngilaq}
pullassaatit	N, pl.	-
pullassimas¦oq	N	–up, –ut
pullat	N	–ip, –it
pullat	N, pl.	-
pullatsikkiart¦orpoq	V	–unngilaq
pullatsi¦ppoq	V	–nngilaq
pullatta¦gaq	N	–kkap, –kkat
pullatt¦oorpoq	V	–uunngilaq
pullatt¦oq	N	–up, –ut
pullattorsuu¦voq	V	–nngilaq
pullattorsu¦uvoq	V	{–aanngilaq, –unngilaq}
pullavig¦aa	V	–inngilaa
pullavi¦k	N	–up, –it
pullavissaaru¦ppoq	V	–tinngilaq
pull¦erpoq	V	–inngilaq
pump¦erpaa	V	–inngilaa
punne¦q	N	–rup, –rit
punnerna¦q	N	–p, –t
punn¦erpaa	V	–inngilaa
punnersi¦voq	V	–nngilaq
punnerusaa¦q	N	–p, –t
punnerusivi¦k	N	–up, –it
punngajua¦rpoq	V	–nngilaq
punngaria¦rpoq	V	–nngilaq
punngars¦orpoq	V	–unngilaq
punngavallaa¦rpoq	V	–nngilaq
punnga¦voq	V	–nngilaq
punnguj¦oorpoq	V	–uunngilaq
punngujooru¦ppaa	V	–tinngilaa
punnil¦erpaa	V	–inngilaa
punniliorfi¦k	N	–up, –it
punnili¦orpoq	V	–unngilaq
pupeerulluinna¦rpoq	V	–nngilaq
pupeerullu¦innarpoq	V	{–innanngilaq, –aannanngilaq}
pupeeru¦ppoq	V	–tinngilaq
pupeerutt¦oq	N	–up, –ut
pupiit	N, pl.	-
pupi¦k	N	–up, –it
pupilla¦k	N	–ap, –at
pupilla¦ppoq	V	–nngilaq
pupinne¦q	N	–rup, –rit
pupinnersu¦aq	N	–up, –it
pupi¦ppoq	V	–nngilaq
pupiss¦oq	N	–up, –ut
pupi¦ssoq	N	{–ssup, –ttup}, {–ssut, –ttut}
pupissu¦aq	N	–up, –it
pupittariarne¦q	N	–rup, –rit
pupiusaa¦q	N	–p, –t
pupiusaaqa¦rpoq	V	–nngilaq
pupiusa¦q	N	–p, –t
pu¦ppoq	V	–nngilaq
puseqattaallaqqi¦ppoq	V	–nngilaq
puseqattaa¦rpoq	V	–nngilaq
pusigaa¦ppaa	V	–tinngilaa
pusigarne¦q	N	–rup, –rit
pusiga¦rpoq	V	–nngilaq
pusigarti¦ppaa	V	–nngilaa
pusigart¦oorpoq	V	–uunngilaq
pusigu¦ppaa	V	–tinngilaa
pusigussa¦q	N	–p, –t
pusingaa¦rpoq	V	–nngilaq
pusinga¦voq	V	–nngilaq
pusi¦ppaa	V	–nngilaa
pusi¦ppoq	V	–nngilaq
pusisaa¦voq	V	–nngilaq
pusisa¦q	N	–p, –t
pusita¦q	N	–p, –t
pusiti¦ppaa	V	–nngilaa
pusit¦ippaa	V	–sinngilaa
pusitsi¦voq	V	–nngilaq
pusitt¦oorpoq	V	–uunngilaq
pusittoorti¦ppaa	V	–nngilaa
pussar¦aa	V	–inngilaa
pussarillaqqi¦ppoq	V	–nngilaq
pussarisa¦rpoq	V	–nngilaq
pussari¦vaa	V	–nngilaa
pussari¦voq	V	–nngilaq
pussarus¦erpaa	V	–inngilaa
pussaru¦serpaa	V	{–sinngilaa, –tilinngilaa}
pussarut	N	–ip, –it
pussinna¦rpoq	V	–nngilaq
puss¦oq	N	–up, –ut
pussoqaqaaq	V	(no generation)
pussorne¦q	N	–rup, –rit
puss¦orpaa	V	–unngilaa
puss¦orpoq	V	–unngilaq
pussortorpaa	V	(no generation)
pussort¦orpoq	V	–unngilaq
pussor¦torpoq	V	{–sunngilaq, –tunngilaq}
pussua¦rpaa	V	–nngilaa
pussu¦gaq	N	–kkap, –kkat
pussugi¦ppoq	V	–nngilaq
pussugu¦ppoq	V	–tinngilaq
pussugutaars¦erpoq	V	–inngilaq
pussuguteeqqat	N	–ip, –it
pussugutit	N	–ip, –it
pussuinna¦rpaa	V	–nngilaa
pussuinna¦rpoq	V	–nngilaq
pussu¦k	N	–up, –it
pussukilliorna¦rpoq	V	–nngilaq
pussukinnartuleri¦voq	V	–nngilaq
pussukinnartuli¦orpoq	V	–unngilaq
pussukinnartuliort¦oq	N	–up, –ut
pussuki¦ppoq	V	–nngilaq
pussukulaa¦rpoq	V	–nngilaq
pussukula¦voq	V	–nngilaq
pussukullatta¦rpoq	V	–nngilaq
pussukumiallaqqissu¦seq	N	–tsip, –tsit
pussukumiart¦oq	N	–up, –ut
pussulaa¦rpoq	V	–nngilaq
pussummi¦ppaa	V	–nngilaa
pussunga¦voq	V	–nngilaq
pussunne¦q	N	–rup, –rit
pussu¦ppaa	V	–nngilaa
pussu¦ppoq	V	–nngilaq
pussutsi¦ppaa	V	–nngilaa
pussutsi¦ppoq	V	–nngilaq
pussuttart¦oq	N	–up, –ut
pussuut	N	–ip, –it
puterna¦rpoq	V	–nngilaq
put¦oorpaa	V	–uunngilaa
put¦oorpoq	V	–uunngilaq
putoorti¦ppaa	V	–nngilaa
putoort¦oq	N	–up, –ut
putoortuliorfi¦k	N	–up, –it
putoortuli¦orpoq	V	–unngilaq
putoortuliuut	N	–ip, –it
putoortut	N, pl.	-
putoorut	N	–ip, –it
putoorutee¦raq	N	–qqap, –qqat
putoorutt¦oq	N	–up, –ut
put¦oq	N	–up, –ut
putoqqagaju¦ppoq	V	–nngilaq
putoqqagajutt¦oq	N	–up, –ut
putoqqalaarne¦q	N	–rup, –rit
putoqqal¦erpoq	V	–inngilaq
putoqqalluinna¦rpoq	V	–nngilaq
putoqqalluinnart¦oq	N	–up, –ut
putoqqallu¦innartoq	N	{–aannartup, –innartup}, {–aannartut, –innartut}
putoqqas¦oq	N	–up, –ut
putoqqasorujussu¦aq	N	–up, –it
putoqqasorujussu¦uneq	N	{–aanerup, –unerup}, {–aanerit, –unerit}
putoqqasorujussu¦usoq	N	{–aasup, –usup}, {–aasut, –usut}
putoqqasorujussu¦uvoq	V	{–aanngilaq, –unngilaq}
putoqqati¦ppaa	V	–nngilaa
putoqqati¦ppoq	V	–nngilaq
putoqqa¦voq	V	–nngilaq
putoqquffi¦k	N	–up, –it
putoqquffissa¦q	N	–p, –t
putoqqu¦ppaa	V	–tinngilaa
putoqqu¦ppoq	V	–tinngilaq
putoqqussa¦q	N	–p, –t
putoqqutiti¦ppaa	V	–nngilaa
putoqqut¦itippaa	V	{–itsinngilaa, –itinngilaa, –sinngilaa}
putserajuppoq	V	(no generation)
putseraluttuinna¦rpoq	V	–nngilaq
puts¦erpoq	V	–inngilaq
putsiliu¦ppaa	V	–tinngilaa
putsiliussaa¦voq	V	–nngilaq
putsinne¦q	N	–rup, –rit
putsiorne¦q	N	–rup, –rit
putsi¦orpaa	V	–unngilaa
putsi¦ppaa	V	–nngilaa
putsi¦ppoq	V	–nngilaq
putsiugaa¦voq	V	–nngilaq
putsiu¦gaq	N	–kkap, –kkat
putsiugassa¦q	N	–p, –t
putsuarikkunnaa¦rpoq	V	–nngilaq
putsuari¦ppoq	V	–nngilaq
putsuarissi¦voq	V	–nngilaq
putsuarivi¦ppoq	V	–nngilaq
puttaanngu¦aq	N	–up, –it
puttaa¦q	N	–p, –t
puttaa¦rpoq	V	–nngilaq
puttalaa¦rpoq	V	–nngilaq
puttala¦voq	V	–nngilaq
puttallaa¦ppaa	V	–tinngilaa
puttallari¦ppoq	V	–nngilaq
puttallarlu¦ppoq	V	–nngilaq
puttalla¦rpoq	V	–nngilaq
puttallarsa¦rpaa	V	–nngilaa
puttallartaat	N	–ip, –it
puttallarti¦ppaa	V	–nngilaa
puttallua¦rpaa	V	–nngilaa
puttalluarsinnaa¦vaa	V	–nngilaa
putta¦ppaa	V	–nngilaa
puttaqatsi¦voq	V	–nngilaq
puttaqus¦erpaa	V	–inngilaa
puttaqu¦serpaa	V	{–sinngilaa, –tilinngilaa}
puttaqut	N	–ip, –it
puttaqutaa¦voq	V	–nngilaq
puttarsiit	N	–ip, –it
puttarsisa¦q	N	–p, –t
puttarsi¦vaa	V	–nngilaa
puttarsi¦voq	V	–nngilaq
puttasia	N	–p, –t
puttas¦oq	N	–up, –ut
puttassisinnaassu¦seq	N	–tsip, –tsit
puttassi¦voq	V	–nngilaq
puttasu¦ppoq	V	–nngilaq
putta¦voq	V	–nngilaq
puttort¦ooq	N	–uup, –uut
puttortu¦voq	V	–nngilaq
puttuffig¦aa	V	–inngilaa
puttuffi¦k	N	–up, –it
puttuffiu¦voq	V	–nngilaq
puttu¦ppaa	V	–tinngilaa
puttu¦ppoq	V	–tinngilaq
puttusima¦voq	V	–nngilaq
puttusi¦orpoq	V	–unngilaq
puttu¦siorpoq	V	{–siunngilaq, –tiliunngilaq}
puttut	N	–ip, –it
puttut	N, pl.	-
puttutaa¦voq	V	–nngilaq
puttutig¦aa	V	–inngilaa
puttutigivi¦ppaa	V	–nngilaa
puttutt¦oorpoq	V	–uunngilaq
putu	N	–p, –t
putu¦aa	V	–nngilaa
putua¦q	N	–p, –t
putu¦gaq	N	–kkap, –kkat
putu¦goq	N	–kkup, –kkut
putugormi¦ppoq	V	–nngilaq
putugumia¦rpoq	V	–nngilaq
putugumiart¦orpoq	V	–unngilaq
putuia¦rpoq	V	–nngilaq
putujart¦orpoq	V	–unngilaq
putukkumia¦rpoq	V	–nngilaq
putul¦ik	N	{–iup, –lip, –lup}, –lit
putuliu¦gaq	N	–kkap, –kkat
putuliuut	N	–ip, –it
putulluinna¦rpoq	V	–nngilaq
putullu¦innarpoq	V	{–innanngilaq, –aannanngilaq}
putumagaju¦ppoq	V	–nngilaq
putumagajutt¦oq	N	–up, –ut
putumallu¦innartoq	N	{–aannartup, –innartup}, {–aannartut, –innartut}
putumane¦q	N	–rup, –rit
putumas¦oq	N	–up, –ut
putumasorujussu¦aq	N	–up, –it
putumasorujussu¦uneq	N	{–aanerup, –unerup}, {–aanerit, –unerit}
putumasorujussu¦usoq	N	{–aasup, –usup}, {–aasut, –usut}
putumasorujussu¦uvoq	V	{–aanngilaq, –unngilaq}
putumavallaaqaaq	V	(no generation)
putuma¦voq	V	–nngilaq
putummas¦erpoq	V	–inngilaq
putummattorsuit	N, pl.	-
putunertu¦voq	V	–nngilaq
putunngatig¦aa	V	–inngilaa
putunngatigivi¦ppaa	V	–nngilaa
putunnguu¦tilerneq	N	{–tilernerup, –sernerup, –tsilernerup}, {–tilernerit, –sernerit, –tsilernerit}
putusaarine¦q	N	–rup, –rit
putusaa¦rpaa	V	–nngilaa
putusaa¦rpoq	V	–nngilaq
putusaarutaas¦oq	N	–up, –ut
putusa¦q	N	–p, –t
putusima¦voq	V	–nngilaq
putusoorne¦q	N	–rup, –rit
putus¦oorpoq	V	–uunngilaq
putus¦oq	N	–up, –ut
putussarsi¦voq	V	–nngilaq
pututi¦ppaa	V	–nngilaa
putuukkat	N, pl.	-
putuut	N	–ip, –it
putu¦voq	V	–nngilaq
puualla¦ppoq	V	–nngilaq
puuanii¦ppoq	V	–nngilaq
puuara¦rpoq	V	–nngilaq
puugaa¦voq	V	–nngilaq
puu¦gaq	N	–kkap, –kkat
puugutaa¦raq	N	–qqap, –qqat
puugutaasa¦q	N	–p, –t
puugutaasat	N, pl.	-
puugut¦aq	N	{–ap, –tap}, {–at, –tat}
puugutarsi¦voq	V	–nngilaq
puugutarsu¦aq	N	–up, –it
puuguts¦erpoq	V	–inngilaq
puugutsi¦orpoq	V	–unngilaq
puugutsiu¦ppaa	V	–tinngilaa
puugutsi¦voq	V	–nngilaq
puuiaanngilaq	V	(no generation)
puuiaa¦voq	V	–nngilaq
puu¦iaavoq	V	{–ajaanngilaq, –iaanngilaq}
puuia¦rpaa	V	–nngilaa
puu¦iarpaa	V	{–ajanngilaa, –ianngilaa}
puujutaa	N	–p, –t
puukkaluttuinna¦rpoq	V	–nngilaq
puukulla¦k	N	–ap, –at
puul¦ik	N	{–iup, –lip, –lup}, –lit
puulinng¦orpoq	V	–unngilaq
puulittaa¦voq	V	–nngilaq
puulit¦taavoq	V	{–aanngilaq, –taanngilaq}
puuliu¦voq	V	–nngilaq
puullaaqine¦q	N	–rup, –rit
puullaaqi¦voq	V	–nngilaq
puulla¦k	N	–ap, –at
puullinganaqaaq	V	(no generation)
puullinga¦voq	V	–nngilaq
puulluinna¦rpoq	V	–nngilaq
puuluk¦erpaa	V	–inngilaa
puulukersu¦aq	N	–up, –it
puuluki	N	–p, –t
puulukia¦raq	N	–qqap, –qqat
puuluk¦iaraq	N	{–eeqqap, –iaqqap}, {–eeqqat, –iaqqat}
puulukimine¦q	N	–rup, –rit
puulukim¦ineq	N	–ernup, –ernit
puulukis¦orpoq	V	–unngilaq
puuluki¦sorpoq	V	{–sunngilaq, –tunngilaq}
puuluki¦torpoq	V	{–sunngilaq, –tunngilaq}
puulukiusa¦q	N	–p, –t
puuluttaaru¦ppoq	V	–tinngilaq
puulutta¦q	N	–p, –t
puuluttaqa¦rpoq	V	–nngilaq
puumigaaqaaq	V	(no generation)
puumigaa¦rpoq	V	–nngilaq
puumikkiart¦orpoq	V	–unngilaq
puumi¦ppoq	V	–nngilaq
puumisaarpoq	V	(no generation)
puumittaarne¦q	N	–rup, –rit
puumi¦ttaarneq	N	{–ssaarnerup, –ttaarnerup}, {–ssaarnerit, –ttaarnerit}
puumittaa¦rpoq	V	–nngilaq
puungagaju¦ppoq	V	–nngilaq
puungaqaaq	V	(no generation)
puungas¦oq	N	–up, –ut
puunga¦voq	V	–nngilaq
puunne¦q	N	–rup, –rit
puunngakkaluttuinna¦rpoq	V	–nngilaq
puunnga¦ppoq	V	–nngilaq
puunngassimaarpoq	V	(no generation)
puunngatsi¦ppaa	V	–nngilaa
puunngu¦aq	N	–up, –it
puunsi	N	(no generation)
puupa¦ppoq	V	–nngilaq
puupavi¦ppoq	V	–nngilaq
puupiinganaqaaq	V	(no generation)
puupiinga¦voq	V	–nngilaq
puu¦ppoq	V	–nngilaq
puussaa¦rpaa	V	–nngilaa
puussaaru¦ppoq	V	–tinngilaq
puussa¦q	N	–p, –t
puussaqa¦rpoq	V	–nngilaq
puussarsi¦orpoq	V	–unngilaq
puussarsi¦voq	V	–nngilaq
puussia¦q	N	–p, –t
puussiaqa¦rpoq	V	–nngilaq
puussimaarpoq	V	(no generation)
puutsitaa¦voq	V	–nngilaq
påskesiorpoq	V	(no generation)
pædagogikki	N	(no generation)
