Lexeme	WC	Flexion
IA	Prop	–ip
iaamina¦rpoq	V	–nngilaq
iaarna¦rpoq	V	–nngilaq
iangas¦oorpoq	V	–uunngilaq
ianga¦voq	V	–nngilaq
iarraa	Interj	(no generation)
iasilaa¦rpoq	V	–nngilaq
iasilaraluttuaq	Interj	(no generation)
iasilat	Interj	(no generation)
ias¦oorpoq	V	–uunngilaq
iata¦ppoq	V	–nngilaq
ICC	Prop	–ip
Idealisten	Prop	–ip
iffaats¦oq	N	–up, –ut
iffari¦ppoq	V	–nngilaq
iffarissaa¦rpoq	V	–nngilaq
iffas¦erpaa	V	–inngilaa
iffas¦erpoq	V	–inngilaq
iffialia¦q	N	–p, –t
iffialiorfi¦k	N	–up, –it
iffia¦q	N	–p, –t
iffia¦rpoq	V	–nngilaq
iffiarsiniarajutta¦rpoq	V	–nngilaq
iffiarsinia¦rajuttarpoq	V	{–kkajuttanngilaq, –rajuttanngilaq}
iffiar¦torpoq	V	{–sunngilaq, –tunngilaq}
iffiassat	N, pl.	-
iffiassiassat	N, pl.	-
iffi¦gaq	N	–kkap, –kkat
iffiorfi¦k	N	–up, –it
iffiorne¦q	N	–rup, –rit
iffi¦orpoq	V	–unngilaq
iffiort¦oq	N	–up, –ut
iffi¦ppoq	V	–nngilaq
iffiu¦gaq	N	–kkap, –kkat
iffiugassangas¦oq	N	–up, –ut
iffiugassa¦q	N	–p, –t
iffiukatannerarpoq	V	(no generation)
iga	N	–p, –t
ig¦aa	V	–inngilaa
igaa¦q	N	–p, –t
igaa¦raq	N	–qqap, –qqat
igaa¦rpoq	V	–nngilaq
igaarsunni¦ppoq	V	–nngilaq
igaart¦orpoq	V	–unngilaq
igaar¦torpoq	V	{–sunngilaq, –tunngilaq}
igaasa¦q	N	–p, –t
igaasaria¦rpoq	V	–nngilaq
igaasa¦rpoq	V	–nngilaq
igaassa¦q	N	–p, –t
igaffi¦k	N	–up, –it
igaja¦k	N	–ap, –at
igajumalerpoq	V	(no generation)
igalaaju¦voq	V	–nngilaq
igalaal¦erpaa	V	–inngilaa
igala¦alerpaa	V	{–alinngilaa, –ssinngilaa}
igalaalersortariaqa¦rpaa	V	–nngilaa
igalaalersussa¦vaa	V	–nngilaa
igalaali¦orpoq	V	–unngilaq
igalaaliort¦oq	N	–up, –ut
igalaamernit	N, pl.	-
igalaam¦ineq	N	–ernup, –ernit
igalaa¦q	N	–p, –t
igalaartaasa¦q	N	–p, –t
igalaarta¦q	N	–p, –t
igalaasa¦q	N	–p, –t
igalaasa¦rpoq	V	–nngilaq
igalaasarta¦q	N	–p, –t
igalaasart¦ooq	N	–uup, –uut
igalaassa¦q	N	–p, –t
igalaassat	N, pl.	-
igalaassia¦q	N	–p, –t
igalasserfi¦k	N	–up, –it
igala¦sserfik	N	{–alerfiup, –sserfiup}, {–alerfiit, –sserfiit}
igala¦sserpaa	V	{–alinngilaa, –ssinngilaa}
igalassers¦orpaa	V	–unngilaa
igala¦ssiivoq	V	{–aliinngilaq, –ssiinngilaq}
igalassi¦orpoq	V	–unngilaq
igalassiu¦ppaa	V	–tinngilaa
igala¦ssiuppaa	V	{–aliutinngilaa, –ssiutinngilaa}
igal¦eq	N	–ip, –it
Igaliku	Prop	–p
igalil¦ik	N	{–iup, –lip, –lup}, –lit
igane¦q	N	–rup, –rit
igannguanngilaq	V	(no generation)
iganngua¦rpoq	V	–nngilaq
iga¦q	N	–p, –t
igas¦oq	N	–up, –ut
iga¦vaa	V	–nngilaa
iga¦voq	V	–nngilaq
igeeqqaa¦vik	N	{–ffiup, –viup}, {–ffiit, –viit}
igeeqqaa¦voq	V	–nngilaq
igeriussi¦vik	N	{–ffiup, –viup}, {–ffiit, –viit}
igerpalla¦ppoq	V	–nngilaq
ig¦erpallappoq	V	{–erpallanngilaq, –ipallanngilaq}
igg	Interj	(no generation)
igga¦ppaa	V	–sinngilaa
iggari¦ppoq	V	–nngilaq
iggarissaa¦rpoq	V	–nngilaq
iggarissu¦seq	N	–tsip, –tsit
iggas¦erpoq	V	–inngilaq
iggassi¦voq	V	–nngilaq
iggavig¦aa	V	–inngilaa
iggavi¦k	N	–up, –it
iggeeru¦ppoq	V	–tinngilaq
iggerisuu¦voq	V	–nngilaq
iggeri¦voq	V	–nngilaq
iggersaa¦rpoq	V	–nngilaq
iggiaa¦rpaa	V	–nngilaa
iggi¦aq	N	–ssap, –ssat
iggiaqanngilaq	V	(no generation)
iggiari¦ppoq	V	–nngilaq
iggiarissa¦rpoq	V	–nngilaq
iggiari¦ssarpoq	V	–ttanngilaq
iggiarlunne¦q	N	–rup, –rit
iggiarlu¦ppoq	V	–nngilaq
iggiingaanna¦rpoq	V	–nngilaq
iggiinga¦voq	V	–nngilaq
iggiinnga¦rpoq	V	–nngilaq
iggi¦ppaa	V	–nngilaa
iggisaa¦voq	V	–nngilaq
iggis¦erpaa	V	{–ilinngilaa, –inngilaa}
iggisi¦ivoq	V	{–inngilaq, –liinngilaq}
iggisissa¦q	N	–p, –t
iggissa¦q	N	–p, –t
iggissi¦voq	V	–nngilaq
iggi¦t	N	–sip, –sit
iggoraarsunnguaq	Interj	(no generation)
iggu	Interj	(no generation)
igguagassa¦q	N	–p, –t
iggullua¦rpoq	V	–nngilaq
iggu¦ppaa	V	–nngilaa
iggut	N	–ip, –it
iggutee¦raq	N	–qqap, –qqat
igiinnarsima¦voq	V	–nngilaq
igiinnartari¦aq	N	{–ssap, –ap}, {–ssat, –at}
igiinnartari¦aq	N	–ssap, –ssat
igikkiartorsinnaassavaa	V	(no generation)
igikkumanngilaa	V	(no generation)
igil¦eq	N	–ip, –it
igimaa¦q	N	–p, –t
igim¦aq	N	{–ap, –map}, {–at, –mat}
igima¦rpaa	V	–nngilaa
igimartaa¦rpoq	V	–nngilaq
igine¦q	N	–rup, –rit
iginne¦q	N	–rup, –rit
iginnerusisa¦rpoq	V	–nngilaq
iginnerutaaru¦ppoq	V	–tinngilaq
Iginniarfi¦k	N	–up, –it
Iginniarfi¦k	Prop	–up, –it
iginnia¦rpaa	V	–nngilaa
iginnia¦rpoq	V	–nngilaq
igi¦ppaa	V	–nngilaa
igi¦ppoq	V	–nngilaq
igisa¦rpoq	V	–nngilaq
igis¦oorpoq	V	–uunngilaq
igissima¦vaa	V	–nngilaa
igitaasivissu¦aq	N	–up, –it
igitaa¦voq	V	–nngilaq
igita¦q	N	–p, –t
igitassaannaa¦voq	V	–nngilaq
igitassaanngilaq	V	(no generation)
igitassaa¦voq	V	–nngilaq
igitassa¦q	N	–p, –t
igitassat	N, pl.	-
igitat	N, pl.	-
igiti¦ppaa	V	–nngilaa
igi¦tippaa	V	{–sinngilaa, –tinngilaa, –tsinngilaa}
igits¦erpaa	V	–inngilaa
igitsia¦q	N	–p, –t
igitsii¦vaa	V	–nngilaa
igitsii¦voq	V	–nngilaq
igitsine¦q	N	–rup, –rit
igitsisaanna¦rpoq	V	–nngilaq
igitsissu¦aq	N	–up, –it
igitsi¦t	N	–sip, –sit
igitsivig¦aa	V	–inngilaa
igitsi¦vigaa	V	{–ffiginngilaa, –viginngilaa}
igitsi¦voq	V	–nngilaq
igiula¦voq	V	–nngilaq
igi¦voq	V	–nngilaq
igul¦eq	N	–ip, –it
igunalaa¦rpoq	V	–nngilaq
igun¦aq	N	–nap, –nat
igunarni¦ppoq	V	–nngilaq
iguna¦rpoq	V	–nngilaq
igunars¦erpaa	V	–inngilaa
igunarsii¦voq	V	–nngilaq
igu¦ppaa	V	–nngilaa
igutsaa¦raq	N	–qqap, –qqat
igutsa¦k	N	–ap, –at
igutsassu¦aq	N	–up, –it
igutsine¦q	N	–rup, –rit
igutsis¦oq	N	–up, –ut
igutsi¦voq	V	–nngilaq
iguut	N	–ip, –it
iguutaaru¦ppoq	V	–tinngilaq
iguutaarutivi¦ppoq	V	–nngilaq
iguutil¦ik	N	{–iup, –lip, –lup}, –lit
ii	Interj	(no generation)
ii¦gaq	N	–kkap, –kkat
iigarfi¦k	N	–up, –it
iigarfil¦ik	N	{–iup, –lip, –lup}, –lit
iigarmiu	N	–p, –t
iigarne¦q	N	–rup, –rit
iiga¦rpoq	V	–nngilaq
iigartarfi¦k	N	–up, –it
iigartart¦oq	N	–up, –ut
iigart¦erpoq	V	–inngilaq
iigarti¦ppaa	V	–nngilaa
iigassialers¦orpaa	V	–unngilaa
iigassia¦q	N	–p, –t
iigu¦ppaa	V	–nngilaa
iikajas¦oq	N	–up, –ut
iikajataa¦rpoq	V	–nngilaq
iikaja¦voq	V	–nngilaq
iikkanii¦ppoq	V	–nngilaq
iikkat	N, pl.	-
iikk¦erpaa	V	–inngilaa
iikkers¦orpaa	V	–unngilaa
iikkersui¦voq	V	–nngilaq
iikker¦suutit	N, pl.	{–suutit, –tuutit}
iilaanngits¦oq	N	–up, –ut
iilaa¦voq	V	–nngilaq
iila¦k	N	–ap, –at
iil¦erpaa	V	–inngilaa
iillari¦ppoq	V	–nngilaq
iillari¦ssoq	N	{–ssup, –ttup}, {–ssut, –ttut}
iillarissu¦seq	N	–tsip, –tsit
iiminaqaaq	V	(no generation)
iimisaa¦rpoq	V	–nngilaq
iimi¦voq	V	–nngilaq
iingag¦aa	V	–inngilaa
iingagivallaaqaa	V	(no generation)
iingalas¦oq	N	–up, –ut
iingala¦voq	V	–nngilaq
iingas¦oq	N	–up, –ut
iinga¦voq	V	–nngilaq
iioraasi¦ppaa	V	–nngilaa
iioraas¦oq	N	–up, –ut
iioraa¦voq	V	–nngilaq
iiora¦rpaa	V	–nngilaa
iipileernia¦rpoq	V	–nngilaq
iipili	N	–p, –t
iipiliilatsi¦voq	V	–nngilaq
iipilisi¦voq	V	–nngilaq
iipili¦torpoq	V	{–sunngilaq, –tunngilaq}
iisaars¦erpoq	V	–inngilaq
iisa¦q	N	–p, –t
iisaqanngilaq	V	(no generation)
iisaqa¦rpoq	V	–nngilaq
iisaqusanne¦q	N	–rup, –rit
iisaqusa¦ppoq	V	–nngilaq
iisaqusa¦q	N	–p, –t
iisarta¦gaq	N	–kkap, –kkat
iisartagar¦torpoq	V	{–sunngilaq, –tunngilaq}
iisassa¦q	N	–p, –t
iisasseri¦voq	V	–nngilaq
iisat	N, pl.	-
iisilluanngilaq	V	(no generation)
iisine¦q	N	–rup, –rit
iisinngilaq	V	(no generation)
iisinnginniarfi¦k	N	–up, –it
iisinnginniarne¦q	N	–rup, –rit
iisinnginniarpoq	V	(no generation)
iisis¦oq	N	–up, –ut
iisi¦voq	V	–nngilaq
iisorniut	N	–ip, –it
iisorta¦q	N	–p, –t
iitanna¦rpoq	V	–nngilaq
iita¦ppoq	V	–nngilaq
iitsallari¦ppoq	V	–nngilaq
iitsallari¦ssoq	N	{–ssup, –ttup}, {–ssut, –ttut}
iitsallarissu¦seq	N	–tsip, –tsit
iitsiveeru¦ppoq	V	–tinngilaq
ii¦vaa	V	–nngilaa
iivangkiiliu	N	–p, –t
iivangkiiliulersaa¦rpoq	V	–nngilaq
iivangkiiliulersaart¦oq	N	–up, –ut
iivangkiiliuler¦saartoq	N	{–saartup, –taartup}, {–saartut, –taartut}
iivangkilisti	N	–p, –t
ikaali¦orpoq	V	–unngilaq
ikaaliortitsi¦voq	V	–nngilaq
ikaa¦ppaa	V	–tinngilaa
ikaa¦q	N	–p, –t
ikaaqquvoq	V	(no generation)
ikaari¦aq	N	–ssap, –ssat
ikaariarmiu	N	–p, –t
ikaa¦rpaa	V	–nngilaa
ikaa¦rpoq	V	–nngilaq
ikaarsaa¦rpoq	V	–nngilaq
ikaarsimaarne¦q	N	–rup, –rit
ikaarsimaa¦rpoq	V	–nngilaq
ikaartaa¦rpoq	V	–nngilaq
ikaartaasi¦orpoq	V	–unngilaq
ikaartaa¦siorpoq	V	{–siunngilaq, –tiliunngilaq}
ikaartaat	N	–ip, –it
ikaartaat	N, pl.	-
ikaartarfi¦k	N	–up, –it
ikaarti¦ppaa	V	–nngilaa
ikaarti¦ppoq	V	–nngilaq
ikaartitaa¦rpoq	V	–nngilaq
ikaartiterine¦q	N	–rup, –rit
ikaartiteris¦oq	N	–up, –ut
ikaartiteri¦voq	V	–nngilaq
ikaartit¦erpaa	V	–inngilaa
ikaartiti¦gaq	N	–kkap, –kkat
ikaartit¦igaq	N	{–ikkap, –sikkap}, {–ikkat, –sikkat}
ikaartitsi¦voq	V	–nngilaq
ikaartortarfi¦k	N	–up, –it
ikaar¦tortarfik	N	{–sortarfiup, –tortarfiup}, {–sortarfiit, –tortarfiit}
ikaaru¦ppaa	V	–tinngilaa
ikaaru¦serpaa	V	{–sinngilaa, –tilinngilaa}
ikaaru¦serpaa	V	–tilinngilaa
ikaarussine¦q	N	–rup, –rit
ikaarut	N	–ip, –it
ikaarutsiu¦ppaa	V	–tinngilaa
ikaarut¦siuppaa	V	{–italiutinngilaa, –siutinngilaa}
ikaarutsiu¦ppoq	V	–tinngilaq
ikaasaa¦q	N	–p, –t
ikaasi¦orpoq	V	–unngilaq
ikaa¦siorpoq	V	{–siunngilaq, –tiliunngilaq}
ikaassa¦q	N	–p, –t
ikaassisart¦oq	N	–up, –ut
ikaassis¦oq	N	–up, –ut
ikaassi¦voq	V	–nngilaq
ikaassui¦voq	V	–nngilaq
ikaat	N	–ip, –it
ikaat	N, pl.	-
ikaataa¦voq	V	–nngilaq
ikaatit	N, pl.	-
ikajuu¦serpaa	V	{–sinngilaa, –tilinngilaa}
ikajuut	N	–ip, –it
ikajuutaars¦erpoq	V	–inngilaq
ikakkajuppoq	V	(no generation)
ikakkumatuvoq	V	(no generation)
Ikamiut	Prop, pl.	-
ikanii¦ppoq	V	–nngilaq
ikanii¦tippaa	V	{–sinngilaa, –tinngilaa, –tsinngilaa}
ikanne¦q	N	–rup, –rit
ika¦ppoq	V	–nngilaq
ikaqasiu¦ppaa	V	–tinngilaa
ikaqa¦siuppaa	V	{–siutinngilaa, –tiliutinngilaa}
ikaqat	N	–ip, –it
ikaqataa¦voq	V	–nngilaq
ikasaatig¦aa	V	–inngilaa
ikasa¦rpoq	V	–nngilaq
ikasarumat¦ooq	N	–uup, –uut
ikatitsi¦voq	V	–nngilaq
ikatsitsi¦voq	V	–nngilaq
ikattut	N, pl.	-
ikatu¦voq	V	–nngilaq
ike¦q	N	–rup, –rit
ikeqa¦rpoq	V	–nngilaq
Ikerasaarsu¦k	N	–up, –it
Ikerasaarsu¦k	Prop	–up, –it
ikerasaatsia¦q	N	–ap, –at
Ikerasa¦k	N	–ap, –at
Ikerasa¦k	Prop	–ap
ikerasa¦k	N	–ap, –at
ikerasakits¦oq	N	–up, –ut
ikerasalia¦q	N	–p, –t
Ikerasassu¦aq	N	–up, –it
Ikerasassu¦aq	Prop	–up, –it
ikerats¦erpoq	V	–inngilaq
ik¦erinnaaniippoq	V	{–erinnaaniinngilaq, –iinnaaniinngilaq}
ik¦erinnaq	N	{–erinnaap, –iinnaap}, {–erinnaat, –iinnaat}
ik¦erinnarmiippoq	V	{–erinnarmiinngilaq, –iinnarmiinngilaq}
ikerinnarsi¦orpoq	V	–unngilaq
ik¦erinnarsiorpoq	V	{–erinnarsiunngilaq, –iinnarsiunngilaq}
ikerinnarsiortart¦oq	N	–up, –ut
ik¦erinnarsiortartoq	N	{–erinnarsiortartup, –iinnarsiortartup}, {–erinnarsiortartut, –iinnarsiortartut}
ikeritsu¦voq	V	–nngilaq
ikernguaaru¦ppoq	V	–tinngilaq
ikerngu¦aq	N	–ssap, –ssat
ikernuaaru¦ppoq	V	–tinngilaq
ikernu¦aq	N	–ssap, –ssat
ikernu¦k	N	–up, –it
ikern¦usserpaa	V	{–gussinngilaa, –ulinngilaa, –ussinngilaa}
ikerpa¦rpoq	V	–nngilaq
ikerpasi¦ppoq	V	–nngilaq
ik¦erpoq	V	–inngilaq
ikersi¦orpoq	V	–unngilaq
ikersi¦ppaa	V	–nngilaa
ikersi¦ppoq	V	–nngilaq
ikersisima¦voq	V	–nngilaq
ikersis¦imavoq	V	–simanngilaq
ikersissima¦voq	V	–nngilaq
Ikersu¦aq	N	–up, –it
ikert¦ooq	N	–uup, –uut
ikertu¦voq	V	–nngilaq
iki	N	–p, –t
ikiagaa¦voq	V	–nngilaq
ikia¦gaq	N	–kkap, –kkat
ikiag¦oorpoq	V	–uunngilaq
ikia¦goorpoq	V	{–guunngilaq, –tiguunngilaq}
ikiala¦voq	V	–nngilaq
ikialitsi¦ppoq	V	–nngilaq
ikialitsissima¦voq	V	–nngilaq
ikia¦q	N	–p, –t
ikiaqut	N	–ip, –it
ikiaqutissa¦q	N	–p, –t
ikiaqutissat	N, pl.	-
ikiaqutissia¦q	N	–p, –t
ikiaqutit	N, pl.	-
ikiarii¦gaq	N	–kkap, –kkat
ikiariissitaarne¦q	N	–rup, –rit
ikiariissi¦taarneq	N	{–saarnerup, –taarnerup}, {–saarnerit, –taarnerit}
ikiariissitaa¦rpoq	V	–nngilaq
ikiarissaa¦q	N	–p, –t
ikiarissa¦aq	V	–nngilaq
ikiarissaa¦rpoq	V	–nngilaq
ikiarne¦q	N	–rup, –rit
ikiaroornart¦oq	N	–up, –ut
ikiaroornartut	N, pl.	-
ikiaroornartut¦orpoq	V	–unngilaq
ikiaroorne¦q	N	–rup, –rit
ikiaroorniut	N	–ip, –it
ikiaroorniutit	N, pl.	-
ikiar¦oorpoq	V	–uunngilaq
ikiaroortarne¦q	N	–rup, –rit
ikiaroortuaanna¦rpoq	V	–nngilaq
ikia¦rpaa	V	–nngilaa
ikia¦rpoq	V	–nngilaq
ikiarsine¦q	N	–rup, –rit
ikiarsi¦voq	V	–nngilaq
ikiarut	N, pl.	-
ikiassalaa¦rpoq	V	–nngilaq
ikiffig¦aa	V	–inngilaa
ikiginni¦ppoq	V	–nngilaq
ikigi¦ppoq	V	–nngilaq
ikigissaa¦rpoq	V	–nngilaq
ikikilli¦voq	V	–nngilaq
ikikinaa¦rpaa	V	–nngilaa
ikiki¦ppoq	V	–nngilaq
ikikkaane¦q	N	–rup, –rit
ikikkaa¦neq	N	{–junerup, –nerup}, {–junerit, –nerit}
ikikkaa¦voq	V	{–junngilaq, –nngilaq}
ikikkaa¦voq	V	–nngilaq
ikikkagaa¦voq	V	–nngilaq
ikikka¦gaq	N	–kkap, –kkat
ikikkagassa¦q	N	–p, –t
ikikka¦rpaa	V	–nngilaa
ikikkarti¦ppaa	V	–nngilaa
ikil¦erpaa	V	–inngilaa
ikilersimas¦oq	N	–up, –ut
ikilers¦orpaa	V	–unngilaa
ikilersui¦voq	V	–nngilaq
ikiliartorne¦q	N	–rup, –rit
ikiliar¦torneq	N	{–sornerup, –tornerup}, {–sornerit, –tornerit}
ikiligaa¦voq	V	–nngilaq
ikili¦gaq	N	–kkap, –kkat
ikilii¦voq	V	–nngilaq
ikil¦ik	N	{–iup, –lip, –lup}, –lit
ikilissuu¦voq	V	–nngilaq
ikilissu¦uvoq	V	{–aanngilaq, –unngilaq}
ikillaa¦voq	V	–nngilaq
ikilulluinna¦rpoq	V	–nngilaq
ikilu¦ppoq	V	–nngilaq
ikilutsi¦ppoq	V	–nngilaq
ikinaaqqu¦ppaa	V	–tinngilaa
ikinaar¦ivoq	V	{–inngilaq, –sinngilaq}
ikinaar¦sivoq	V	{–inngilaq, –sinngilaq}
ikine¦q	N	–rup, –rit
ikinerpalu¦ppoq	V	–nngilaq
ikinnerussuteqarne¦q	N	–rup, –rit
ikinnerussuteqartut	N, pl.	-
ikinnerusut	N, pl.	-
ikinngusisa¦rpoq	V	–nngilaq
ikinngut	N	–ip, –it
ikinngutaa¦voq	V	–nngilaq
ikinnguteqarne¦q	N	–rup, –rit
ikinngutig¦aa	V	–inngilaa
ikinngutigiinne¦q	N	–rup, –rit
ikinngutigiit	N, pl.	-
ikinngutiginerpaa¦vaa	V	–nngilaa
ikinngutiginngisa¦q	N	–p, –t
ikinngutigisa¦q	N	–p, –t
ikinngutigiunnaa¦rpaa	V	–nngilaa
ikinngutill¦erpaa	V	–inngilaa
ikinngutimaa¦rpaa	V	–nngilaa
ikinngutinnaa¦q	N	–p, –t
ikinngutinnerfig¦aa	V	–inngilaa
ikinngutinn¦erpoq	V	–inngilaq
ikinngutinners¦oq	N	–up, –ut
ikinngutinner¦soq	N	{–sup, –tup}, {–sut, –tut}
ikinngutinninngilaq	V	(no generation)
ikinngutivi¦k	N	–up, –it
ikioqatigiinne¦q	N	–rup, –rit
ikioqquvoq	V	(no generation)
ikioqutsi¦voq	V	–nngilaq
ikioriaraluarsinnaavaa	V	(no generation)
ikiorneqaat	N	–ip, –it
ikiorneqaqquvoq	V	(no generation)
ikiorneqarne¦q	N	–rup, –rit
iki¦orpaa	V	–unngilaa
iki¦orpoq	V	–unngilaq
ikiorserneqarne¦q	N	–rup, –rit
ikiors¦erpaa	V	–inngilaa
ikiorsiine¦q	N	–rup, –rit
ikiorsiisig¦aa	V	–inngilaa
ikiorsii¦sigaa	V	–tiginngilaa
ikiorsiissut	N	–ip, –it
ikiorsiissuteqartarne¦q	N	–rup, –rit
ikiorsiissutit	N, pl.	-
ikiorsii¦vik	N	{–ffiup, –viup}, {–ffiit, –viit}
ikiorsii¦voq	V	–nngilaq
ikiortaaru¦ppoq	V	–tinngilaq
ikiortaas¦oq	N	–up, –ut
ikiortaa¦voq	V	–nngilaq
ikiorti	N	–p, –t
ikiortig¦aa	V	–inngilaa
ikiortigigallassavaa	V	(no generation)
ikiortilli¦orpoq	V	–unngilaq
ikiortiser¦aa	V	–inngilaa
ikiortiserinni¦ppoq	V	–nngilaq
ikiortissaarunne¦q	N	–rup, –rit
ikiortissarsi¦orpoq	V	–unngilaq
ikiorumasanngilaa	V	(no generation)
iki¦ppaa	V	–nngilaa
ikippallaaqaat	N	–ip, –it
ikippoq	V	(no generation)
ikisa¦q	N	–p, –t
ikisine¦q	N	–rup, –rit
ikisi¦voq	V	–nngilaq
ikisorsuu¦voq	V	–nngilaq
ikisorsu¦uvoq	V	{–aanngilaq, –unngilaq}
ikissa¦q	N	–p, –t
ikissima¦voq	V	–nngilaq
ikitoqqat	N, pl.	-
ikitsine¦q	N	–rup, –rit
ikitsisaarnia¦q	N	–p, –t
ikitsisaa¦voq	V	–nngilaq
ikitsisit	N, pl.	-
ikitsissu¦ppaa	V	–tinngilaa
ikitsissut	N	–ip, –it
ikitsisuu¦voq	V	–nngilaq
ikitsi¦t	N	–sip, –sit
ikitsi¦voq	V	–nngilaq
ikittaa¦serpaa	V	{–sinngilaa, –tilinngilaa}
ikittaat	N	–ip, –it
ikittunnguit	N, pl.	-
ikiueqqaarne¦q	N	–rup, –rit
ikiuigaju¦ppoq	V	–nngilaq
ikiuine¦q	N	–rup, –rit
ikiuiniaqatigiiffi¦k	N	–up, –it
ikiuiniarne¦q	N	–rup, –rit
ikiuisarne¦q	N	–rup, –rit
ikiuis¦oq	N	–up, –ut
ikiuisussaane¦q	N	–rup, –rit
ikiuisussaassu¦seq	N	–tsip, –tsit
ikiuiumat¦ooq	N	–uup, –uut
ikiuiumatussu¦seq	N	–tsip, –tsit
ikiuiumatuu¦voq	V	–nngilaq
ikiui¦voq	V	–nngilaq
ikiulu¦ppaa	V	–nngilaa
ikiulu¦ppoq	V	–nngilaq
ikiuluttaannarpoq	V	(no generation)
ikiupisisaa¦rpoq	V	–nngilaq
ikiuukkumatoqaaq	V	(no generation)
ikiuukkusutt¦oq	N	–up, –ut
ikiuullua¦rpoq	V	–nngilaq
ikiuunne¦q	N	–rup, –rit
ikiuunniarsar¦aaq	V	–inngilaq
ikiuu¦ppoq	V	–tinngilaq
ikiuut	N	–ip, –it
ikiuutaallua¦rpoq	V	–nngilaq
ikiuutaa¦voq	V	–nngilaq
ikiuutigeqqita¦q	N	–p, –t
ikiuutilaarusuppoq	V	(no generation)
ikiuutisi¦voq	V	–nngilaq
ikiuutit¦orpoq	V	–unngilaq
ikiuutt¦oq	N	–up, –ut
ikiuuttuarpoq	V	(no generation)
iki¦vaa	V	–nngilaa
iki¦voq	V	–nngilaq
ikkaalu¦ppoq	V	–nngilaq
ikkaalutsitsi¦voq	V	–nngilaq
ikkaaluttuinnaa¦voq	V	–nngilaq
ikkag¦aa	V	–inngilaa
ikkagis¦oorpaa	V	–uunngilaa
ikkali¦voq	V	–nngilaq
ikkanne¦q	N	–rup, –rit
ikkanneria¦rpaa	V	–nngilaa
ikkanniia¦rpaa	V	–nngilaa
ikkannikkiart¦orpoq	V	–unngilaq
ikkanni¦ppoq	V	–nngilaq
ikkappallaaqaaq	V	(no generation)
ikka¦ppoq	V	–nngilaq
ikkar¦aa	V	–inngilaa
ikkarliffi¦k	N	–up, –it
ikkarlinne¦q	N	–rup, –rit
ikkarli¦ppoq	V	–nngilaq
ikkarlisaa¦rpoq	V	–nngilaq
ikkarlisima¦voq	V	–nngilaq
ikkarli¦sippaa	V	{–sinngilaa, –tinngilaa, –tsinngilaa}
ikkarlissima¦voq	V	–nngilaq
ikkarluisa¦ppoq	V	–nngilaq
ikkarlu¦k	N	–up, –it
ikkarlussu¦aq	N	–up, –it
ikkarnaalla¦ppoq	V	–nngilaq
ikkarna¦rpoq	V	–nngilaq
ikkas¦erpoq	V	–inngilaq
ikkataa¦voq	V	–nngilaq
ikkatig¦aa	V	–inngilaa
ikkatilliine¦q	N	–rup, –rit
ikkatillii¦voq	V	–nngilaq
Ikkatt¦eq	N	–ip, –it
ikkatt¦oq	N	–up, –ut
ikkeerna¦rpoq	V	–nngilaq
ikkeert¦orpoq	V	–unngilaq
ikke¦q	N	–rup, –rit
ikkertal¦ik	N	{–iup, –lip, –lup}, –lit
ikkii	Interj	(no generation)
ikkiilli¦voq	V	–nngilaq
ikkii¦ppoq	V	–nngilaq
ikki¦k	N	{–ngup, –up}, {–it, –ngit}
ikkillunne¦q	N	–rup, –rit
ikkillu¦ppoq	V	–nngilaq
ikkilunne¦q	N	–rup, –rit
ikkilu¦ppoq	V	–nngilaq
ikkimmiu	N	–p, –t
ikking¦erpoq	V	–inngilaq
ikkingersinnaanngilaq	V	(no generation)
ikkingers¦oorpoq	V	–uunngilaq
ikkivig¦aa	V	–inngilaa
ikkivigiinna¦rpaa	V	–nngilaa
ikkivi¦k	N	–up, –it
ikkivissaaru¦ppoq	V	–tinngilaq
ikkivissarsi¦voq	V	–nngilaq
ikku	Pron, pl.	–a
ikkuffig¦aa	V	–inngilaa
ikkuffi¦k	N	–up, –it
ikkuffissaaru¦ppaa	V	–tinngilaa
ikkuffissarsi¦vaa	V	–nngilaa
ikkuffissarsi¦voq	V	–nngilaq
ikkulaa¦rpoq	V	–nngilaq
ikku¦laarpoq	V	{–laanngilaq, –tilaanngilaq}
ikkull¦erpaa	V	–inngilaa
ikkullua¦rpoq	V	–nngilaq
ikkulu¦ppoq	V	–nngilaq
ikkulutsitsi¦voq	V	–nngilaq
ikkuluttuinnaa¦voq	V	–nngilaq
ikkungalaa¦rpoq	V	–nngilaq
ikkungane¦q	N	–rup, –rit
ikku¦nganeq	N	{–nganerup, –tinganerup}, {–nganerit, –tinganerit}
ikkungas¦oq	N	–up, –ut
ikku¦ngasoq	N	{–ngasup, –tingasup}, {–ngasut, –tingasut}
ikkunga¦voq	V	–nngilaq
ikkunneqarne¦q	N	–rup, –rit
ikkunneqa¦rpoq	V	–nngilaq
ikku¦ppaa	V	{–nngilaa, –tinngilaa}
ikku¦ppoq	V	–tinngilaq
ikkusimaannarpoq	V	(no generation)
ikkusima¦voq	V	–nngilaq
ikkussaa¦voq	V	–nngilaq
ikku¦ssaavoq	V	{–ssaanngilaq, –taanngilaq}
ikku¦ssaq	N	{–ssap, –tap}, {–ssat, –tat}
ikkussine¦q	N	–rup, –rit
ikkussissut	N	–ip, –it
ikkussi¦vik	N	{–ffiup, –viup}, {–ffiit, –viit}
ikkussi¦voq	V	–nngilaq
ikkuss¦orpaa	V	–unngilaa
ikkussu¦gaq	N	–kkap, –kkat
ikkussuine¦q	N	–rup, –rit
ikkussuisart¦oq	N	–up, –ut
ikkussuussine¦q	N	–rup, –rit
ikkussuussisart¦oq	N	–up, –ut
ikkutaasa¦rpoq	V	–nngilaq
ikku¦taasarpoq	V	{–taasanngilaq, –ssaasanngilaq}
ikkuta¦q	N	–p, –t
ikku¦taq	N	{–ssap, –tap}, {–ssat, –tat}
ikkutassa¦q	N	–p, –t
ikku¦tassaq	N	{–tassap, –ssassap}, {–tassat, –ssassat}
ikk¦uteqqinneqarpoq	V	{–uteqqinneqanngilaq, –utseqqinneqanngilaq, –oqqinneqanngilaq}
ikkutiinna¦rpoq	V	–nngilaq
ikku¦tiinnarpoq	V	{–tiinnanngilaq, –tsiinnanngilaq, –innanngilaq}
ikkutivi¦ppoq	V	–nngilaq
ikkuttart¦oq	N	–up, –ut
ikorfaa¦voq	V	–nngilaq
ikorfa¦q	N	–p, –t
ikorfa¦rpaa	V	–nngilaa
ikorfartorneqarne¦q	N	–rup, –rit
ikorfar¦torneqarneq	N	{–sorneqarnerup, –torneqarnerup}, {–sorneqarnerit, –torneqarnerit}
ikorfart¦orpaa	V	–unngilaa
ikorfartorti	N	–p, –t
ikorfartuisoqarne¦q	N	–rup, –rit
ikorfassa¦q	N	–p, –t
ikorfi¦k	N	–up, –it
ikorfiu¦ppaa	V	–tinngilaa
ikorfiussaa¦voq	V	–nngilaq
ikorfiussa¦q	N	–p, –t
ik¦orpoq	V	–unngilaq
ikorsimmavi¦k	N	–up, –it
ikualaa¦rpoq	V	–nngilaq
ikualane¦q	N	–rup, –rit
ikualasorsuu¦voq	V	–nngilaq
ikualasorsu¦uvoq	V	{–aanngilaq, –unngilaq}
ikuala¦voq	V	–nngilaq
ikuallaane¦q	N	–rup, –rit
ikuallaa¦ppoq	V	–tinngilaq
ikuallaasarfi¦k	N	–up, –it
ikuallaaveqarfi¦k	N	–up, –it
ikuallaavi¦k	N	–up, –it
ikuallagaa¦voq	V	–nngilaq
ikuallagussaa¦voq	V	–nngilaq
ikuallajaats¦oq	N	–up, –ut
ikuallajas¦oq	N	–up, –ut
ikuallaja¦voq	V	–nngilaq
ikuallakkalua¦rpoq	V	–nngilaq
ikuallanne¦q	N	–rup, –rit
ikualla¦ppaa	V	–nngilaa
ikualla¦ppoq	V	–nngilaq
ikuallassaa¦serpaa	V	{–sinngilaa, –tilinngilaa}
ikuallassaat	N	–ip, –it
ikuallassimassagunaraluarpoq	V	(no generation)
ikuallassima¦voq	V	–nngilaq
ikuallatsi¦ppaa	V	–nngilaa
ikuallatsitsine¦q	N	–rup, –rit
ikuallat¦sitsineq	N	{–sitsinerup, –itsinerup}, {–sitsinerit, –itsinerit}
ikuallatsitsis¦oq	N	–up, –ut
ikuallat¦sitsisoq	N	{–sitsisup, –itsisup}, {–sitsisut, –itsisut}
ikuallatsitsi¦voq	V	–nngilaq
ikuallat¦sitsivoq	V	{–sitsinngilaq, –itsinngilaq}
ikuallattoorne¦q	N	–rup, –rit
ikuallatt¦oq	N	–up, –ut
ikuallattoqa¦rpoq	V	–nngilaq
ikua¦rpaa	V	–nngilaa
ikuarta¦q	N	–p, –t
ikugaa¦voq	V	–nngilaq
iku¦gaq	N	–kkap, –kkat
ikumaava¦rpoq	V	–nngilaq
ikumajuarpoq	V	(no generation)
ikumallua¦rpoq	V	–nngilaq
ikumane¦q	N	–rup, –rit
ikumanik¦oq	N	–up, –ut
ikumasart¦oq	N	–up, –ut
ikumasinnaassu¦seq	N	–tsip, –tsit
ikumas¦oq	N	–up, –ut
ikumatiinna¦rpaa	V	–nngilaa
ikumatita¦q	N	–p, –t
ikumatitsisarfi¦k	N	–up, –it
ikumatitsi¦vik	N	{–ffiup, –viup}, {–ffiit, –viit}
ikuma¦voq	V	–nngilaq
ikummari¦ppoq	V	–nngilaq
ikummarissaa¦rpoq	V	–nngilaq
ikummari¦ssaat	N	{–ssaatip, –ttaatip}, {–ssaatit, –ttaatit}
ikummarissa¦rpaa	V	–nngilaa
ikummarlu¦ppoq	V	–nngilaq
ikummarlussi¦voq	V	–nngilaq
ikummarluttuaanna¦rpoq	V	–nngilaq
ikumma¦serpaa	V	{–sinngilaa, –tilinngilaa}
ikumma¦sersorpaa	V	{–sersunngilaa, –tilersunngilaa}
ikummat	N	–ip, –it
ikummataa¦voq	V	–nngilaq
ikummatissaarniarfi¦k	N	–up, –it
ikummatissa¦q	N	–p, –t
ikummatissat	N, pl.	-
ikungaanna¦rpoq	V	–nngilaq
ikungakanne¦q	N	–rup, –rit
ikunnaa¦ppaa	V	–tinngilaa
ikunna¦rpoq	V	–nngilaq
iku¦ppaa	V	–nngilaa
iku¦ppoq	V	–nngilaq
ikus¦erpaa	V	–inngilaa
iku¦sik	N	–tsip, –tsit
ikusimia¦rpaa	V	–nngilaa
ikusimia¦rpoq	V	–nngilaq
ikusimiart¦orpoq	V	–unngilaq
ikusimmia¦rpaa	V	–nngilaa
ikusimmi¦ppaa	V	–nngilaa
ikusimmi¦ppoq	V	–nngilaq
ikusi¦ppaa	V	–nngilaa
iku¦ssivoq	V	{–ssinngilaq, –tsinngilaq}
ikuta¦q	N	–p, –t
iku¦tsivoq	V	{–ssinngilaq, –tsinngilaq}
ikuttaasi¦orpoq	V	–unngilaq
ikuttaa¦siorpoq	V	{–siunngilaq, –tiliunngilaq}
ikuttaat	N	–ip, –it
ikuttaa¦voq	V	–nngilaq
ikutta¦rpaa	V	–nngilaa
ikuunaqqu¦ppoq	V	–tinngilaq
ikuunna¦ppoq	V	–nngilaq
ikuunnatsita¦q	N	–p, –t
ikuunnatt¦oq	N	–up, –ut
ikuusi¦orpoq	V	–unngilaq
ikuu¦voq	V	–nngilaq
ila	N	–p, –t
ila-ila	Interj	(no generation)
ilaa	Interj	(no generation)
ilaaffig¦aa	V	–inngilaa
ilaaffissa¦q	N	–p, –t
ilaaginna¦q	N	–ap, –at
ilaaginna¦q	N	–p, –t
ilaaginna¦rpoq	V	–nngilaq
ilaaginnart¦oq	N	–up, –ut
ilaajaane¦q	N	–rup, –rit
ilaajaat	N	–ip, –it
ilaajaataa¦voq	V	–nngilaq
ilaajaa¦voq	V	–nngilaq
ilaaja¦rpaa	V	–nngilaa
ilaajunnaa¦rpoq	V	–nngilaq
ilaalinngisaanna¦rpoq	V	–nngilaq
ilaallak	Interj	(no generation)
ilaana	Interj	(no generation)
ilaane¦q	N	–rup, –rit
ilaannaa¦voq	V	–nngilaq
ilaannakuus¦oq	N	–up, –ut
ilaanna¦q	N	{–p, –ap}, {–t, –at}
ilaanna¦q	N	–ap, –at
ilaanngilaq	V	(no generation)
ilaannginne¦q	N	–rup, –rit
ilaanngits¦oq	N	–up, –ut
ilaannikkut	N, pl.	-
ilaa¦q	N	–p, –t
ilaaqarpallaaqaaq	V	(no generation)
ilaaqa¦rpoq	V	–nngilaq
ilaaqqukkajuppoq	V	(no generation)
ilaaqqunngilaa	V	(no generation)
ilaaqqu¦ppoq	V	–tinngilaq
ilaaqqusaanngits¦oq	N	–up, –ut
ilaa¦rpaa	V	–nngilaa
ilaarsigaju¦ppoq	V	–nngilaq
ilaarsini¦ooq	N	–uup, –uut
ilaarsiumatuvoq	V	(no generation)
ilaarsi¦voq	V	–nngilaq
ilaar¦sivoq	V	{–inngilaq, –sinngilaq}
ilaartaa¦voq	V	–nngilaq
ilaart¦ooq	N	–uup, –uut
ilaartornik¦oq	N	–up, –ut
ilaar¦tornikoq	N	{–sornikup, –tornikup}, {–sornikut, –tornikut}
ilaart¦orpaa	V	–unngilaa
ilaartuine¦q	N	–rup, –rit
ilaartui¦voq	V	–nngilaq
ilaartuutissa¦q	N	–p, –t
ilaarunnaqaaq	V	(no generation)
ilaarunna¦rpoq	V	–nngilaq
ilaaru¦ppoq	V	–tinngilaq
ilaarusu¦ppoq	V	–nngilaq
ilaarut	N	–ip, –it
ilaarutig¦aa	V	–inngilaa
ilaaruti¦lliineq	N	{–ginninnerup, –lliinerup}, {–ginninnerit, –lliinerit}
ilaaruti¦lliivoq	V	{–ginninngilaq, –lliinngilaq}
ilaasartaat	N	–ip, –it
ilaas¦oq	N	–up, –ut
ilaasortaane¦q	N	–rup, –rit
ilaasortaasimas¦oq	N	–up, –ut
ilaasortaatita¦q	N	–p, –t
ilaasortaa¦voq	V	–nngilaq
ilaasortanng¦orpoq	V	–unngilaq
ilaasorta¦q	N	–p, –t
ilaassamaat	N	–ip, –it
ilaassa¦q	N	–p, –t
ilaasuinnaa¦voq	V	–nngilaq
ilaasussaaru¦ppoq	V	–tinngilaq
ilaat	N	–ip, –it
ilaat	N, pl.	-
ilaatinngilaa	V	(no generation)
ilaati¦ppaa	V	–nngilaa
ilaatitsine¦q	N	–rup, –rit
ilaa¦voq	V	–nngilaq
ilag¦aa	V	–inngilaa
ilageeqarfi¦k	N	–up, –it
ilageeqarne¦q	N	–rup, –rit
ilagiinne¦q	N	–rup, –rit
ilagii¦ssut	N, pl.	{–ssut, –ttut}
ilagiissutaa¦voq	V	–nngilaq
ilagiit	N, pl.	-
ilaginnaaginnarne¦q	N	–rup, –rit
ilaginnaajui¦ppoq	V	–nngilaq
ilaginnaane¦q	N	–rup, –rit
ilaginnaanna¦rpaa	V	–nngilaa
ilaginnaa¦voq	V	–nngilaq
ilaginna¦rpaa	V	–nngilaa
ilaginninne¦q	N	–rup, –rit
ilagisa¦q	N	–p, –t
ilagisariit	N, pl.	-
ilagisat	N, pl.	-
ilagulluinna¦rpoq	V	–nngilaq
ilagu¦ppoq	V	–tinngilaq
ilagutivi¦ppoq	V	–nngilaq
ilaguu¦ppoq	V	–tinngilaq
ilaguussaa¦rpoq	V	–nngilaq
ilaguutias¦oq	N	–up, –ut
ilaguutiinnalerne¦q	N	–rup, –rit
ilaguut¦iinnalerneq	N	{–iinnalernerup, –siinnalernerup}, {–iinnalernerit, –siinnalernerit}
ilaguutiinnaler¦soq	N	{–sup, –tup}, {–sut, –tut}
ilaguut¦iinnalersoq	N	{–iinnalersup, –iinnalertup, –siinnalersup, –siinnalertup}, {–iinnalersut, –iinnalertut, –siinnalersut, –siinnalertut}
ilakkuminangaart¦oq	N	–up, –ut
ilakkumina¦rpoq	V	–nngilaq
ilakkuminart¦oq	N	–up, –ut
ilakkuminassu¦seq	N	–tsip, –tsit
ilakunna¦ppoq	V	–nngilaq
ilakuu¦erpoq	V	–inngilaq
ilalaanngilaq	V	(no generation)
ilalaarne¦q	N	–rup, –rit
ilalaa¦rpoq	V	–nngilaq
ilalaartuaanna¦rpoq	V	–nngilaq
ilalerinngits¦oq	N	–up, –ut
ilal¦erinngitsoq	N	{–erinngitsup, –iinngitsup}, {–erinngitsut, –iinngitsut}
ilalernanngits¦oq	N	–up, –ut
ilalerna¦rpoq	V	–nngilaq
ilalernart¦oq	N	–up, –ut
ilal¦erpaa	V	–inngilaa
ilaliinna¦rpaa	V	–nngilaa
ilalii¦voq	V	–nngilaq
ilal¦iivoq	V	{–erinngilaq, –iinngilaq}
ilalisaatig¦aa	V	–inngilaa
ilalisa¦rpoq	V	–nngilaq
ilaliulluinna¦rpoq	V	–nngilaq
ilaliullu¦innarpoq	V	{–innanngilaq, –aannanngilaq}
ilaliu¦ppaa	V	–tinngilaa
ilaliu¦ppoq	V	–tinngilaq
ilaliussa¦q	N	–p, –t
ilallattaari¦voq	V	–nngilaq
ilaluar¦aa	V	–inngilaa
ilamaa¦rpaa	V	–nngilaa
ilam¦ineq	N	–ernup, –ernit
ilamininngu¦aannanngorpoq	V	{–aannanngunngilaq, –innanngunngilaq}
ilang¦erpaa	V	–inngilaa
ilangiisi¦ppaa	V	–nngilaa
ilangiiui¦ppoq	V	–nngilaq
ilangii¦voq	V	–nngilaq
ilannaa¦q	N	–p, –t
ilannaar¦aa	V	–inngilaa
ilannar¦aa	V	–inngilaa
ilannga¦aneq	N	{–anerup, –rsinerup}, {–anerit, –rsinerit}
ilanngaaseris¦oq	N	–up, –ut
ilanngaa¦serisoq	N	{–serisup, –tilerisup}, {–serisut, –tilerisut}
ilanngaa¦serivoq	V	{–serinngilaq, –tilerinngilaq}
ilanngaa¦serpaa	V	{–sinngilaa, –tilinngilaa}
ilannga¦asiineq	N	{–asiinerup, –rsisiinerup, –atiliinerup}, {–asiinerit, –rsisiinerit, –atiliinerit}
ilanngaa¦siivoq	V	{–siinngilaq, –tiliinngilaq}
ilanngaassine¦q	N	–rup, –rit
ilanngaat	N	–ip, –it
ilanngaataa¦voq	V	–nngilaq
ilanngaateqanngits¦oq	N	–up, –ut
ilanngaateqarsinnaatitaane¦q	N	–rup, –rit
ilanngaatissa¦q	N	–p, –t
ilanngaavig¦aa	V	–inngilaa
ilannga¦avigaa	V	{–affiginngilaa, –aviginngilaa, –rsiffiginngilaa}
ilannga¦avoq	V	{–anngilaq, –rsinngilaq}
ilannga¦gaq	N	–kkap, –kkat
ilannga¦rpaa	V	–nngilaa
ilanngarsimanngits¦oq	N	–up, –ut
ilanngarsimas¦oq	N	–up, –ut
ilanngarsima¦voq	V	–nngilaq
ilanngarsivig¦aa	V	–inngilaa
ilannga¦rsivoq	V	{–anngilaq, –rsinngilaq}
ilanngarterine¦q	N	–rup, –rit
ilanngartiler¦soq	N	{–sup, –tup}, {–sut, –tut}
ilanngart¦orpaa	V	–unngilaa
ilanngartuu¦ppaa	V	–tinngilaa
ilanngartuussi¦voq	V	–nngilaq
ilannguffig¦aa	V	–inngilaa
ilannguffiginninne¦q	N	–rup, –rit
ilanngullu¦innarneq	N	{–innarnerup, –aannarnerup}, {–innarnerit, –aannarnerit}
ilanngullu¦innarpaa	V	{–aannanngilaa, –innanngilaa}
ilanngunnaveersaarne¦q	N	–rup, –rit
ilanngunne¦q	N	–rup, –rit
ilanngu¦ppaa	V	–tinngilaa
ilanngu¦ppoq	V	–tinngilaq
ilanngussaa¦voq	V	–nngilaq
ilanngussa¦q	N	–p, –t
ilanngussimas¦oq	N	–up, –ut
ilanngussine¦q	N	–rup, –rit
ilanngussi¦voq	V	–nngilaq
ilannguta¦q	N	–p, –t
ilanngutassia¦q	N	–p, –t
ilanngutassiort¦oq	N	–up, –ut
ilanngutass¦iortoq	N	{–aliortup, –iortup}, {–aliortut, –iortut}
ilanngut¦eqqippaa	V	{–eqqinngilaa, –seqqinngilaa}
ilanngutinngiinnarpaa	V	(no generation)
ilanngutinngilaa	V	(no generation)
ilanngut¦ivinneq	N	{–ivinnerup, –sivinnerup}, {–ivinnerit, –sivinnerit}
ilapitt¦orpaa	V	–unngilaa
ilapittuut	N	–ip, –it
ilapittuutaa¦voq	V	–nngilaq
ilapittuutig¦aa	V	–inngilaa
ilapittuutissat	N, pl.	-
ila¦ppoq	V	–nngilaq
ilaq	N	(no generation)
ilaqajuippoq	V	(no generation)
ilaqanngilaq	V	(no generation)
ilaqarne¦q	N	–rup, –rit
ilaqa¦rpoq	V	–nngilaq
ilaqarsinnaatitaane¦q	N	–rup, –rit
ilaqartaanna¦rpoq	V	–nngilaq
ilaqu¦seq	N	–tsip, –tsit
ilaqusernaasa¦q	N	–p, –t
ilaqutaas¦oq	N	–up, –ut
ilaqutalisa¦rpoq	V	–nngilaq
ilaqut¦aq	N	{–ap, –tap}, {–at, –tat}
ilaqutariit	N, pl.	-
ilaqutarsiat	N, pl.	-
ilarfallattaa¦rpoq	V	–nngilaq
ilarnaveeqqus¦erpaa	V	–inngilaa
ilarnaveeqqu¦serpaa	V	{–sinngilaa, –tilinngilaa}
ilarnaveeqqut	N	–ip, –it
ila¦rpaa	V	–nngilaa
ilarpaan¦eerpaa	V	–iinngilaa
ila¦rpoq	V	–nngilaq
ilarrallattaari¦voq	V	–nngilaq
ilarrallattaa¦rpaa	V	–nngilaa
ilarrallattaa¦rpoq	V	–nngilaq
ilartaa¦rpoq	V	–nngilaq
ilasaarillaqqi¦ppoq	V	–nngilaq
ilasaari¦voq	V	–nngilaq
ilasaa¦rpaa	V	–nngilaa
ilasaat	N	–ip, –it
ilasa¦q	N	–p, –t
ilasa¦rpaa	V	–nngilaa
ilaser¦aa	V	–inngilaa
ilaserinni¦ppoq	V	–nngilaq
ilas¦erpaa	V	–inngilaa
ilas¦erpoq	V	–inngilaq
ilasertuaanna¦rpoq	V	–nngilaq
ilasiaa¦voq	V	–nngilaq
ilasia¦q	N	–p, –t
ilasiar¦aa	V	–inngilaa
ilasiassarsi¦orpoq	V	–unngilaq
ilasine¦q	N	–rup, –rit
ilasi¦voq	V	–nngilaq
ilassaaru¦ppoq	V	–tinngilaq
ilassa¦q	N	–p, –t
ilassarsiar¦aa	V	–inngilaa
ilassarsi¦orpoq	V	–unngilaq
ilassarsiort¦oq	N	–up, –ut
ilassarsi¦vaa	V	–nngilaa
ilassarsi¦voq	V	–nngilaq
ilasseqatigiinne¦q	N	–rup, –rit
ilasseraanngilaq	V	(no generation)
ilasseraannginne¦q	N	–rup, –rit
ilasseraanngits¦oq	N	–up, –ut
ilassillua¦rpaa	V	–nngilaa
ilassima¦voq	V	–nngilaq
ilassinninne¦q	N	–rup, –rit
ilassinni¦ppoq	V	–nngilaq
ilassinnissut	N	–ip, –it
ilassinnittarfi¦k	N	–up, –it
ilassiorne¦q	N	–rup, –rit
ilass¦iorneq	N	{–aliornerup, –iornerup}, {–aliornerit, –iornerit}
ilassiorneqarne¦q	N	–rup, –rit
ilass¦iorneqarneq	N	{–aliorneqarnerup, –iorneqarnerup}, {–aliorneqarnerit, –iorneqarnerit}
ilassi¦orpaa	V	–unngilaa
ilassi¦orpoq	V	–unngilaq
ilass¦iorpoq	V	{–aliunngilaq, –iunngilaq}
ilassiort¦oq	N	–up, –ut
ilass¦iortoq	N	{–aliortup, –iortup}, {–aliortut, –iortut}
ilassisa¦rpaa	V	–nngilaa
ilassissaa¦rpaa	V	–nngilaa
ilassissaa¦rpoq	V	–nngilaq
ilassi¦tippaa	V	{–tinngilaa, –sinngilaa}
ilassiunngilaq	V	(no generation)
ilassiunngits¦oq	N	–up, –ut
ilass¦iunngitsoq	N	{–aliunngitsup, –iunngitsup}, {–aliunngitsut, –iunngitsut}
ilassi¦vaa	V	–nngilaa
ilassi¦voq	V	–nngilaq
ilassunnaa¦ppoq	V	–nngilaq
ilassut	N	–ip, –it
ilassuteqaateqartitsine¦q	N	–rup, –rit
ilassutissa¦q	N	–p, –t
ilassuu¦ppoq	V	–tinngilaq
ilassuutiui¦ppoq	V	–nngilaq
ilataar¦aa	V	–inngilaa
ilataa¦rpoq	V	–nngilaq
ilatsaasornaqaaq	V	(no generation)
ilatsaas¦orpaa	V	–unngilaa
ilatsaas¦orpoq	V	–unngilaq
ilatsaasui¦voq	V	–nngilaq
ilats¦erpaa	V	–inngilaa
ilatserpoq	V	(no generation)
ilatsiinnalerne¦q	N	–rup, –rit
ilatsiinnaler¦soq	N	{–sup, –tup}, {–sut, –tut}
ilatsiinna¦rpoq	V	–nngilaq
ilatsiinnart¦oq	N	–up, –ut
ilatsi¦ppaa	V	–nngilaa
ilatt¦oorpoq	V	–uunngilaq
ilattoorti¦ppaa	V	–nngilaa
ilatt¦orpoq	V	–unngilaq
ila¦vaa	V	–nngilaa
ilavi¦k	N	–up, –it
ila¦voq	V	–nngilaq
ileqannginne¦q	N	–rup, –rit
ileqilasorsu¦aq	N	–up, –it
ileqila¦voq	V	–nngilaq
ileqimisaarfig¦aa	V	–inngilaa
ileqimisaa¦rpoq	V	–nngilaq
ileqimisaart¦orpoq	V	–unngilaq
ileqimisaartuinna¦rpoq	V	–nngilaq
ileqimisatt¦orpoq	V	–unngilaq
ileqqaagaqarne¦q	N	–rup, –rit
ileqqaallaqqi¦ppoq	V	–nngilaq
ileqqaanngissu¦seq	N	–tsip, –tsit
ileqqaa¦ppaa	V	–tinngilaa
ileqqaarnart¦oq	N	–up, –ut
ileqqaarne¦q	N	–rup, –rit
ileqqaarniut	N	–ip, –it
ileqqaa¦rpaa	V	–nngilaa
ileqqaa¦rpoq	V	–nngilaq
ileqqaartitsine¦q	N	–rup, –rit
ileqqaaru¦ppaa	V	–tinngilaa
ileqqaarut	N	–ip, –it
ileqqis¦erpaa	V	–inngilaa
ileqq¦oq	N	–up, –ut
ileqqor¦aa	V	–inngilaa
ileqqoreqqusa¦q	N	–p, –t
ileqqorinne¦q	N	–rup, –rit
ileqqori¦ppoq	V	–nngilaq
ileqqorisa¦q	N	–p, –t
ileqqorissaarne¦q	N	–rup, –rit
ileqqori¦ssaarneq	N	{–ssaarnerup, –ttaarnerup}, {–ssaarnerit, –ttaarnerit}
ileqqorissaa¦rpoq	V	–nngilaq
ileqqorissa¦rpaa	V	–nngilaa
ileqqorissa¦rpoq	V	–nngilaq
ileqqori¦ssarpoq	V	–ttanngilaq
ileqqorissi¦voq	V	–nngilaq
ileqqori¦ssoq	N	{–ssup, –ttup}, {–ssut, –ttut}
ileqqorissu¦seq	N	–tsip, –tsit
ileqqorl¦erpoq	V	–inngilaq
ileqqorlunne¦q	N	–rup, –rit
ileqqorlu¦ppoq	V	–nngilaq
ileqqorlutt¦oq	N	–up, –ut
ileqqorsi¦orpaa	V	–unngilaa
ileqqorsorajuppoq	V	(no generation)
ileqqors¦orpoq	V	–unngilaq
ileqqor¦sorpoq	V	{–sunngilaq, –tunngilaq}
ileqqorsuu¦siaq	N	{–siap, –tiliap}, {–siat, –tiliat}
ileqqorsuusi¦orpoq	V	–unngilaq
ileqqorsuu¦siorpoq	V	{–siunngilaq, –tiliunngilaq}
ileqqorsuut	N	–ip, –it
ileqqorsuutitoq¦aq	N	–qap, –qat
ileqqortaa¦q	N	–p, –t
ileqqulersorne¦q	N	–rup, –rit
ileqquler¦suut	N	{–suutip, –tuutip}, {–suutit, –tuutit}
ileqquliu¦ppaa	V	–tinngilaa
ileqquliussi¦voq	V	–nngilaq
ileqquliutiinna¦rpaa	V	–nngilaa
ileqqumis¦oorpoq	V	–uunngilaq
ileqqunngorsaane¦q	N	–rup, –rit
ileqqupiloqart¦oq	N	–up, –ut
ileqqupilu¦k	N	–up, –it
ileqqussaanngits¦oq	N	–up, –ut
ileqqussa¦q	N	–p, –t
ileqqut	N, pl.	-
ileqqutoq¦aq	N	{–qap, –ap}, {–qat, –at}
ileqquunerus¦oq	N	–up, –ut
ileqquus¦oq	N	–up, –ut
ileraa¦ppoq	V	–nngilaq
ilerag¦aa	V	–inngilaa
ileragisaqanngilaq	V	(no generation)
ileranaa¦ppoq	V	–nngilaq
ilerananngilaq	V	(no generation)
ileranaqaaq	V	(no generation)
ilerana¦rpoq	V	–nngilaq
ilerasujui¦ppoq	V	–nngilaq
ilerasu¦ppoq	V	–nngilaq
ilerasuut	N	–ip, –it
ilerasuuteqarfigilereernikuuaa	V	(no generation)
ilerasuuteqa¦rpoq	V	–nngilaq
ilerasuutig¦aa	V	–inngilaa
ileratsaa¦ppaa	V	–tinngilaa
ileratsaatig¦aa	V	–inngilaa
ileratsa¦ppoq	V	–nngilaq
ilerattaa¦ppoq	V	{–nngilaq, –tinngilaq}
ilerfia¦q	N	–p, –t
ilerfiarne¦q	N	–rup, –rit
ilerfia¦rpoq	V	–nngilaq
ilerfiart¦oq	N	–up, –ut
ilerfi¦orpaa	V	–unngilaa
ilerfi¦orpoq	V	–unngilaq
ilerfu¦voq	V	–nngilaq
ilernik¦oq	N	–up, –ut
ilernikor¦aa	V	–inngilaa
ilerniku	N	–p, –t
ilernikuli¦orpaa	V	–unngilaa
ilernikuli¦orpoq	V	–unngilaq
ilerruffig¦aa	V	–inngilaa
ilerru¦voq	V	–nngilaq
ilersaasat	N, pl.	-
ilersa¦q	N	–p, –t
ilersippaa	V	(no generation)
ilersi¦vaa	V	–nngilaa
ilersi¦voq	V	–nngilaq
iliarsoqqi¦k	N	–up, –it
iliarsoqqiu¦voq	V	–nngilaq
iliarsor¦orpoq	V	–unngilaq
iliarsu¦k	N	–up, –it
iliarsunngu¦aq	N	–up, –it
iliartoqqaarumagaluarpaa	V	(no generation)
ilig¦aa	V	–inngilaa
iligiinne¦q	N	–rup, –rit
iligiissut	N, pl.	-
iligii¦ssut	N, pl.	{–ssut, –ttut}
iligiit	N, pl.	-
iligil¦erpaa	V	–inngilaa
iligillua¦rpaa	V	–nngilaa
iligisa¦q	N	–p, –t
iligisaqarne¦q	N	–rup, –rit
iliillisaa¦voq	V	–nngilaq
iliilli¦vaa	V	–nngilaa
ilii¦ppoq	V	–nngilaq
ili¦k	N	–up, –it
ilikkaa¦ppaa	V	–tinngilaa
ilikkaassi¦voq	V	–nngilaq
ilikka¦gaq	N	–kkap, –kkat
ilikkaja¦voq	V	–nngilaq
ilikkariartorne¦q	N	–rup, –rit
ilikkarne¦q	N	–rup, –rit
ilikka¦rpaa	V	–nngilaa
ilikka¦rpoq	V	–nngilaq
ilikkarserii¦ppoq	V	–nngilaq
ilikkarti¦ppaa	V	–nngilaa
ilikkartitseriaa¦seq	N	–tsip, –tsit
ilikkavi¦ppoq	V	–nngilaq
ilikkut	N, pl.	-
ilimag¦aa	V	–inngilaa
ilimagineqa¦rpoq	V	–nngilaq
ilimagineqarsinnaas¦oq	N	–up, –ut
ilimaginngisaas¦oq	N	–up, –ut
ilimaginngisa¦q	N	–p, –t
ilimagisa¦q	N	–p, –t
ilimakk¦eerpaa	V	–iinngilaa
ilimananngits¦oq	N	–up, –ut
ilimana¦piluttoq	N	{–piluttup, –ripiluttup}, {–piluttut, –ripiluttut}
Ilimana¦q	Prop	–p
ilimanaqaaq	V	(no generation)
ilimana¦rpoq	V	–nngilaq
ilimanart¦oq	N	–up, –ut
ilimanassu¦seq	N	–tsip, –tsit
ilimanassusilerine¦q	N	–rup, –rit
ilimasaarine¦q	N	–rup, –rit
ilimasaaris¦oq	N	–up, –ut
ilimasaari¦voq	V	–nngilaq
ilimasaa¦rpaa	V	–nngilaa
ilimasaarut	N	–ip, –it
ilimasaaruteqarne¦q	N	–rup, –rit
ilimasaarutig¦aa	V	–inngilaa
ilimasaarutigineqanngits¦oq	N	–up, –ut
ilimasuarna¦rpoq	V	–nngilaq
ilimasu¦erpoq	V	–inngilaq
ilimasunne¦q	N	–rup, –rit
ilimasupi¦lunneq	N	{–lunnerup, –pilunnerup}, {–lunnerit, –pilunnerit}
ilimasupilu¦ppoq	V	–nngilaq
ilimasu¦ppoq	V	–nngilaq
ilimasuut	N	–ip, –it
ilimasuutaa¦voq	V	–nngilaq
ilimasuutig¦aa	V	–inngilaa
ilimatsaat	N	–ip, –it
ilimatsajanerulluinnalerpoq	V	(no generation)
ilimatsajanerulluinnalersarpoq	V	(no generation)
ilimatsajanerulluinna¦rpoq	V	–nngilaq
ilimatsa¦ppoq	V	–nngilaq
Ilimmaasa¦q	N	–p, –t
Ilimmaasa¦q	Prop	–p
ilimmaasa¦q	N	–p, –t
Ilimmarfi¦k	N	–up, –it
Ilimmarfi¦k	Prop	–up, –it
ilimma¦rpoq	V	–nngilaq
ilingane¦q	N	–rup, –rit
ilinga¦voq	V	–nngilaq
ilingisu¦ppoq	V	–nngilaq
ilinia¦gaq	N	–kkap, –kkat
ilinne¦q	N	–rup, –rit
ilinnga¦ppoq	V	–nngilaq
ilinnga¦rpoq	V	–nngilaq
ilinngassa¦rpoq	V	–nngilaq
ilinniagaats¦oq	N	–up, –ut
ilinniagakits¦oq	N	–up, –ut
ilinniagal¦ik	N	{–iup, –lip, –lup}, –lit
ilinnia¦gaq	N	–kkap, –kkat
ilinniagaqanngits¦oq	N	–up, –ut
ilinniagaqaqqinne¦q	N	–rup, –rit
ilinniagaqariartorne¦q	N	–rup, –rit
ilinniagaqarne¦q	N	–rup, –rit
ilinniagaqarnermusiat	N, pl.	-
ilinniagaqarnersiuteqarfiusinnaas¦oq	N	–up, –ut
Ilinniagaqarnersiuteqartitsivi¦k	N	{–iup, –up}, {–iit, –it}
Ilinniagaqarnersiuteqartitsivi¦k	Prop	–up, –it
ilinniagaqarnersiutit	N, pl.	-
ilinniagaqarsimanngits¦oq	N	–up, –ut
ilinniagart¦ooq	N	–uup, –uut
ilinniagartuunngorniarfi¦k	N	–up, –it
ilinniagartuut	N, pl.	-
ilinniagassa¦q	N	–p, –t
ilinniagassat	N, pl.	-
ilinniagassi¦ppaa	V	–nngilaa
ilinniakkeri¦voq	V	–nngilaq
ilinnianngiffeqarallarfi¦k	N	–up, –it
ilinnianngiffeqarallarne¦q	N	–rup, –rit
ilinniaqqaagassat	N, pl.	-
ilinniaqqaatissa¦q	N	–p, –t
ilinniaqqikkusulernikuu¦voq	V	{–nngilaq, –nngivoq}
ilinniaqqinne¦q	N	–rup, –rit
ilinniaqqi¦ppoq	V	–nngilaq
ilinniarfeqarfi¦k	N	–up, –it
ilinniarfig¦aa	V	–inngilaa
ilinniarfi¦k	N	–up, –it
Ilinniarfissu¦aq	N	–up, –it
ilinniarfissu¦aq	N	–up, –it
ilinniarfius¦oq	N	–up, –ut
ilinniarluarsimanngits¦oq	N	–up, –ut
ilinniarluarsimas¦oq	N	–up, –ut
ilinniarne¦q	N	–rup, –rit
ilinniarnersiutit	N, pl.	-
ilinniarnert¦ooq	N	–uup, –uut
ilinniarnertuunngornia¦q	N	–p, –t
ilinniarnertuunngorniarfeqarfi¦k	N	–up, –it
Ilinniarnertuunngorniarfi¦k	N	–up, –it
ilinniarnertuunngorniarfi¦k	N	–up, –it
ilinniarnertuunngorniarne¦q	N	–rup, –rit
ilinniarnilerine¦q	N	–rup, –rit
ilinnia¦rpaa	V	–nngilaa
ilinnia¦rpoq	V	–nngilaq
ilinniarsimanngits¦oq	N	–up, –ut
ilinniarsimas¦oq	N	–up, –ut
ilinniarteqqi¦ppaa	V	–nngilaa
ilinniarti¦ppaa	V	–nngilaa
ilinniartitaane¦q	N	–rup, –rit
ilinniartitseriaa¦seq	N	–tsip, –tsit
ilinniartitsine¦q	N	–rup, –rit
ilinniartitsis¦oq	N	–up, –ut
ilinniartitsisoqatigiit	N, pl.	-
ilinniartitsisorinikuusa¦q	N	–p, –t
ilinniartitsisori¦ppoq	V	–nngilaq
ilinniartitsisorisa¦q	N	–p, –t
ilinniartitsisorissaa¦rpoq	V	–nngilaq
ilinniartitsissut	N	–ip, –it
ilinniartitsisunngorniarfi¦k	N	–up, –it
ilinniartitsisunngorniarne¦q	N	–rup, –rit
ilinniartitsisussaalatsine¦q	N	–rup, –rit
ilinniartitsisussaaleqine¦q	N	–rup, –rit
ilinniartitsisuune¦q	N	–rup, –rit
ilinniartitsisuu¦voq	V	–nngilaq
ilinniartitsi¦voq	V	–nngilaq
ilinniart¦oq	N	–up, –ut
ilinniartoqat	N	–ip, –it
ilinniar¦toqat	N	{–toqatip, –soqatip}, {–toqatit, –soqatit}
ilinniartuunersiutit	N, pl.	-
ilinniartuu¦voq	V	–nngilaq
ilinnii¦ppoq	V	–nngilaq
ilinnik¦oq	N	–up, –ut
ilinniut	N	–ip, –it
ilinniutit	N, pl.	-
ilioqqaane¦q	N	–rup, –rit
ilioqqaas¦oq	N	–up, –ut
ilioqqaa¦voq	V	–nngilaq
ilioraa¦vik	N	{–ffiup, –viup}, {–ffiit, –viit}
ilioraa¦voq	V	–nngilaq
ili¦orajunneq	N	{–orajunnerup, –ukkajunnerup}, {–orajunnerit, –ukkajunnerit}
iliorfig¦aa	V	–inngilaa
ilioriaa¦seq	N	–tsip, –tsit
ilioriarnissa¦q	N	–p, –t
ilioriusissaqanngilaq	V	(no generation)
iliorne¦q	N	–rup, –rit
ili¦orpaa	V	–unngilaa
ili¦orpoq	V	–unngilaq
iliortaa¦seq	N	–tsip, –tsit
ili¦ppaa	V	–nngilaa
ilippag¦aa	V	–inngilaa
ilippana¦rpoq	V	–nngilaq
ilippanart¦oq	N	–up, –ut
ili¦ppoq	V	–nngilaq
ilisaa¦voq	V	–nngilaq
ilisa¦q	N	–p, –t
ilisar¦aa	V	–inngilaa
ilisarine¦q	N	–rup, –rit
ilisarinia¦rpaa	V	–nngilaa
ilisarinneqqinne¦q	N	–rup, –rit
ilisar¦inneqqinneq	N	{–inneqqinnerup, –seqqinnerup}, {–inneqqinnerit, –seqqinnerit}
ilisarisaa¦voq	V	–nngilaq
ilisarisa¦q	N	–p, –t
ilisarisimalernikuunngisaannaraluarpaa	V	(no generation)
ilisarisimaneqarluart¦oq	N	–up, –ut
ilisaris¦imaneqarluartoq	N	{–imaneqarluartup, –simaneqarluartup}, {–imaneqarluartut, –simaneqarluartut}
ilisarisimasa¦q	N	–p, –t
ilisarisima¦vaa	V	–nngilaa
ilisariti¦ppaa	V	–nngilaa
ilisariti¦ppoq	V	–nngilaq
ilisarititsine¦q	N	–rup, –rit
ilisarititsissut	N	–ip, –it
ilisarititsi¦voq	V	–nngilaq
ilisarivi¦ppaa	V	–nngilaa
ilisarnaa¦serpaa	V	{–sinngilaa, –tilinngilaa}
ilisarnaat	N	–ip, –it
ilisarnaataallu¦innartoq	N	{–aannartup, –innartup}, {–aannartut, –innartut}
ilisarnaataas¦oq	N	–up, –ut
ilisarnaatig¦aa	V	–inngilaa
ilisarnaqutig¦aa	V	–inngilaa
ilisarnarluart¦oq	N	–up, –ut
ilisar¦narluartoq	N	{–inarluartup, –narluartup}, {–inarluartut, –narluartut}
ilisarna¦rpoq	V	–nngilaq
ilisar¦narpoq	V	{–inanngilaq, –nanngilaq}
ilisarnarsigaluttuinnarpoq	V	(no generation)
ilisarnarti¦ppaa	V	–nngilaa
ilisar¦nartippaa	V	{–inartinngilaa, –nartinngilaa}
ilisarnart¦oq	N	–up, –ut
ilisar¦nartoq	N	{–inartup, –nartup}, {–inartut, –nartut}
ilisarnarunnaarsitsine¦q	N	–rup, –rit
ilisar¦narunnaarsitsineq	N	{–inarunnaarsitsinerup, –narunnaarsitsinerup}, {–inarunnaarsitsinerit, –narunnaarsitsinerit}
ilisarsaanngilaq	V	(no generation)
ilisarsaa¦voq	V	–nngilaq
ilisarsiniut	N	–ip, –it
ilisar¦siniut	N	{–inninniutip, –siniutip}, {–inninniutit, –siniutit}
ilisarsisarne¦q	N	–rup, –rit
ilisar¦sisarneq	N	{–innittarnerup, –sisarnerup}, {–innittarnerit, –sisarnerit}
ilisarsi¦voq	V	–nngilaq
ilisar¦sivoq	V	{–inninngilaq, –sinngilaq}
ilisat	N, pl.	-
ilisiinniusi¦orpoq	V	–unngilaq
ilisiinniu¦siorpoq	V	{–siunngilaq, –tiliunngilaq}
ilisii¦ppaa	V	–nngilaa
ilisii¦ppoq	V	–nngilaq
ilisiits¦oq	N	–up, –ut
ilisimaanne¦q	N	–rup, –rit
ilisimaa¦ppoq	V	–nngilaq
ilisimaar¦aa	V	–inngilaa
ilisimaarillua¦rpaa	V	–nngilaa
ilisimaarinni¦ppoq	V	–nngilaq
ilisimaarisa¦q	N	–p, –t
ilisimaassu¦seq	N	–tsip, –tsit
ilis¦imaassuseq	N	{–imaassutsip, –simaassutsip}, {–imaassutsit, –simaassutsit}
ilisimaats¦oq	N	–up, –ut
ilisimaatsorpalaart¦oq	N	–up, –ut
ilisimajunnaarne¦q	N	–rup, –rit
ilisimajunnaa¦rpoq	V	–nngilaq
ilisimajunnaar¦saat	N	{–saatip, –taatip}, {–saatit, –taatit}
ilisimajunnaarsimas¦oq	N	–up, –ut
ilisimajunnaar¦sippaa	V	{–sinngilaa, –tinngilaa}
ilisimajunnaar¦sitsineq	N	{–sitsinerup, –titsinerup}, {–sitsinerit, –titsinerit}
ilisimajunnaar¦sitsisartoq	N	{–sitsisartup, –titsisartup}, {–sitsisartut, –titsisartut}
ilisimajunnaar¦sitsissut	N	{–sitsissutip, –titsissutip}, {–sitsissutit, –titsissutit}
ilisimajunnaar¦titsineq	N	{–sitsinerup, –titsinerup}, {–sitsinerit, –titsinerit}
ilisimajunnaar¦titsineq	N	{–titsinerup, –sitsinerup}, {–titsinerit, –sitsinerit}
ilisimajunnaavinne¦q	N	–rup, –rit
ilisimalereerpaa	V	(no generation)
ilisimalerniarpaa	V	(no generation)
ilisimal¦erpaa	V	–inngilaa
ilisimalersitsine¦q	N	–rup, –rit
ilisimaler¦sitsineq	N	{–sitsinerup, –titsinerup}, {–sitsinerit, –titsinerit}
ilisimaneqanngilaq	V	(no generation)
ilisimaneqanngits¦oq	N	–up, –ut
ilisimaneqarlua¦rpoq	V	–nngilaq
ilisimaneqa¦rpoq	V	–nngilaq
ilisimaneqart¦oq	N	–up, –ut
ilisimania¦rpoq	V	–nngilaq
ilisimanngilaq	V	(no generation)
ilisimanngisa¦q	N	–p, –t
ilisimanngisartaqa¦rpoq	V	–nngilaq
ilisimanni¦ppoq	V	–nngilaq
ilisimannitt¦oq	N	–up, –ut
ilisimaqaaq	V	(no generation)
ilisimarii¦gaq	N	–kkap, –kkat
ilisimarngus¦erpoq	V	–inngilaq
ilisimasal¦ik	N	{–iup, –lip, –lup}, –lit
ilisimasa¦q	N	–p, –t
ilisimasaqal¦erpoq	V	–inngilaq
ilisimasaqanngits¦oq	N	–up, –ut
ilisimasaqareerne¦q	N	–rup, –rit
ilisimasaqarfi¦k	N	–up, –it
ilisimasaqarne¦q	N	–rup, –rit
ilisimasassarsiorne¦q	N	–rup, –rit
ilisimasassarsiornerit	N, pl.	-
ilisimasassarsi¦orpoq	V	–unngilaq
ilisimasassarsiort¦oq	N	–up, –ut
ilisimasassat	N, pl.	-
ilisimasat	N, pl.	-
ilisimas¦oq	N	–up, –ut
ilisimasorsu¦aq	N	–up, –it
ilisimasorta¦q	N	–p, –t
ilisimassu¦seq	N	–tsip, –tsit
ilisimassutig¦aa	V	–inngilaa
ilisimati¦ppaa	V	–nngilaa
ilisimatitsine¦q	N	–rup, –rit
ilisimatitsis¦oq	N	–up, –ut
ilisimatitsissut	N	–ip, –it
ilisimatitsissutig¦aa	V	–inngilaa
ilisimatitsisussaatitaane¦q	N	–rup, –rit
ilisimatitsi¦voq	V	–nngilaq
ilisimat¦ooq	N	–uup, –uut
ilisimatooqatigiit	N, pl.	-
ilisimatoorpassuaqa¦rpoq	V	–nngilaq
ilisimatoorsu¦aq	N	–up, –it
ilisimatungaart¦oq	N	–up, –ut
ilisimatusaat	N	–ip, –it
ilisimatusaatig¦aa	V	–inngilaa
ilisimatusaqatigiit	N, pl.	-
ilisimatusarfiit	N, pl.	-
Ilisimatusarfi¦k	N	–up, –it
Ilisimatusarfi¦k	Prop	–up, –it
ilisimatusarfi¦k	N	–up, –it
ilisimatusarne¦q	N	–rup, –rit
ilisimatusart¦oq	N	–up, –ut
ilisimatusartuune¦q	N	–rup, –rit
ilisimatuunngorniarne¦q	N	–rup, –rit
ilisimatuunngorniart¦oq	N	–up, –ut
ilisimatuut	N, pl.	-
ilisima¦vaa	V	–nngilaa
ilisimavallaanngilaq	V	(no generation)
ilisima¦voq	V	–nngilaq
ilisimmaa¦ppaa	V	–tinngilaa
ilisimmarilluart¦oq	N	–up, –ut
ilisimmari¦ppoq	V	–nngilaq
ilisimma¦rpoq	V	–nngilaq
ilisine¦q	N	–rup, –rit
ilisi¦ppaa	V	–nngilaa
ili¦sippaa	V	{–sinngilaa, –tinngilaa}
ilisissu¦ppaa	V	–tinngilaa
ilisiveeru¦ppaa	V	–tinngilaa
ilisi¦veeruppaa	V	{–ffeerutinngilaa, –veerutinngilaa}
ilisiveeru¦ppoq	V	–tinngilaq
ilisi¦veeruppoq	V	{–ffeerutinngilaq, –veerutinngilaq}
ilisiveerussine¦q	N	–rup, –rit
ilisi¦veerussineq	N	{–ffeerussinerup, –veerussinerup}, {–ffeerussinerit, –veerussinerit}
ilisiveerussi¦vaa	V	–nngilaa
ilisiveerussi¦voq	V	–nngilaq
ilisi¦veerussivoq	V	{–ffeerussinngilaq, –veerussinngilaq}
ilisi¦vik	N	{–ffiup, –viup}, {–ffiit, –viit}
ilisivilers¦orpaa	V	–unngilaa
ilisi¦vilersorpaa	V	{–ffilersunngilaa, –vilersunngilaa}
ilisivittaa¦rpoq	V	–nngilaq
ilisi¦vittaarpoq	V	{–ffittaanngilaq, –vittaanngilaq}
ilisi¦voq	V	–nngilaq
ilissaatig¦aa	V	–inngilaa
ilissaa¦voq	V	–nngilaq
ilissamaas¦erpoq	V	–inngilaq
ilissamaa¦serpoq	V	{–sinngilaq, –tilinngilaq}
ilissamaat	N	–ip, –it
ilissa¦q	N	–p, –t
ilissarsi¦orpoq	V	–unngilaq
ilissarsi¦voq	V	–nngilaq
ilisserillaqqi¦ppoq	V	–nngilaq
ilisseri¦voq	V	–nngilaq
ilisserne¦q	N	–rup, –rit
ilissernerluku	N	–p, –t
iliss¦erpaa	V	–inngilaa
iliss¦erpoq	V	–inngilaq
ilissersima¦voq	V	–nngilaq
ilisserusi¦orpoq	V	–unngilaq
ilisseru¦siorpoq	V	{–siunngilaq, –tiliunngilaq}
ilisserut	N	–ip, –it
ilisserutaa¦voq	V	–nngilaq
ilissigaa¦voq	V	–nngilaq
ilissiis¦oq	N	–up, –ut
ilissinnii¦ppoq	V	–nngilaq
ilississa¦aq	V	–nngilaq
ilissu¦aq	N	–up, –it
ilissunni¦ppoq	V	–nngilaq
ilits¦erpaa	V	–inngilaa
ilitsersorneqarne¦q	N	–rup, –rit
ilitsers¦orpaa	V	–unngilaa
ilitsersorti	N	–p, –t
ilitsersortig¦aa	V	–inngilaa
ilitsersuine¦q	N	–rup, –rit
ilitsersuisart¦oq	N	–up, –ut
ilitsersuis¦oq	N	–up, –ut
ilitsersui¦voq	V	–nngilaq
ilitsersuu¦ppaa	V	–tinngilaa
ilitsersuusi¦orpoq	V	–unngilaq
ilitsersuu¦siorpoq	V	{–siunngilaq, –tiliunngilaq}
ilitser¦suusiorpoq	V	{–suusiunngilaq, –suutiliunngilaq, –tuusiunngilaq, –tuutiliunngilaq}
ilitsersuussis¦oq	N	–up, –ut
ilitser¦suussisoq	N	{–suussisup, –tuussisup}, {–suussisut, –tuussisut}
ilitsersuussi¦voq	V	–nngilaq
ilitser¦suussivoq	V	{–suussinngilaq, –tuussinngilaq}
ilitsersuut	N	–ip, –it
ilitser¦suut	N	{–suutip, –tuutip}, {–suutit, –tuutit}
ilitsersuutit	N, pl.	-
ilitser¦suutit	N, pl.	{–suutit, –tuutit}
ilitsiisa¦rpoq	V	–nngilaq
ilitsiisuu¦voq	V	–nngilaq
ilitsii¦voq	V	–nngilaq
ilitsilertorna¦rpoq	V	–nngilaq
ilitsillaqqi¦ppoq	V	–nngilaq
ilitsi¦ppaa	V	–nngilaa
ilitsiut	N	–ip, –it
ilitsiveeru¦ppaa	V	–tinngilaa
ilitsi¦veeruppaa	V	{–ffeerutinngilaa, –veerutinngilaa}
ilitsivi¦k	N	–up, –it
ilitsi¦vik	N	{–ffiup, –viup}, {–ffiit, –viit}
ilitsi¦voq	V	–nngilaq
ilitsoqqu¦ppaa	V	–tinngilaa
ilitsoqqussa¦q	N	–p, –t
ilitsoqqussi¦voq	V	–nngilaq
ilitsoqqutig¦aa	V	–inngilaa
ilitsor¦aaq	V	–inngilaq
ilitsoril¦erpoq	V	–inngilaq
ilitsorillua¦rpoq	V	–nngilaq
ilitsori¦voq	V	–nngilaq
ilitt¦oorpoq	V	–uunngilaq
ilittut	N, pl.	-
iliugaju¦ppoq	V	–nngilaq
iliullua¦rpoq	V	–nngilaq
iliu¦seq	N	–tsip, –tsit
il¦iuseq	N	{–erutsip, –iutsip}, {–erutsit, –iutsit}
ilius¦oq	N	–up, –ut
iliuu¦seq	N	–tsip, –tsit
iliuuseqanngilaq	V	(no generation)
iliuuseqaqataas¦oq	N	–up, –ut
iliuuseqaqatigiinne¦q	N	–rup, –rit
iliuuseqaqatigii¦ttarneq	N	{–ssarnerup, –ttarnerup}, {–ssarnerit, –ttarnerit}
iliuuseqarne¦q	N	–rup, –rit
iliuuseqarsinnaane¦q	N	–rup, –rit
iliuuseqarsinnaannginne¦q	N	–rup, –rit
iliuuseqart¦oq	N	–up, –ut
iliuusissa¦q	N	–p, –t
iliu¦voq	V	–nngilaq
ili¦vaa	V	–nngilaa
ilive¦q	N	–rup, –rit
iliveqarfi¦k	N	–up, –it
iliveqarfileris¦oq	N	–up, –ut
iliveqa¦rpoq	V	–nngilaq
iliveqqivi¦k	N	–up, –it
iliveqqui¦k	N	–up, –it
iliv¦erpaa	V	–inngilaa
iliversi¦ooq	N	–uup, –uut
ilivi¦ppoq	V	–nngilaq
ilivits¦oq	N	–up, –ut
ilivitsukaa¦q	N	–p, –t
ilivitsukaat	N, pl.	-
ili¦voq	V	–nngilaq
illaagut	N, pl.	-
illaagutaars¦erpoq	V	–inngilaq
illaagutaasat	N, pl.	-
illaal¦ik	N	{–iup, –lip, –lup}, –lit
illaall¦erpoq	V	–inngilaq
illaannaleqqa¦voq	V	–nngilaq
illaa¦q	N	–p, –t
illaar¦ivoq	V	{–inngilaq, –sinngilaq}
illaa¦rpaa	V	–nngilaa
illaa¦rpoq	V	–nngilaq
illaarsaa¦rpoq	V	–nngilaq
illaarsi¦voq	V	–nngilaq
illaar¦sivoq	V	{–inngilaq, –sinngilaq}
illaarsu¦k	N	–up, –it
illaasapajuppoq	V	(no generation)
illaatig¦aa	V	–inngilaa
illaatiginni¦ppoq	V	–nngilaq
illaatt¦orpoq	V	–unngilaq
illajanerulluinna¦rpoq	V	–nngilaq
illakuluppoq	V	(no generation)
illakuluutig¦aa	V	–inngilaa
illakuluutiginni¦ppoq	V	–nngilaq
illakusu¦ppoq	V	–nngilaq
illalaa¦rpoq	V	–nngilaq
illal¦erpoq	V	–inngilaq
illa¦q	N	–p, –t
illaraj¦ooq	N	–uup, –uut
illarajuppoq	V	(no generation)
illarasaa¦rpoq	V	–nngilaq
illarfig¦aa	V	–inngilaa
illaria¦rpoq	V	–nngilaq
illariili¦ppoq	V	–nngilaq
illarna¦rpoq	V	–nngilaq
illarne¦q	N	–rup, –rit
illarpalaa¦q	N	–p, –t
illarpalu¦ppoq	V	–nngilaq
illa¦rpoq	V	–nngilaq
illarsaari¦voq	V	–nngilaq
illarsa¦rpoq	V	–nngilaq
illaruaatig¦aa	V	–inngilaa
illaruaatiginni¦ppoq	V	–nngilaq
illarua¦rpoq	V	–nngilaq
illassaqanngilaq	V	(no generation)
ille¦q	N	–rup, –rit
iller¦aa	V	–inngilaa
ille¦raq	N	–qqap, –qqat
illera¦rpaa	V	–nngilaa
illera¦rpoq	V	–nngilaq
illerfi¦k	N	–up, –it
illerfissarsi¦utileqatigiit	N, pl.	{–ortileqatigiit, –utileqatigiit}
illerfissu¦aq	N	–up, –it
illerfiusa¦q	N	–p, –t
illerisa¦q	N	–p, –t
illermii¦ppoq	V	–nngilaq
illernaasanngu¦aq	N	–up, –it
illernaasa¦q	N	–p, –t
illernanngu¦aq	N	–up, –it
illerna¦q	N	–p, –t
illerna¦rpoq	V	–nngilaq
iller¦narpoq	V	{–inanngilaq, –nanngilaq}
illernarsa¦rpaa	V	–nngilaa
iller¦narsarpaa	V	{–inarsanngilaa, –narsanngilaa}
illernarsi¦voq	V	–nngilaq
illernartitaa¦voq	V	–nngilaq
iller¦nartitaavoq	V	{–inartitaanngilaq, –nartitaanngilaq}
illernart¦oq	N	–up, –ut
iller¦nartoq	N	{–inartup, –nartup}, {–inartut, –nartut}
Illernartut	N, pl.	-
Illernartut	N, pl.	–t
illernartut	N, pl.	-
iller¦nartut	N, pl.	{–inartut, –nartut}
illernartuunngits¦oq	N	–up, –ut
iller¦nartuunngitsoq	N	{–inartuunngitsup, –nartuunngitsup}, {–inartuunngitsut, –nartuunngitsut}
illernartuut	N	–ip, –it
illernartuut	N, pl.	-
iller¦nartuut	N	{–inartuutip, –nartuutip}, {–inartuutit, –nartuutit}
illerne¦q	N	–rup, –rit
ill¦erpaa	V	–inngilaa
ill¦erpoq	V	–inngilaq
illersart¦oq	N	–up, –ut
illersartut	N, pl.	-
illersi¦ppaa	V	–nngilaa
iller¦sippaa	V	{–sinngilaa, –tinngilaa}
illersissa¦q	N	–p, –t
illersorajunnerusarpaa	V	(no generation)
illersorne¦q	N	–rup, –rit
illersornia¦rpaa	V	–nngilaa
illersornissa¦q	N	–p, –t
illers¦orpaa	V	–unngilaa
illers¦orpoq	V	–unngilaq
illersorsinnaatitaane¦q	N	–rup, –rit
illersortariaqarne¦q	N	–rup, –rit
illersorti	N	–p, –t
illersortig¦aa	V	–inngilaa
illersortissalerneqanngits¦oq	N	–up, –ut
illersugaane¦q	N	–rup, –rit
illersuine¦q	N	–rup, –rit
illersuiniaqatigiiffi¦k	N	–up, –it
iller¦suiniaqatigiiffik	N	{–suiniaqatigiiffiup, –tuiniaqatigiiffiup}, {–suiniaqatigiiffiit, –tuiniaqatigiiffiit}
illersuis¦oq	N	–up, –ut
illersuisut	N, pl.	-
illersui¦voq	V	–nngilaq
illersuut	N	–ip, –it
iller¦suut	N	{–suutip, –tuutip}, {–suutit, –tuutit}
illertaa¦rpoq	V	–nngilaq
illerusaarfi¦k	N	–up, –it
illerusaa¦rpoq	V	–nngilaq
illeruu¦ppaa	V	–tinngilaa
illiaartinne¦q	N	–rup, –rit
illialu¦ppoq	V	–nngilaq
illi¦aq	N	–ssap, –ssat
illig¦aa	V	–inngilaa
illigiikkut	N	–ip, –it
illigisaqannginne¦q	N	–rup, –rit
illigisaqarne¦q	N	–rup, –rit
illigu¦ppoq	V	–nngilaq
illigussaa¦rpaa	V	–nngilaa
illigussu¦seq	N	–tsip, –tsit
illigutsaa¦ppaa	V	–tinngilaa
illigutsanne¦q	N	–rup, –rit
illigutsa¦ppoq	V	–nngilaq
illigutt¦oq	N	–up, –ut
illiisuu¦voq	V	–nngilaq
illiiumanngilaq	V	(no generation)
illii¦voq	V	–nngilaq
illikaattoorti¦ppaa	V	–nngilaa
illikaa¦voq	V	–nngilaq
illikarne¦q	N	–rup, –rit
illika¦rpaa	V	–nngilaa
illika¦rpoq	V	–nngilaq
illikarsinnaanngilaq	V	(no generation)
illikarti¦ppaa	V	–nngilaa
illikartitaane¦q	N	–rup, –rit
illikartitsine¦q	N	–rup, –rit
illikartoorne¦q	N	–rup, –rit
illikart¦oorpoq	V	–uunngilaq
ill¦ineq	N	{–ernup, –inerup}, {–ernit, –inerit}
illinnaa¦ppoq	V	–nngilaq
illinna¦rpoq	V	–nngilaq
illinnart¦oq	N	–up, –ut
illipalaarsu¦aq	N	–up, –it
illip¦oorpaa	V	–uunngilaa
illip¦oorpoq	V	–uunngilaq
illi¦ppaa	V	–tinngilaa
illi¦ppoq	V	–nngilaq
illisaaja¦rpaa	V	–nngilaa
illisaaja¦rpoq	V	–nngilaq
illisaajarsima¦voq	V	–nngilaq
illis¦eq	N	–ip, –it
illi¦sersorpaa	V	{–sersunngilaa, –silersunngilaa, –ssersunngilaa, –tsersunngilaa}
illi¦silerpaa	V	{–silinngilaa, –tsinngilaa}
illi¦silersorpaa	V	{–sersunngilaa, –silersunngilaa, –ssersunngilaa, –tsersunngilaa}
illisilersuu¦ppaa	V	–tinngilaa
illisilersuu¦ppoq	V	–tinngilaq
illisit	N, pl.	-
illissaa¦voq	V	–nngilaq
illissa¦q	N	–p, –t
illiss¦erpaa	V	–inngilaa
illi¦ssersorpaa	V	{–sersunngilaa, –silersunngilaa, –ssersunngilaa, –tsersunngilaa}
illi¦tserpaa	V	{–silinngilaa, –tsinngilaa}
illi¦tsersorpaa	V	{–sersunngilaa, –silersunngilaa, –ssersunngilaa, –tsersunngilaa}
illitsersuu¦ppaa	V	–tinngilaa
illitsersuu¦ppoq	V	–tinngilaq
illiukkuma¦voq	V	–nngilaq
illiu¦ppaa	V	–tinngilaa
illiu¦ppoq	V	–tinngilaq
illoo¦raq	N	–qqap, –qqat
ill¦ooraq	N	{–oorup, –uaqqap}, {–ooqqat, –oorit, –uaqqat}
illoorne¦q	N	–rup, –rit
ill¦oorpoq	V	–uunngilaq
ill¦oq	N	–up, –ut
illoqanngilaq	V	(no generation)
illoqannginnersa¦q	N	–p, –t
illoqarfee¦raq	N	–qqap, –qqat
illoqarf¦eeraq	N	{–eeqqap, –iaqqap}, {–eeqqat, –iaqqat}
illoqarfiit	N, pl.	-
illoqarfi¦k	N	–up, –it
illoqarfik¦oq	N	–up, –ut
illoqarfimmiut	N, pl.	-
illoqarfinngu¦aq	N	–up, –it
illoqarfissu¦aq	N	–up, –it
illoqasiu¦ppaa	V	–tinngilaa
illoqa¦siuppaa	V	{–siutinngilaa, –tiliutinngilaa}
illoqat	N	–ip, –it
illoqatigiinne¦q	N	–rup, –rit
illoqatigiit	N, pl.	-
Illoqqortoormiut	Prop, pl.	-
illoqqu¦ppaa	V	–tinngilaa
illorfi¦k	N	–up, –it
illoriit	N, pl.	-
Illorpaat	N, pl.	-
illorpassuaqarfi¦k	N	–up, –it
illorsu¦aq	N	–up, –it
Illorsuit	N, pl.	-
Illorsuit	Prop, pl.	-
illortaa¦q	N	–p, –t
illu	N	–p, –t
illua-tungeriit	N, pl.	-
illuaamitsiarpaa	V	(no generation)
illuaami¦vaa	V	–nngilaa
illuaami¦voq	V	–nngilaq
illuaraasanngu¦aq	N	–up, –it
ill¦uaraasannguaq	N	{–ooraasannguup, –uaraasannguup}, {–ooraasannguit, –uaraasannguit}
illuarakasi¦k	N	–up, –it
ill¦uarakasik	N	{–oorakasiup, –uarakasiup}, {–oorakasiit, –uarakasiit}
illua¦raq	N	–qqap, –qqat
ill¦uaraq	N	{–oorup, –uaqqap}, {–ooqqat, –oorit, –uaqqat}
illuarne¦q	N	–rup, –rit
illuarneqarsinnaas¦oq	N	–up, –ut
illuarneqarsinnaa¦voq	V	–nngilaq
illua¦rpaa	V	–nngilaa
illua¦rpoq	V	–nngilaq
illuarta¦q	N	–p, –t
illuarti¦ppaa	V	–nngilaa
illuartoorne¦q	N	–rup, –rit
illuart¦oorpoq	V	–uunngilaq
illuartussaane¦q	N	–rup, –rit
illuartussaa¦voq	V	–nngilaq
illuatig¦oorpoq	V	–uunngilaq
illua¦tigoorpoq	V	{–tiguunngilaq, –guunngilaq}
illuatung¦eq	N	–ip, –it
illuatungeriit	N, pl.	-
illuatungerisa¦q	N	–p, –t
illuatungiliunne¦q	N	–rup, –rit
illuatungiliutt¦oq	N	–up, –ut
illuernia¦q	N	–p, –t
illu¦erpoq	V	–inngilaq
illuersima¦voq	V	–nngilaq
illueru¦ppoq	V	–tinngilaq
illug¦aa	V	–inngilaa
illugiiaat	N, pl.	-
illugiikkuutaat	N, pl.	-
illugiinngitsut	N, pl.	-
illugii¦ssitsineq	N	{–ssitsinerup, –tsitsinerup}, {–ssitsinerit, –tsitsinerit}
illugiit	N, pl.	-
illugi¦ppoq	V	–nngilaq
illugissaa¦rpoq	V	–nngilaq
illugissi¦voq	V	–nngilaq
illuigaa¦voq	V	–nngilaq
illui¦gaq	N	–kkap, –kkat
illuigartaa¦rpoq	V	–nngilaq
illuikki¦orpoq	V	–unngilaq
illuinnaasiort¦oq	N	–up, –ut
illuinnaa¦siortoq	N	{–siortup, –tiliortup}, {–siortut, –tiliortut}
illuinnaasiunngits¦oq	N	–up, –ut
illuinnaa¦siunngitsoq	N	{–siunngitsup, –tiliunngitsup}, {–siunngitsut, –tiliunngitsut}
illuinnanngu¦aq	N	–up, –it
illuinna¦q	N	–ap, –at
illuinnarsiorne¦q	N	–rup, –rit
illuinnarsi¦orpoq	V	–unngilaq
illuinnars¦orpoq	V	–unngilaq
illuinnarsuut	N	–ip, –it
illuinnarsuutaasa¦q	N	–p, –t
illuinnarsuutil¦ik	N	{–iup, –lip, –lup}, –lit
Illukasi¦k	N	–up, –it
illukasi¦k	N	–up, –it
illukisaa¦rpaa	V	–nngilaa
illukisaa¦rpoq	V	–nngilaq
illukkumina¦rpoq	V	–nngilaq
illuk¦oq	N	–up, –ut
illukorsu¦aq	N	–up, –it
illuku	N	–p, –t
illukusiort¦oq	N	–up, –ut
illuleri¦voq	V	–nngilaq
illul¦erpaa	V	–inngilaa
illulia¦q	N	–p, –t
Illuligaarsu¦k	N	–up, –it
Illul¦ik	N	{–iup, –lip, –lup}, –lit
illuliorfi¦k	N	–up, –it
illuliorfissa¦q	N	–p, –t
illuliorne¦q	N	–rup, –rit
illuli¦orpaa	V	–unngilaa
illuli¦orpoq	V	–unngilaq
illuliortaa¦seq	N	–tsip, –tsit
illuliortit¦erneq	N	{–ernerup, –sernerup}, {–ernerit, –sernerit}
illuliortitsis¦oq	N	–up, –ut
illulual¦ik	N	{–iup, –lip, –lup}, –lit
illulua¦q	N	–p, –t
illumii¦ppoq	V	–nngilaq
illungavallaaqaaq	V	(no generation)
illunga¦voq	V	–nngilaq
illunikkiart¦orpoq	V	–unngilaq
illuni¦ppoq	V	–nngilaq
illunnaa¦q	N	–p, –t
illunna¦rpoq	V	–nngilaq
illunne¦q	N	–rup, –rit
illunngu¦aq	N	–up, –it
illunnguusaa¦voq	V	–nngilaq
illunnguusa¦q	N	–p, –t
illupalaanngu¦aq	N	–up, –it
illupalaa¦q	N	–p, –t
illupalaarsu¦aq	N	–up, –it
illuperaa¦rpaa	V	–nngilaa
illuperaa¦rpoq	V	–nngilaq
illupera¦rpoq	V	–nngilaq
illupia¦rpoq	V	–nngilaq
illu¦ppoq	V	–nngilaq
illusaria¦rpaa	V	–nngilaa
illusaria¦rpoq	V	–nngilaq
illusa¦rpaa	V	–nngilaa
illusimmavig¦aa	V	–inngilaa
illusimmavi¦k	N	–up, –it
illusimmavippassuaqa¦rpoq	V	–nngilaq
illusinaa¦rpaa	V	–nngilaa
illusippallaaqaaq	V	(no generation)
illusi¦ppoq	V	–nngilaq
illusisarfi¦k	N	–up, –it
illusisimasi	N	–p, –t
illusisi¦ppaa	V	–nngilaa
illusisitsine¦q	N	–rup, –rit
illusisitsi¦voq	V	–nngilaq
illusi¦voq	V	–nngilaq
illussaaleqine¦q	N	–rup, –rit
illussaarsu¦aq	N	–up, –it
illussaarsuaqaqaaq	V	(no generation)
illussa¦q	N	–p, –t
illussaqartitsine¦q	N	–rup, –rit
illussaqqi¦ppoq	V	–nngilaq
illussarsiort¦oq	N	–up, –ut
illut	N, pl.	-
ill¦utaaq	N	{–ortaap, –utaap}, {–ortaat, –utaat}
illutaa¦rpoq	V	–nngilaq
illutalissu¦aq	N	–up, –it
illutoq¦aq	N	{–qap, –ap}, {–qat, –at}
illutsianngu¦aq	N	–up, –it
illutsia¦q	N	–ap, –at
illutt¦orpoq	V	–unngilaq
illuttoruu¦ppaa	V	–tinngilaa
illuttut	N, pl.	-
illutuanngu¦aq	N	–up, –it
illutua¦q	N	–p, –t
illuusa¦q	N	–p, –t
illuut	N	–ip, –it
illuu¦tileqatigiit	N, pl.	{–tileqatigiit, –seqatigiit}
illuutil¦ik	N	{–iup, –lip, –lup}, –lit
ILO	Prop	–ip
il¦oq	N	–up, –ut
iloqaqaaq	V	(no generation)
iloqiaasa¦q	N	–p, –t
iloqiaas¦oq	N	–up, –ut
iloqiaassut	N	–ip, –it
iloqiaa¦voq	V	–nngilaq
iloqi¦ak	N	{–aap, –ssap}, {–aat, –ssat}
iloqianng¦orpoq	V	–unngilaq
iloqiss¦erpoq	V	–inngilaq
iloqissersimane¦q	N	–rup, –rit
iloqissi¦orpoq	V	–unngilaq
iloqqasut	N, pl.	-
iloqqu¦ppaa	V	{–nngilaa, –tinngilaa}
iloqqu¦tsisarneq	N	{–ssisarnerup, –tsisarnerup}, {–ssisarnerit, –tsisarnerit}
iloqqu¦tsivoq	V	{–ssinngilaq, –tsinngilaq}
iloqquts¦orpoq	V	–unngilaq
iloqqutsug¦aa	V	–inngilaa
iloqut	N	–ip, –it
iloqutit	N, pl.	-
ilorfaallag¦aa	V	–inngilaa
ilorfaalla¦ppoq	V	–nngilaq
ilorfa¦q	N	–ap, –at
ilorfarmi¦ppaa	V	–nngilaa
ilorfarm¦oorpaa	V	–uunngilaa
ilorl¦eq	N	–iup, –iit
ilorlerpaa¦q	N	–p, –t
ilorlersaat	N	–ip, –it
ilorliit	N, pl.	-
ilorliut	N	–ip, –it
ilorliut	N, pl.	-
ilorliu¦voq	V	–nngilaq
ilorli¦vaa	V	–nngilaa
ilorpa¦rpoq	V	–nngilaq
ilorpasi¦ppoq	V	–nngilaq
ilorraallag¦aa	V	–inngilaa
ilorraallak	Interj	(no generation)
ilorraallangaa¦rpoq	V	–nngilaq
ilorraallannaqaaq	V	(no generation)
ilorraallanna¦rpoq	V	–nngilaq
ilorraallanne¦q	N	–rup, –rit
ilorraalla¦ppoq	V	–nngilaq
ilorraallatsi¦ppaa	V	–nngilaa
ilorra¦q	N	–ap, –at
ilorrarm¦oorpaa	V	–uunngilaa
ilorrarm¦oorpoq	V	–uunngilaq
ilorri¦orpaa	V	–unngilaa
ilorri¦orpoq	V	–unngilaq
ilorri¦ppoq	V	–nngilaq
ilorrisaarna¦rpoq	V	–nngilaq
ilorrisaa¦rpoq	V	–nngilaq
ilorrisimaarnart¦oq	N	–up, –ut
ilorrisimaa¦rpoq	V	–nngilaq
ilorru¦voq	V	–nngilaq
ilorsu¦aq	N	–up, –it
Ilu	N	–p, –t
ilu	N	–p, –t
iluaag¦aa	V	–inngilaa
iluaaginarsivoq	V	(no generation)
iluaaginngilaa	V	(no generation)
iluaaginni¦ppoq	V	–nngilaq
iluaakkunnaa¦rpoq	V	–nngilaq
iluaakuju¦ppoq	V	–nngilaq
iluaallaatig¦aa	V	–inngilaa
iluaallak	Interj	(no generation)
iluaallangaa¦rpoq	V	–nngilaq
iluaallannaqaaq	V	(no generation)
iluaallanna¦rpoq	V	–nngilaq
iluaalla¦ppoq	V	–nngilaq
iluaallatsitsine¦q	N	–rup, –rit
iluaallerne¦q	N	–rup, –rit
iluaall¦erpoq	V	–inngilaq
iluaalliart¦orpoq	V	–unngilaq
iluaalli¦orpoq	V	–unngilaq
iluaalliu¦ut	N	{–tip, –utip}, {–tit, –utit}
iluaalli¦voq	V	–nngilaq
iluaanne¦q	N	–rup, –rit
iluaa¦ppoq	V	–nngilaq
iluaassu¦seq	N	–tsip, –tsit
iluaat	N	–ip, –it
iluaats¦oq	N	–up, –ut
iluaatsulia¦q	N	–p, –t
iluaatsuli¦orpoq	V	–unngilaq
iluakk¦ooq	N	–uup, –uut
iluakk¦oorpoq	V	–uunngilaq
ilu¦akkoorpoq	V	{–akkuunngilaq, –ssakkuunngilaq}
iluam¦eerpoq	V	–iinngilaq
ilu¦ameerpoq	V	{–amiinngilaq, –aminngaanniinngilaq, –ssamiinngilaq, –ssaminngaanniinngilaq}
iluameersitsinia¦rpoq	V	–nngilaq
ilu¦ameersitsiniarpoq	V	{–ameersitsinianngilaq, –aminngaanneersitsinianngilaq, –ssameersitsinianngilaq, –ssaminngaanneersitsinianngilaq}
iluameer¦soq	N	{–sup, –tup}, {–sut, –tut}
ilu¦ameersoq	N	{–ameersup, –ameertup, –aminngaanneersup, –aminngaanneertup, –ssameersup, –ssameertup, –ssaminngaanneersup, –ssaminngaanneertup}, {–ameersut, –ameertut, –aminngaanneersut, –aminngaanneertut, –ssameersut, –ssameertut, –ssaminngaanneersut, –ssaminngaanneertut}
iluanaanngilaq	V	(no generation)
iluanaaqutig¦aa	V	–inngilaa
iluanaariart¦orpoq	V	–unngilaq
iluanaar¦iartorpoq	V	{–iartunngilaq, –siartunngilaq}
iluanaarnart¦oq	N	–up, –ut
iluanaarne¦q	N	–rup, –rit
iluanaarniapilunne¦q	N	–rup, –rit
iluanaarniapilutt¦oq	N	–up, –ut
iluanaarniarfig¦aa	V	–inngilaa
iluanaarniarne¦q	N	–rup, –rit
iluanaarniuteqarne¦q	N	–rup, –rit
iluanaa¦rpaa	V	–nngilaa
iluanaarpallaanngilaq	V	(no generation)
iluanaa¦rpoq	V	–nngilaq
iluanaartitsi¦voq	V	–nngilaq
iluanaart¦oq	N	–up, –ut
iluanaaru¦ppaa	V	–tinngilaa
iluanaarut	N	–ip, –it
iluanaarutaa¦voq	V	–nngilaq
iluanaarutig¦aa	V	–inngilaa
iluanaarutit	N, pl.	-
iluanaarutivi¦k	N	–up, –it
iluangerajuppoq	V	(no generation)
iluang¦erpoq	V	–inngilaq
iluangertaanna¦rpoq	V	–nngilaq
iluanii¦ppoq	V	–nngilaq
ilu¦aniippoq	V	{–aniinngilaq, –ssaniinngilaq}
iluaniitt¦oq	N	–up, –ut
ilu¦aniittoq	N	{–aniittup, –ssaniittup}, {–aniittut, –ssaniittut}
iluanngits¦oq	N	–up, –ut
iluanngitsuliorne¦q	N	–rup, –rit
iluanngitsuliort¦oq	N	–up, –ut
iluanngitsuliortu¦iaaneq	N	{–ajaanerup, –iaanerup}, {–ajaanerit, –iaanerit}
ilu¦aq	N	{–ap, –ssap}, {–at, –ssat}
iluaqu¦serpaa	V	{–sinngilaa, –tilinngilaa}
iluaqusers¦orpaa	V	–unngilaa
iluaqu¦sersorpaa	V	{–sersunngilaa, –tilersunngilaa}
iluaqu¦sersuut	N	{–sersuutip, –sertuutip, –tilersuutip, –tilertuutip}, {–sersuutit, –sertuutit, –tilersuutit, –tilertuutit}
iluaqusiu¦ppaa	V	–tinngilaa
iluaqu¦siuppaa	V	{–siutinngilaa, –tiliutinngilaa}
iluaqut	N	–ip, –it
iluaqutaanngilaq	V	(no generation)
iluaqutaanngitsoorsinnaanngits¦oq	N	–up, –ut
iluaqutaanngits¦oq	N	–up, –ut
iluaqutaas¦oq	N	–up, –ut
iluaqutaati¦ppaa	V	–nngilaa
iluaqutaa¦voq	V	–nngilaq
iluaquteqarne¦q	N	–rup, –rit
iluaqutig¦aa	V	–inngilaa
iluaqutigeqqiineq	N	(no generation)
iluaqutiginninne¦q	N	–rup, –rit
iluaqutiginninniarne¦q	N	–rup, –rit
iluaqutissa¦q	N	–p, –t
iluaqutit	N, pl.	-
iluaqutsiu¦ppaa	V	–tinngilaa
iluaqut¦siuppaa	V	{–italiutinngilaa, –siutinngilaa}
iluar¦aa	V	–inngilaa
iluareqqusaarpoq	V	(no generation)
iluareqquvoq	V	(no generation)
iluarerpalunngilaa	V	(no generation)
iluariinna¦rpaa	V	–nngilaa
iluarileraluttuinnarpaa	V	(no generation)
iluarillua¦rpaa	V	–nngilaa
iluarinanngilaq	V	(no generation)
iluarinanngits¦oq	N	–up, –ut
iluarinart¦oq	N	–up, –ut
iluarineqanngilaq	V	(no generation)
iluarineqa¦rpoq	V	–nngilaq
iluarinngilaa	V	(no generation)
iluarinninne¦q	N	–rup, –rit
iluarinni¦ppoq	V	–nngilaq
iluarinnitt¦oq	N	–up, –ut
iluarisaars¦orpoq	V	–unngilaq
iluarisaa¦voq	V	–nngilaq
iluarisarsiorne¦q	N	–rup, –rit
iluarne¦q	N	–rup, –rit
iluarnerpaa¦q	N	–p, –t
iluarnersa¦q	N	–p, –t
iluarnersi¦orpaa	V	–unngilaa
iluarnia¦rpoq	V	–nngilaq
ilua¦rpoq	V	–nngilaq
iluarsaane¦q	N	–rup, –rit
iluarsaa¦ppaa	V	–tinngilaa
iluarsaaqqinne¦q	N	–rup, –rit
iluarsaas¦oq	N	–up, –ut
iluarsaassine¦q	N	–rup, –rit
iluarsaassisart¦oq	N	–up, –ut
iluarsaassivinne¦q	N	–rup, –rit
iluarsaassi¦voq	V	–nngilaq
iluarsaata¦q	N	–p, –t
iluarsaatig¦aa	V	–inngilaa
iluarsaa¦voq	V	–nngilaq
iluarsagaane¦q	N	–rup, –rit
iluarsaqqi¦ppaa	V	–nngilaa
iluarsa¦rpaa	V	–nngilaa
iluarsartuunneqart¦oq	N	–up, –ut
iluarsartuu¦ppaa	V	–tinngilaa
iluarsartuussi¦voq	V	–nngilaq
iluarseqqi¦ppoq	V	–nngilaq
iluarsiart¦orpoq	V	–unngilaq
iluarsiar¦torpoq	V	{–tunngilaq, –sunngilaq}
iluarsiine¦q	N	–rup, –rit
iluarsiissut	N	–ip, –it
iluarsiissutiginia¦gaq	N	–kkap, –kkat
iluarsineqarsinnaas¦oq	N	–up, –ut
iluarsisa¦q	N	–p, –t
iluarsissutig¦aa	V	–inngilaa
iluarsi¦vaa	V	–nngilaa
iluarsivikkunarpoq	V	(no generation)
iluarsi¦voq	V	–nngilaq
iluarsu¦seq	N	–tsip, –tsit
iluarti¦ppaa	V	–nngilaa
iluartitaari¦voq	V	–nngilaq
iluartitsi¦voq	V	–nngilaq
iluart¦oq	N	–up, –ut
iluartulersaarut	N	–ip, –it
iluartuli¦orpoq	V	–unngilaq
iluartunnguutig¦aa	V	–inngilaa
Iluartut	N, pl.	-
iluartut	N, pl.	-
iluartuusaa¦rpoq	V	–nngilaq
iluartuusaart¦oq	N	–up, –ut
iluartuussut	N	–ip, –it
iluartuussutig¦aa	V	–inngilaa
iluartuuti¦ppaa	V	–nngilaa
iluartuutitaassutig¦aa	V	–inngilaa
iluartuutita¦q	N	–p, –t
iluartuu¦voq	V	–nngilaq
iluarusunnaqaaq	V	(no generation)
iluarusunnarpoq	V	(no generation)
iluarusu¦ppoq	V	–nngilaq
iluasaannginne¦q	N	–rup, –rit
iluasaaqqinne¦q	N	–rup, –rit
iluasaaqqissaa¦rpoq	V	–nngilaq
iluasaarpallaanngits¦oq	N	–up, –ut
iluasaa¦rpoq	V	–nngilaq
iluasaartaannarpoq	V	(no generation)
iluatig¦aa	V	–inngilaa
iluatiginngilaa	V	(no generation)
iluatig¦oorpoq	V	–uunngilaq
ilua¦tigoorpoq	V	{–tiguunngilaq, –guunngilaq}
ilu¦atigoorpoq	V	{–atiguunngilaq, –ssatiguunngilaq}
iluatikkunnaqaaq	V	(no generation)
iluatikku¦ppaa	V	–tinngilaa
iluatinnannginne¦q	N	–rup, –rit
iluatinnanngits¦oq	N	–up, –ut
iluatinnaqaaq	V	(no generation)
iluatinna¦rpoq	V	–nngilaq
iluatinnart¦oq	N	–up, –ut
iluatissa¦rpoq	V	–nngilaq
iluatsikkiart¦orpoq	V	–unngilaq
iluatsilluarne¦q	N	–rup, –rit
iluatsillua¦rpaa	V	–nngilaa
iluatsillua¦rpoq	V	–nngilaq
iluatsilluart¦oq	N	–up, –ut
iluatsinngitsoorne¦q	N	–rup, –rit
iluatsinngitsoorpoq	V	(no generation)
iluatsinngitsoort¦oq	N	–up, –ut
iluatsinngitsuu¦gaq	N	–kkap, –kkat
iluatsi¦ppaa	V	–nngilaa
iluatsi¦ppoq	V	–nngilaq
iluatsissimas¦oq	N	–up, –ut
iluatsissinnaanngilaq	V	(no generation)
iluatsitaari¦voq	V	–nngilaq
iluatsitsigajunnarneru¦voq	V	–nngilaq
iluatsit¦silaarpoq	V	{–ilaanngilaq, –silaanngilaq}
iluatsit¦silluarneq	N	{–illuarnerup, –silluarnerup}, {–illuarnerit, –silluarnerit}
iluatsit¦silluartoq	N	{–illuartup, –silluartup}, {–illuartut, –silluartut}
iluatsitsinngilaq	V	(no generation)
iluatsitsisinnaanngilaq	V	(no generation)
iluatsitsi¦viunnginneq	N	{–ffiunnginnerup, –viunnginnerup}, {–ffiunnginnerit, –viunnginnerit}
iluatsitsi¦voq	V	–nngilaq
iluatsitt¦oq	N	–up, –ut
ilue¦q	N	–rup, –rit
ilueqarfi¦k	N	–up, –it
ilu¦erpaa	V	–inngilaa
iluersi¦ooq	N	–uup, –uut
iluilaarsu¦k	N	–up, –it
iluilaarsummiu	N	–p, –t
iluila¦q	N	–ap, –at
iluilarmii¦ppoq	V	–nngilaq
iluilarmiu	N	–p, –t
iluile¦q	N	–rup, –rit
iluilluinna¦rpoq	V	–nngilaq
ilui¦ppoq	V	–nngilaq
iluitsukaa¦q	N	–p, –t
iluki¦ppoq	V	–nngilaq
iluleq	N	–rnup, –rnit
ilulequt	N	–ip, –it
ilulequtaa¦voq	V	–nngilaq
ilulequt¦serpaa	V	{–italinngilaa, –sinngilaa}
ilulersu¦aq	N	–up, –it
iluliam¦ineq	N	–ernup, –ernit
ilulia¦q	N	–p, –t
iluli¦aq	N	–ssap, –ssat
iluliarsu¦aq	N	–up, –it
iluliarujussu¦aq	N	–up, –it
iluliaru¦seq	N	–tsip, –tsit
iluliiaat	N	–ip, –it
iluliiaataaru¦ppoq	V	–tinngilaq
ilulissa¦q	N	–p, –t
Ilulissat	N, pl.	-
Ilulissat	Prop, pl.	-
ilulissat	N, pl.	-
iluliss¦erpaa	V	{–alinngilaa, –inngilaa}
iluliss¦erpoq	V	–inngilaq
ilulissersorsuu¦voq	V	–nngilaq
ilulissersorsu¦uvoq	V	{–aanngilaq, –unngilaq}
ilulisser¦sorsuuvoq	V	{–sorsuaanngilaq, –sorsuunngilaq, –torsuaanngilaq, –torsuunngilaq}
iluliss¦ersorsuuvoq	V	{–alersorsuaanngilaq, –alersorsuunngilaq, –alertorsuaanngilaq, –alertorsuunngilaq, –ersorsuaanngilaq, –ersorsuunngilaq, –ertorsuaanngilaq, –ertorsuunngilaq}
ilulissivi¦k	N	–up, –it
iluliumane¦q	N	–rup, –rit
iluliumanil¦ik	N	{–iup, –lip, –lup}, –lit
iluliuma¦voq	V	–nngilaq
iluliummaa¦ppoq	V	–tinngilaq
iluliumma¦rpoq	V	–nngilaq
iluliummarti¦ppaa	V	–nngilaa
iluliusani¦ppoq	V	–nngilaq
iluliusa¦q	N	–p, –t
ilull¦eq	N	–iup, –iit
ilull¦erpaa	V	–inngilaa
ilull¦erpoq	V	–inngilaq
ilullersaa¦rpoq	V	–nngilaq
ilulliine¦q	N	–rup, –rit
ilullil¦erpaa	V	–inngilaa
ilullil¦erpoq	V	–inngilaq
ilulline¦q	N	–rup, –rit
ilullisaa¦voq	V	–nngilaq
ilullisa¦q	N	–p, –t
ilullissia¦q	N	–p, –t
ilulliussaa¦voq	V	–nngilaq
ilulli¦vaa	V	–nngilaa
ilulli¦voq	V	–nngilaq
ilulunne¦q	N	–rup, –rit
iluluum¦erpoq	V	–inngilaq
iluluumi¦voq	V	–nngilaq
ilumikk¦erpoq	V	–inngilaq
ilumikkiss¦erpoq	V	–inngilaq
ilumikkiu¦ppaa	V	–tinngilaa
ilumil¦erpoq	V	–inngilaq
ilumioqarne¦q	N	–rup, –rit
ilumioqa¦rpoq	V	–nngilaq
ilumi¦ppoq	V	–nngilaq
ilumiu	N	–p, –t
ilumiug¦aa	V	–inngilaa
ilumiulerfi¦k	N	–up, –it
ilumiul¦erpaa	V	–inngilaa
ilumiuliu¦ppaa	V	–tinngilaa
ilumiuliussis¦oq	N	–up, –ut
ilumiunittarfi¦k	N	–up, –it
ilumiuu¦voq	V	–nngilaq
ilummia¦rpoq	V	–nngilaq
ilummoorne¦q	N	–rup, –rit
ilum¦moorneq	N	{–moornerup, –oornerup}, {–moornerit, –oornerit}
ilumm¦oorpoq	V	–uunngilaq
ilum¦moorpoq	V	{–muunngilaq, –uunngilaq}
ilummukaa¦ppaa	V	–tinngilaa
ilum¦mukaappaa	V	{–mukaatinngilaa, –ukaatinngilaa}
ilummukaassi¦voq	V	–nngilaq
ilum¦mukaassivoq	V	{–mukaassinngilaq, –ukaassinngilaq}
ilummuka¦rpoq	V	–nngilaq
ilum¦mukarpoq	V	{–mukanngilaq, –ukanngilaq}
ilummuulaaginna¦rpoq	V	–nngilaq
ilumoorfig¦aa	V	–inngilaa
ilum¦oorfigaa	V	{–moorfiginngilaa, –oorfiginngilaa}
ilumoorfiginngilaa	V	(no generation)
ilumoorluinna¦rpoq	V	–nngilaq
ilum¦oorluinnarpoq	V	{–moorluinnanngilaq, –oorluinnanngilaq}
ilumoorne¦q	N	–rup, –rit
ilum¦oorneq	N	{–moornerup, –oornerup}, {–moornerit, –oornerit}
ilumoorniaqqissaart¦oq	N	–up, –ut
ilum¦oorniaqqissaartoq	N	{–moorniaqqissaartup, –oorniaqqissaartup}, {–moorniaqqissaartut, –oorniaqqissaartut}
ilumoorniart¦oq	N	–up, –ut
ilum¦oorniartoq	N	{–moorniartup, –oorniartup}, {–moorniartut, –oorniartut}
ilum¦oorpoq	V	{–muunngilaq, –uunngilaq}
ilum¦oorpoq	V	–uunngilaq
ilumoorsaanngits¦oq	N	–up, –ut
ilum¦oorsaanngitsoq	N	{–moorsaanngitsup, –oorsaanngitsup}, {–moorsaanngitsut, –oorsaanngitsut}
ilumoorsaarne¦q	N	–rup, –rit
ilum¦oorsaarneq	N	{–moorsaarnerup, –oorsaarnerup}, {–moorsaarnerit, –oorsaarnerit}
ilumoorsaarpallaanngilaq	V	(no generation)
ilumoorsaarpalutt¦oq	N	–up, –ut
ilum¦oorsaarpaluttoq	N	{–moorsaarpaluttup, –oorsaarpaluttup}, {–moorsaarpaluttut, –oorsaarpaluttut}
ilumoorsaa¦rpoq	V	–nngilaq
ilum¦oorsaarpoq	V	{–moorsaanngilaq, –oorsaanngilaq}
ilumoorsaart¦oq	N	–up, –ut
ilum¦oorsaartoq	N	{–moorsaartup, –oorsaartup}, {–moorsaartut, –oorsaartut}
ilumoortaanna¦rpoq	V	–nngilaq
ilumoort¦oq	N	–up, –ut
ilum¦oortoq	N	{–moortup, –oortup}, {–moortut, –oortut}
ilumoortuaanna¦rpoq	V	–nngilaq
ilum¦oortuaannarpoq	V	{–moortuaannanngilaq, –oortuaannanngilaq}
ilumooru¦ppaa	V	–tinngilaa
ilumooruppallaa¦rpaa	V	–nngilaa
ilumoorussivallaa¦rpoq	V	–nngilaq
ilumoorussi¦voq	V	–nngilaq
ilumut	Interj	(no generation)
ilumuuinnguatsiarpoq	V	(no generation)
ilumuuiss¦orpoq	V	–unngilaq
ilum¦uuissorpoq	V	{–muuissunngilaq, –uuissunngilaq}
ilumuunngilaq	V	(no generation)
ilumuunngissu¦seq	N	–tsip, –tsit
ilum¦uunngissuseq	N	{–muunngissutsip, –uunngissutsip}, {–muunngissutsit, –uunngissutsit}
ilumuunngits¦oq	N	–up, –ut
ilum¦uunngitsoq	N	{–muunngitsup, –uunngitsup}, {–muunngitsut, –uunngitsut}
ilumuussu¦seq	N	–tsip, –tsit
ilum¦uussuseq	N	{–muussutsip, –uussutsip}, {–muussutsit, –uussutsit}
iluna¦rpoq	V	–nngilaq
ilune¦q	N	–rup, –rit
ilung¦erpaa	V	–inngilaa
ilung¦erpoq	V	–inngilaq
ilungersornaqaaq	V	(no generation)
ilungersorna¦rpoq	V	–nngilaq
ilungersornarsigaluttuinnarpoq	V	(no generation)
ilungersorne¦q	N	–rup, –rit
ilungersornial¦erpoq	V	–inngilaq
ilungersorpallaartaqaaq	V	(no generation)
ilungersorpalutt¦oq	N	–up, –ut
ilunger¦sorpaluttoq	N	{–sorpaluttup, –torpaluttup}, {–sorpaluttut, –torpaluttut}
ilungers¦orpoq	V	–unngilaq
ilungersortariaqalersima¦voq	V	–nngilaq
ilungersortariaqarneru¦voq	V	–nngilaq
ilungersortariaqassagaluarpoq	V	(no generation)
ilungersort¦oq	N	–up, –ut
ilungersortuunngissu¦seq	N	–tsip, –tsit
ilunger¦sortuunngissuseq	N	{–sortuunngissutsip, –tortuunngissutsip}, {–sortuunngissutsit, –tortuunngissutsit}
ilungersortuunngits¦oq	N	–up, –ut
ilungersorunanngilaq	V	(no generation)
ilungersuallanne¦q	N	–rup, –rit
ilungersuallappallappoq	V	(no generation)
ilungersuallappallatta¦rpoq	V	–nngilaq
ilungersuana¦rpoq	V	–nngilaq
ilungersuanassu¦seq	N	–tsip, –tsit
ilungersuane¦q	N	–rup, –rit
ilungersuassutig¦aa	V	–inngilaa
ilungersua¦voq	V	–nngilaq
ilungersukatattaraluaqaaq	V	(no generation)
ilungersukatattaraluarpoq	V	(no generation)
ilungersukatavippoq	V	(no generation)
ilungersukujukkaluarpoq	V	(no generation)
ilungersukujukkunarpoq	V	(no generation)
ilungersukujukkunnaarpoq	V	(no generation)
ilungersulaarusuppoq	V	(no generation)
ilungersuna¦rpoq	V	–nngilaq
ilungersunart¦oq	N	–up, –ut
ilungersutsiaraluarpoq	V	(no generation)
ilungersuu¦ppaa	V	–tinngilaa
ilungersuussilluart¦oq	N	–up, –ut
ilunger¦suussilluartoq	N	{–suussilluartup, –tuussilluartup}, {–suussilluartut, –tuussilluartut}
ilungersuussine¦q	N	–rup, –rit
ilunger¦suussineq	N	{–suussinerup, –tuussinerup}, {–suussinerit, –tuussinerit}
ilungersuussis¦oq	N	–up, –ut
ilunger¦suussisoq	N	{–suussisup, –tuussisup}, {–suussisut, –tuussisut}
ilungersuussi¦voq	V	–nngilaq
ilunger¦suussivoq	V	{–suussinngilaq, –tuussinngilaq}
ilungersuutig¦aa	V	–inngilaa
ilunger¦suutigaa	V	{–suutiginngilaa, –tuutiginngilaa}
ilungersuutigisariaqarnera¦rpaa	V	–nngilaa
ilunger¦suutigisariaqarnerarpaa	V	{–suutigisariaqarneranngilaa, –tuutigisariaqarneranngilaa}
ilunngunangaart¦oq	N	–up, –ut
ilunnguna¦rpoq	V	–nngilaq
ilunngunart¦oq	N	–up, –ut
ilunngune¦q	N	–rup, –rit
ilunngussutig¦aa	V	–inngilaa
ilunnguummina¦rpoq	V	–nngilaq
ilunnguummi¦voq	V	–nngilaq
ilunnguutig¦aa	V	–inngilaa
ilunngu¦voq	V	–nngilaq
ilupaa¦q	N	–p, –t
ilupaartaa¦rpoq	V	–nngilaq
ilupaaru¦seq	N	–tsip, –tsit
ilupaaru¦serpaa	V	{–sinngilaa, –tilinngilaa}
ilupaaru¦serpoq	V	{–sinngilaq, –tilinngilaq}
ilupaarut	N	–ip, –it
ilupaassa¦q	N	–p, –t
ilupaassia¦q	N	–p, –t
ilupaassiassa¦q	N	–p, –t
ilupaqu¦serpaa	V	{–sinngilaa, –tilinngilaa}
ilupaqu¦sersorpaa	V	{–sersunngilaa, –tilersunngilaa}
ilupaqut	N	–ip, –it
ilupaqutit	N, pl.	-
ilupaqut¦serpaa	V	{–italinngilaa, –sinngilaa}
ilupaqutserpoq	V	(no generation)
ilupa¦sserpaa	V	{–alinngilaa, –ssinngilaa}
ilus¦eerpoq	V	–iinngilaq
ilu¦seq	N	–tsip, –tsit
iluseqanngits¦oq	N	–up, –ut
iluseqarluarne¦q	N	–rup, –rit
iluseri¦ppoq	V	–nngilaq
iluseri¦ssoq	N	{–ssup, –ttup}, {–ssut, –ttut}
iluserli¦orpoq	V	–unngilaq
iluserlu¦ppoq	V	–nngilaq
iluserlutt¦oq	N	–up, –ut
ilusil¦erpaa	V	–inngilaa
ilu¦silerpaa	V	{–silinngilaa, –tililinngilaa}
ilusilers¦orpaa	V	–unngilaa
ilusilersugaane¦q	N	–rup, –rit
ilusilersuine¦q	N	–rup, –rit
ilusilersuisarfi¦k	N	–up, –it
ilusilersuisart¦oq	N	–up, –ut
ilusilersui¦voq	V	–nngilaq
ilusiligaane¦q	N	–rup, –rit
ilusili¦gaq	N	–kkap, –kkat
ilusiliigallarne¦q	N	–rup, –rit
ilusiluppoq	V	(no generation)
ilusilussuseq	N	(no generation)
ilut	N	–ip, –it
ilut	N, pl.	-
ilutaaru¦ppoq	V	–tinngilaq
iluta¦k	N	–ap, –at
ilutammi¦ppaa	V	–nngilaa
ilutammi¦ppoq	V	–nngilaq
iluta¦q	N	–p, –t
ilutig¦aa	V	–inngilaa
ilutigiit	N, pl.	-
iluts¦erpaa	V	–inngilaa
ilut¦serpaa	V	{–italinngilaa, –sinngilaa}
ilutt¦orpaa	V	–unngilaa
iluttoru¦ppoq	V	–nngilaq
iluttuarpalu¦ppoq	V	–nngilaq
ilutuallaaqaaq	V	(no generation)
ilutunersaa¦voq	V	–nngilaq
ilutu¦voq	V	–nngilaq
iluunnga¦rpaa	V	–nngilaa
iluunnga¦rpoq	V	–nngilaq
iluuuseqarsinnaassu¦seq	N	–tsip, –tsit
ilu¦voq	V	–nngilaq
ima	N	–p, –t
imaaginnart¦oq	N	–up, –ut
imaajaat	N	–ip, –it
imaajaa¦voq	V	–nngilaq
imaaja¦rpaa	V	–nngilaa
imaakajaa¦rpoq	V	–nngilaq
imaakajaarutig¦aa	V	–inngilaa
imaakkajuppoq	V	(no generation)
imaakkajutta¦rpoq	V	–nngilaq
imaaler¦eerpoq	V	–iinngilaq
imaaliallaanna¦q	N	–ap, –at
imaaliinnart¦oq	N	–up, –ut
imaali¦orpaa	V	–unngilaa
imaali¦orpoq	V	–unngilaq
imaali¦vaa	V	–nngilaa
imaali¦voq	V	–nngilaq
imaallaat	Interj	(no generation)
imaan¦eersoq	N	{–eersup, –eertup, –inngaanneersup, –inngaanneertup}, {–eersut, –eertut, –inngaanneersut, –inngaanneertut}
imaangajaa¦rpoq	V	–nngilaq
imaannaanngilaq	V	(no generation)
imaannaanngissu¦seq	N	–tsip, –tsit
imaannaanngits¦oq	N	–up, –ut
imaannaanngitsuu¦voq	V	–nngilaq
imaannaas¦oq	N	–up, –ut
imaannaa¦voq	V	–nngilaq
imaanna¦q	N	–ap, –at
imaa¦ppoq	V	–nngilaq
imaa¦rpaa	V	–nngilaa
imaa¦rpoq	V	–nngilaq
imaarsaane¦q	N	–rup, –rit
imaarsaa¦voq	V	–nngilaq
imaarsarfi¦k	N	–up, –it
imaarsa¦rpaa	V	–nngilaa
imaarsart¦oq	N	–up, –ut
imaarsine¦q	N	–rup, –rit
imaarsivigitinne¦q	N	–rup, –rit
imaarsi¦voq	V	–nngilaq
imaartuinna¦rpoq	V	–nngilaq
imaartu¦innarpoq	V	–aannanngilaq
imaaru¦ppaa	V	–tinngilaa
imaaru¦ppoq	V	–tinngilaq
imaarutivi¦ppoq	V	–nngilaq
imaarutt¦oorpoq	V	–uunngilaq
imaasi¦vaa	V	–nngilaa
imaasi¦voq	V	–nngilaq
imaassinnaa¦voq	V	–nngilaq
imaatt¦oq	N	–up, –ut
imaattoqanngilaq	V	(no generation)
imaatt¦orpoq	V	–unngilaq
imaattuarpoq	V	(no generation)
imaattuarsinnarpoq	V	(no generation)
imaattuut	N	–ip, –it
imaava¦rpoq	V	–nngilaq
imakilli¦voq	V	–nngilaq
imakinaa¦rpaa	V	–nngilaa
imaki¦ppoq	V	–nngilaq
imakits¦oq	N	–up, –ut
imakunng¦erpoq	V	–inngilaq
imakut	N, pl.	-
imakut¦orpoq	V	–unngilaq
imal¦ik	N	{–iup, –lip, –lup}, –lit
imaliliorne¦q	N	–rup, –rit
imalili¦orpoq	V	–unngilaq
ima¦neq	N	{–nerup, –rnup}, {–nerit, –rnit}
imang¦erpoq	V	–inngilaq
imangersaa¦voq	V	–nngilaq
imangersa¦rpaa	V	–nngilaa
imangerta¦q	N	–p, –t
imanna	Interj	(no generation)
imannaali¦voq	V	–nngilaq
imannaa¦voq	V	–nngilaq
imanngari¦ppoq	V	–nngilaq
imanngarsu¦aq	N	–up, –it
imanngasi¦ppoq	V	–nngilaq
im¦aq	N	{–ap, –map}, {–at, –mat}
imaqanngits¦oq	N	–up, –ut
imaqarlua¦rpoq	V	–nngilaq
imaqarnersi¦orpaa	V	–unngilaa
imaqarnersiuine¦q	N	–rup, –rit
imaqarnersiui¦voq	V	–nngilaq
imaqarnilia¦q	N	–p, –t
imaqarniliorne¦q	N	–rup, –rit
imaqarnili¦orpaa	V	–unngilaa
imaqarniliuis¦oq	N	–up, –ut
imaqa¦rpoq	V	–nngilaq
imaqqinne¦q	N	–rup, –rit
imaqqortunersaa¦voq	V	–nngilaq
imaqqortussu¦seq	N	–tsip, –tsit
imaqqortu¦voq	V	–nngilaq
imaqquki¦ppoq	V	–nngilaq
imaqulatsi¦voq	V	–nngilaq
imar¦aa	V	–inngilaa
imari¦aq	N	–ssap, –ssat
imarigaju¦ppaa	V	–nngilaa
imari¦ppoq	V	–nngilaq
imarisa¦q	N	–p, –t
imarissi¦voq	V	–nngilaq
imarissorsuu¦voq	V	–nngilaq
imari¦ssorsuuvoq	V	{–ssorsuaanngilaq, –ssorsuunngilaq, –ttorsuaanngilaq, –ttorsuunngilaq}
imarmiu	N	–p, –t
imarnersaaru¦ppoq	V	–tinngilaq
imarnersani¦ppoq	V	–nngilaq
imarnersa¦q	N	–p, –t
imar¦orpoq	V	–unngilaq
ima¦rpaa	V	–nngilaa
imarpalla¦ppoq	V	–nngilaq
ima¦rpallappoq	V	{–pallanngilaq, –rpallanngilaq}
imarpi¦k	N	–up, –it
imarpissu¦aq	N	–up, –it
imarsioqqi¦ppoq	V	–nngilaq
imarsiornerlunne¦q	N	–rup, –rit
imarsi¦orpoq	V	–unngilaq
imarsiort¦oq	N	–up, –ut
imarsiullaqqi¦ppoq	V	–nngilaq
imarsiut	N	–ip, –it
imarsiutit	N, pl.	-
imarsu¦aq	N	–up, –it
imarta¦q	N	–p, –t
imarti¦ppaa	V	–nngilaa
imartoqaaq	V	(no generation)
imartorumane¦q	N	–rup, –rit
imartune¦q	N	–rup, –rit
imartunersa¦q	N	–p, –t
imartusi¦voq	V	–nngilaq
imartussu¦seq	N	–tsip, –tsit
imartu¦voq	V	–nngilaq
imarualarpalu¦ppoq	V	–nngilaq
imaruala¦voq	V	–nngilaq
imaruarpalu¦ppoq	V	–nngilaq
imaruarpaluttuinnaa¦voq	V	–nngilaq
imarunngu¦voq	V	–nngilaq
imaruu¦ppaa	V	–tinngilaa
imaruussaa¦voq	V	–nngilaq
imasiortulersaarutit	N, pl.	-
imassaaru¦ppoq	V	–tinngilaq
imassaasuane¦q	N	–rup, –rit
imassaat	N	–ip, –it
imassaataaru¦ppoq	V	–tinngilaq
imassa¦q	N	–p, –t
imassat	N, pl.	-
imavia¦q	N	–p, –t
imaviartaa¦voq	V	–nngilaq
imaviarta¦q	N	–p, –t
imavi¦k	N	–up, –it
imeerukkallanngilaq	V	(no generation)
imeerunnaveersaa¦rpoq	V	–nngilaq
imeeru¦ppoq	V	–tinngilaq
imeerutissaa¦rpoq	V	–nngilaq
imeerut¦issaarpoq	V	{–issaanngilaq, –sissaanngilaq}
imeq	N	{ermup, erngup, ernup}, {ermit, ernit}
imeqarfi¦k	N	–up, –it
imeqarfilia¦q	N	–p, –t
imeqqutaal¦aq	N	–lap, –lat
imeqquta¦k	N	–ap, –at
imeqqutammi¦ppaa	V	–nngilaa
im¦erajunneq	N	{–erajunnerup, –ikkajunnerup}, {–erajunnerit, –ikkajunnerit}
imerajuppallaaqaaq	V	(no generation)
imerajuppallaarpoq	V	(no generation)
imerajuppoq	V	(no generation)
imerajussi¦voq	V	–nngilaq
im¦erajuttoq	N	{–erajuttup, –ikkajuttup}, {–erajuttut, –ikkajuttut}
im¦erajuttuuneq	N	{–erajuttuunerup, –ikkajuttuunerup}, {–erajuttuunerit, –ikkajuttuunerit}
imeratsi¦ppoq	V	–nngilaq
imerfi¦k	N	–up, –it
imeriili¦ppoq	V	–nngilaq
imeri¦ppoq	V	–nngilaq
imerissi¦voq	V	–nngilaq
imeri¦ssormiu	N	{–ssormiup, –ttormiup}, {–ssormiut, –ttormiut}
imerissorsuu¦voq	V	–nngilaq
imeri¦ssorsuuvoq	V	{–ssorsuaanngilaq, –ssorsuunngilaq, –ttorsuaanngilaq, –ttorsuunngilaq}
imeri¦ssut	N, pl.	{–ssut, –ttut}
imerlaarsi¦voq	V	–nngilaq
imermiorna¦q	N	–p, –t
imermiu	N	–p, –t
imermiutarsu¦aq	N	–up, –it
imernaalaa¦rpoq	V	–nngilaq
imernaalaartuinnaa¦voq	V	–nngilaq
imernaalane¦q	N	–rup, –rit
imernaala¦voq	V	–nngilaq
imernaalla¦ppoq	V	–nngilaq
imernaveersaarne¦q	N	–rup, –rit
imerne¦q	N	–rup, –rit
imerngaalaa¦rpoq	V	–nngilaq
imerngaalaartuinnaa¦voq	V	–nngilaq
imerngaala¦voq	V	–nngilaq
imerngaalla¦ppoq	V	–nngilaq
imerniartarfee¦raq	N	–qqap, –qqat
imerniartarf¦eeraq	N	{–eeqqap, –iaqqap}, {–eeqqat, –iaqqat}
imerniartarfi¦k	N	–up, –it
imerniartarfipala¦aq	N	{–ap, –up}, {–at, –it}
imerniartarfiutil¦ik	N	{–iup, –lip, –lup}, –lit
imerniinnaraluarpoq	V	(no generation)
imerniinna¦rpoq	V	–nngilaq
imer¦orpoq	V	–unngilaq
im¦erpaa	V	–inngilaa
imerpalaa¦rpoq	V	–nngilaq
imerpalas¦ooq	N	–uup, –uut
imerpala¦sooq	N	{–suup, –tuup}, {–suut, –tuut}
imerpalas¦oq	N	–up, –ut
imerpala¦voq	V	–nngilaq
imerpallaarne¦q	N	–rup, –rit
imerpallaa¦rpoq	V	–nngilaq
imerpallaartaqaaq	V	(no generation)
imerpalla¦ppoq	V	–nngilaq
im¦erpallappoq	V	{–erpallanngilaq, –ipallanngilaq}
imerpallassa¦rpaa	V	–nngilaa
im¦erpoq	V	–inngilaq
imersimane¦q	N	–rup, –rit
imersimas¦oq	N	–up, –ut
imersi¦orpoq	V	–unngilaq
imersi¦voq	V	–nngilaq
imersunni¦ppoq	V	–nngilaq
imertaa¦ppaa	V	–tinngilaa
imertaas¦erpoq	V	–inngilaq
imertaa¦serpoq	V	{–sinngilaq, –tilinngilaq}
imer¦taaserpoq	V	{–saasinngilaq, –saatilinngilaq, –taasinngilaq, –taatilinngilaq}
imertaassu¦aq	N	–up, –it
imer¦taassuaq	N	{–saassuup, –taassuup}, {–saassuit, –taassuit}
imertaat	N	–ip, –it
imertaat	N, pl.	-
imer¦taat	N	{–saatip, –taatip}, {–saatit, –taatit}
imertaatig¦aa	V	–inngilaa
imer¦taatigaa	V	{–saatiginngilaa, –taatiginngilaa}
imertarajuppoq	V	(no generation)
imertarfee¦raq	N	–qqap, –qqat
imertarf¦eeraq	N	{–eeqqap, –iaqqap}, {–eeqqat, –iaqqat}
imertarfi¦k	N	–up, –it
imertarfinnaa¦q	N	–p, –t
imertarne¦q	N	–rup, –rit
imertarnia¦rpoq	V	–nngilaq
imerta¦rpoq	V	–nngilaq
imer¦tarpoq	V	{–sanngilaq, –tanngilaq}
imertartart¦oq	N	–up, –ut
imerteri¦voq	V	–nngilaq
imert¦erpaa	V	–inngilaa
imerterussu¦aq	N	–up, –it
imerterut	N	–ip, –it
imeruersaat	N	–ip, –it
imeruer¦saat	N	{–saatip, –taatip}, {–saatit, –taatit}
imeruersaatissat	N, pl.	-
imeruer¦saatissat	N, pl.	{–saatissat, –taatissat}
imerukkunnaa¦rpoq	V	–nngilaq
imerumannginnguatsiaraluarpoq	V	(no generation)
imeru¦ppoq	V	–tinngilaq
imerusuersa¦rpaa	V	–nngilaa
imerusuersa¦rpoq	V	–nngilaq
imerusunne¦q	N	–rup, –rit
imerusu¦ppoq	V	–nngilaq
imeruu¦ppaa	V	–tinngilaa
imiane¦q	N	–rup, –rit
imiar¦aa	V	–inngilaa
imia¦voq	V	–nngilaq
imigaa¦voq	V	–nngilaq
imigassaajunnaa¦rpoq	V	–nngilaq
imigassa¦q	N	–p, –t
imigassarsi¦voq	V	–nngilaq
imigassartal¦ik	N	{–iup, –lip, –lup}, –lit
imigassar¦toqqusaajunnaarpoq	V	{–toqqusaajunnaanngilaq, –soqqusaajunnaanngilaq}
imigassar¦toqqusaajunnaarsitaaneq	N	{–toqqusaajunnaarsitaanerup, –toqqusaajunnaartitaanerup, –soqqusaajunnaarsitaanerup, –soqqusaajunnaartitaanerup}, {–toqqusaajunnaarsitaanerit, –toqqusaajunnaartitaanerit, –soqqusaajunnaarsitaanerit, –soqqusaajunnaartitaanerit}
imigassar¦toriaaseq	N	{–toriaatsip, –soriaatsip}, {–toriaatsit, –soriaatsit}
imigassar¦torpoq	V	{–sunngilaq, –tunngilaq}
imigassar¦tortitseqqusaannginneq	N	{–sortitseqqusaannginnerup, –tortitseqqusaannginnerup}, {–sortitseqqusaannginnerit, –tortitseqqusaannginnerit}
imigassar¦tortitsineq	N	{–sortitsinerup, –tortitsinerup}, {–sortitsinerit, –tortitsinerit}
imigu¦aq	N	–ssap, –ssat
imiilatsinaqaaq	V	(no generation)
imiilatsi¦voq	V	–nngilaq
imiinnaa¦voq	V	–nngilaq
imiinnali¦orpoq	V	–unngilaq
imiinna¦q	N	–ap, –at
imii¦ppoq	V	–nngilaq
imiisa¦ppoq	V	–nngilaq
imiisivi¦k	N	–up, –it
imiisivissa¦q	N	–p, –t
imiisivissu¦aq	N	–up, –it
imiisivittaa¦rpoq	V	–nngilaq
imiisorfi¦k	N	–up, –it
imiis¦orpoq	V	–unngilaq
imiisortaanna¦rpoq	V	–nngilaq
imik¦oq	N	–up, –ut
imileris¦oq	N	–up, –ut
imilia¦q	N	–p, –t
imili¦orpoq	V	–unngilaq
imillunne¦q	N	–rup, –rit
imillu¦ppoq	V	–nngilaq
imilluttaasi¦orpoq	V	–unngilaq
imilluttaa¦siorpoq	V	{–siunngilaq, –tiliunngilaq}
imilluttaat	N	–ip, –it
iminnaa¦ppoq	V	–nngilaq
iminnaqaaq	V	(no generation)
iminnarne¦q	N	–rup, –rit
iminna¦rpoq	V	–nngilaq
iminnarunnaa¦rpoq	V	–nngilaq
iminne¦q	N	–rup, –rit
iminngernaveersaarpoq	V	(no generation)
iminngernaveersaartitsine¦q	N	–rup, –rit
iminngernaveersaart¦oq	N	–up, –ut
iminng¦erpoq	V	–inngilaq
iminnger¦soq	N	{–sup, –tup}, {–sut, –tut}
iminngersorsuu¦voq	V	–nngilaq
iminnger¦sorsuuvoq	V	{–sorsuaanngilaq, –sorsuunngilaq, –torsuaanngilaq, –torsuunngilaq}
iminngersuunngilaq	V	(no generation)
imi¦ppaa	V	–nngilaa
imi¦ppoq	V	–nngilaq
imissaaru¦ppoq	V	–tinngilaq
imi¦ssaat	N	{–ssaatip, –ttaatip}, {–ssaatit, –ttaatit}
imissamaasivi¦k	N	–up, –it
imissa¦q	N	–p, –t
imissaqarfi¦k	N	–up, –it
imissa¦rpaa	V	–nngilaa
imissiart¦orpoq	V	–unngilaq
imissi¦voq	V	–nngilaq
imissut	N	–ip, –it
imi¦ssut	N, pl.	{–ssut, –ttut}
imissutaa¦voq	V	–nngilaq
imissutig¦aa	V	–inngilaa
imiti¦ppoq	V	–nngilaq
imitsi¦ppaa	V	–nngilaa
imi¦tsippaa	V	{–ssinngilaa, –tsinngilaa}
imitsittart¦oq	N	–up, –ut
imi¦tsittartoq	N	{–ssittartup, –tsittartup, –tsissartup}, {–ssittartut, –tsittartut, –tsissartut}
imi¦ttoq	N	{–ssup, –ttup}, {–ssut, –ttut}
imiusivi¦k	N	–up, –it
imi¦usivik	N	{–pusiviup, –usiviup}, {–pusiviit, –usiviit}
im¦iusivik	N	{–erusiviup, –iusiviup}, {–erusiviit, –iusiviit}
imiut	N	–ip, –it
imiutaaru¦ppoq	V	–tinngilaq
imma	Interj	(no generation)
immaa¦ppaa	V	–tinngilaa
immaa¦rpoq	V	–nngilaq
immaa¦voq	V	–nngilaq
immakanneq	Interj	(no generation)
immanne¦q	N	–rup, –rit
immannguaanna¦q	N	–ap, –at
immannguaq	Interj	(no generation)
imma¦ppoq	V	–nngilaq
immaqaarna¦rpoq	V	–nngilaq
immaqaa¦rpoq	V	–nngilaq
immaralaannguaq	Interj	(no generation)
immaralaarsuaq	Interj	(no generation)
immats¦erpoq	V	–inngilaq
immatsiaq	Interj	(no generation)
immatta¦rpoq	V	–nngilaq
immattoorne¦q	N	–rup, –rit
im¦mattoorneq	N	{–attoornerup, –mattoornerup}, {–attoornerit, –mattoornerit}
immatt¦oorpoq	V	–uunngilaq
im¦mattoorpoq	V	{–attuunngilaq, –mattuunngilaq}
immeqqaajunnaa¦rpoq	V	–nngilaq
immeqqaasa¦rpoq	V	–nngilaq
immeqqaa¦voq	V	–nngilaq
immeraanne¦q	N	–rup, –rit
immeraa¦ppoq	V	–tinngilaq
immeraat	N	–ip, –it
immeraataa¦voq	V	–nngilaq
immeraatig¦aa	V	–inngilaa
immera¦rpaa	V	–nngilaa
immera¦rpoq	V	–nngilaq
immerarteqattaa¦rpoq	V	–nngilaq
immerartikkunnaa¦rpoq	V	–nngilaq
immerarti¦ppoq	V	–nngilaq
immerisaanna¦rpoq	V	–nngilaq
immeri¦voq	V	–nngilaq
immerne¦q	N	–rup, –rit
imm¦erpaa	V	–inngilaa
imm¦erpoq	V	–inngilaq
immersa¦gaq	N	–kkap, –kkat
immersart¦oq	N	–up, –ut
immers¦orpaa	V	–unngilaa
immersorpoq	V	(no generation)
immersugassa¦q	N	–p, –t
immersui¦voq	V	–nngilaq
immertaa¦rpoq	V	–nngilaq
immerti¦ppaa	V	–nngilaa
immertussaa¦voq	V	–nngilaq
immer¦tussaavoq	V	{–sussaanngilaq, –tussaanngilaq}
immiaarall¦erpoq	V	–inngilaq
immiaa¦raq	N	–qqap, –qqat
immiaararsi¦voq	V	–nngilaq
immialaat	N, pl.	-
immia¦q	N	–p, –t
immiar¦aa	V	–inngilaa
immiarsia¦q	N	–p, –t
immiarsiar¦aa	V	–inngilaa
immiarsi¦voq	V	–nngilaq
immiarsunni¦ppoq	V	–nngilaq
immiar¦torfik	N	{–sorfiup, –torfiup}, {–sorfiit, –torfiit}
immiassat	N, pl.	-
immigaallua¦rpoq	V	–nngilaq
immigaa¦voq	V	–nngilaq
immi¦gaq	N	–kkap, –kkat
immigia¦q	N	–p, –t
immigia¦rpoq	V	–nngilaq
immiisissaaru¦ppoq	V	–tinngilaq
immiisissa¦q	N	–p, –t
immiisissarsi¦voq	V	–nngilaq
immii¦t	N	–sip, –sit
immii¦voq	V	–nngilaq
immi¦ivoq	V	{–inngilaq, –tsinngilaq}
immikki¦orpoq	V	–unngilaq
immikkiortaanna¦rpoq	V	–nngilaq
immikk¦oorpoq	V	–uunngilaq
immikkoorti¦ppaa	V	–nngilaa
immikkoortitaagallarne¦q	N	–rup, –rit
immikkoortitaane¦q	N	–rup, –rit
immikkoortita¦q	N	–p, –t
immikkoortitat	N, pl.	-
immikkoortitsine¦q	N	–rup, –rit
immikkoortitsi¦voq	V	–nngilaq
immikkoort¦oq	N	–up, –ut
immikkoortoqarfi¦k	N	–up, –it
immikkoortortal¦ik	N	{–iup, –lip, –lup}, –lit
immikkoortorta¦q	N	–p, –t
immikkoortortaqarfi¦k	N	–up, –it
immikkoortuu¦voq	V	–nngilaq
immikkoorut	N	–ip, –it
immikkooruteqarne¦q	N	–rup, –rit
immikkuualutt¦oq	N	–up, –ut
immikkuullarilluinnart¦oq	N	–up, –ut
immikkuullari¦ssoq	N	{–ssup, –ttup}, {–ssut, –ttut}
immikkuussu¦seq	N	–tsip, –tsit
immilitseri¦voq	V	–nngilaq
immilits¦erpaa	V	–inngilaa
immineernia¦rpoq	V	–nngilaq
immin¦eerniarpoq	V	{–eernianngilaq, –ermeernianngilaq, –erminngaanneernianngilaq, –inngaanneernianngilaq}
immin¦eerpoq	V	{–ermiinngilaq, –erminngaanniinngilaq, –iinngilaq, –inngaanniinngilaq}
immin¦eerpoq	V	–iinngilaq
immineersi¦ppaa	V	–nngilaa
immin¦eersippaa	V	{–eersinngilaa, –ermeersinngilaa, –erminngaanneersinngilaa, –inngaanneersinngilaa}
immineers¦orpoq	V	–unngilaq
immineertaanna¦rpoq	V	–nngilaq
imminiiginna¦rpaa	V	–nngilaa
imminiik	Interj	(no generation)
imminnguaa¦raq	N	–qqap, –qqat
imminngu¦aq	N	–up, –it
imminoqqajaas¦oq	N	–up, –ut
imminoriaraluarne¦q	N	–rup, –rit
imminorne¦q	N	–rup, –rit
immin¦orpoq	V	–unngilaq
imminorsimas¦oq	N	–up, –ut
imminort¦oq	N	–up, –ut
immiorajuppoq	V	(no generation)
immiorfi¦k	N	–up, –it
immiorne¦q	N	–rup, –rit
immi¦orpoq	V	–unngilaq
immiortitsi¦voq	V	–nngilaq
immiort¦oq	N	–up, –ut
immi¦ppaa	V	–nngilaa
immi¦ppoq	V	–nngilaq
immisi¦ppaa	V	–nngilaa
immis¦oorpoq	V	–uunngilaq
immi¦soorpoq	V	{–nertuunngilaq, –suunngilaq}
immitseri¦voq	V	–nngilaq
immits¦erpaa	V	–inngilaa
immitsisaanna¦rpoq	V	–nngilaq
immitsiuippoq	V	(no generation)
immi¦tsivoq	V	{–inngilaq, –tsinngilaq}
immiugassat	N, pl.	-
immiunneqart¦oq	N	–up, –ut
immiu¦ppaa	V	–tinngilaa
immiussaa¦voq	V	–nngilaq
immiussa¦q	N	–p, –t
immiussine¦q	N	–rup, –rit
immiussissut	N	–ip, –it
immiussi¦vik	N	{–ffiup, –viup}, {–ffiit, –viit}
immiussi¦voq	V	–nngilaq
immoqanngits¦oq	N	–up, –ut
immoqqui¦k	N	–up, –it
immoqqu¦serpaa	V	{–sinngilaa, –tilinngilaa}
immoqqu¦sersorpaa	V	{–sersunngilaa, –tilersunngilaa}
immoqqut	N	–ip, –it
immuattal¦ik	N	{–iup, –lip, –lup}, –lit
immuerulluinna¦rpoq	V	–nngilaq
immuerullu¦innarpoq	V	{–innanngilaq, –aannanngilaq}
immueru¦ppoq	V	–tinngilaq
immuerutivi¦ppoq	V	–nngilaq
immugi¦ppoq	V	–nngilaq
immugissi¦voq	V	–nngilaq
immuiaasuu¦voq	V	–nngilaq
immuiaat	N	–ip, –it
immuiaa¦voq	V	–nngilaq
immuia¦rpaa	V	–nngilaa
immuisorfi¦k	N	–up, –it
immuis¦orpoq	V	–unngilaq
immuisortitsi¦voq	V	–nngilaq
immuit-panertut	N, pl.	-
immujora¦k	N	–ap, –at
immu¦k	N	–up, –it
immulerta¦rpoq	V	–nngilaq
immuler¦tarpoq	V	{–sanngilaq, –tanngilaq}
immuliorfi¦k	N	–up, –it
immulivi¦k	N	–up, –it
immulla¦rpoq	V	–nngilaq
immull¦erpoq	V	–inngilaq
immullu¦k	N	–up, –it
immulluu¦voq	V	–nngilaq
immuma¦voq	V	–nngilaq
immunikkiart¦orpoq	V	–unngilaq
immuni¦ppoq	V	–nngilaq
immu¦ppaa	V	–tinngilaa
immu¦ppoq	V	–tinngilaq
immu¦serpaa	V	{–sinngilaa, –tilinngilaa}
immu¦serpaa	V	–tilinngilaa
immu¦sersorpaa	V	{–sersunngilaa, –tilersunngilaa}
immussaajaa¦voq	V	–nngilaq
immussaaja¦rpaa	V	–nngilaa
immussaa¦rpaa	V	–nngilaa
immussaa¦voq	V	–nngilaq
immussi¦voq	V	–nngilaq
immussu¦aq	N	–up, –it
immut	N	–ip, –it
immutt¦orpoq	V	–unngilaq
immuttuut	N	–ip, –it
immuttuut	N, pl.	-
immuusivi¦k	N	–up, –it
im¦oorpoq	V	–uunngilaq
imoortiterpaa	V	(no generation)
imoortuinnaa¦voq	V	–nngilaq
imoqqavoq	V	(no generation)
imu¦aa	V	–nngilaa
imujoraa¦rpoq	V	–nngilaq
imunasua¦rpaa	V	–nngilaa
imune¦q	N	–rup, –rit
imungaa¦rpoq	V	–nngilaq
imusaat	N	–ip, –it
imusaa¦voq	V	–nngilaq
imusa¦q	N	–p, –t
imusarne¦q	N	–rup, –rit
imusa¦rpaa	V	–nngilaa
imusi¦voq	V	–nngilaq
imu¦voq	V	–nngilaq
inaali¦ppaa	V	–nngilaa
inaali¦ppoq	V	–nngilaq
inaanii¦ppoq	V	–nngilaq
inaannaanii¦ppoq	V	–nngilaq
inaannaa¦voq	V	–nngilaq
inaanna¦q	N	–ap, –at
inaannar¦orpaa	V	–unngilaa
inaanna¦rpaa	V	–nngilaa
inaar¦ineq	N	{–inerup, –sinerup}, {–inerit, –sinerit}
inaar¦ivoq	V	{–inngilaq, –sinngilaq}
inaa¦rpaa	V	–nngilaa
inaarsaa¦vik	N	{–ffiup, –viup}, {–ffiit, –viit}
inaarsa¦rpaa	V	–nngilaa
inaar¦sivoq	V	{–inngilaq, –sinngilaq}
inaarutig¦aa	V	–inngilaa
inaasa¦rpoq	V	–nngilaq
inaasua¦voq	V	–nngilaq
inalu	N	–p, –t
inaluaa¦raq	N	–qqap, –qqat
inalual¦ik	N	{–iup, –lip, –lup}, –lit
inalualiusa¦q	N	–p, –t
inalu¦aq	N	–ssap, –ssat
inaluarna¦q	N	–p, –t
inalugaa¦raq	N	–qqap, –qqat
inalugaasa¦q	N	–p, –t
inalugaasat	N, pl.	-
inalugal¦ik	N	{–iup, –lip, –lup}, –lit
inalu¦gaq	N	–kkap, –kkat
inalugarsu¦aq	N	–up, –it
inalu¦k	N	–up, –it
inaluusa¦q	N	–p, –t
inaluusat	N, pl.	-
inang¦erpaa	V	–inngilaa
inangerti¦ppoq	V	–nngilaq
inanger¦tippoq	V	{–sinngilaq, –tinngilaq}
inangiis¦oq	N	–up, –ut
ina¦ppaa	V	–nngilaa
inassut	N	–ip, –it
inassutaa¦voq	V	–nngilaq
inassuteqaat	N	–ip, –it
inassuteqarne¦q	N	–rup, –rit
inassutig¦aa	V	–inngilaa
inassutigeqqi¦ppaa	V	–nngilaa
inatserii¦ppoq	V	–nngilaq
inatsillua¦rpoq	V	–nngilaq
inatsiniut	N	–ip, –it
inatsisaagallart¦oq	N	–up, –ut
inatsisaa¦ppoq	V	–nngilaq
inatsisaats¦oq	N	–up, –ut
inatsisaatsussu¦seq	N	–tsip, –tsit
inatsisaatsut	N, pl.	-
inatsisaatsuune¦q	N	–rup, –rit
inatsisaatsuussu¦seq	N	–tsip, –tsit
inatsisaa¦voq	V	–nngilaq
Inatsisartut	N, pl.	-
Inatsisartut	Prop, pl.	-
inatsisartut	N, pl.	-
inatsisig¦aa	V	–inngilaa
Inatsisileriffi¦k	N	–up, –it
inatsisilerine¦q	N	–rup, –rit
inatsisilerinikkut	N, pl.	-
inatsisilerit¦ooq	N	–uup, –uut
inatsisi¦liorneq	N	{–liornerup, –ornerup}, {–liornerit, –ornerit}
inatsisi¦liorpoq	V	{–liunngilaq, –unngilaq}
inatsisi¦liorsinnaasut	N, pl.	{–liorsinnaasut, –orsinnaasut}
inatsisi¦liorsinnaatitaaneq	N	{–liorsinnaatitaanerup, –orsinnaatitaanerup}, {–liorsinnaatitaanerit, –orsinnaatitaanerit}
inatsisi¦liorsinnaatitaasoq	N	{–liorsinnaatitaasup, –orsinnaatitaasup}, {–liorsinnaatitaasut, –orsinnaatitaasut}
inatsisi¦liortoq	N	{–liortup, –ortup}, {–liortut, –ortut}
inatsisi¦liortussaatitaaneq	N	{–liortussaatitaanerup, –ortussaatitaanerup}, {–liortussaatitaanerit, –ortussaatitaanerit}
inatsisi¦liortut	N, pl.	{–liortut, –ortut}
inatsisi¦liortuusoq	N	{–liortuusup, –ortuusup}, {–liortuusut, –ortuusut}
inatsisissa¦q	N	–p, –t
inatsisit	N, pl.	-
inatsisitaarfi¦k	N	–up, –it
inatsisitigoort¦oq	N	–up, –ut
inatsissutig¦aa	V	–inngilaa
inatsi¦t	N	–sip, –sit
inatsiumat¦ooq	N	–uup, –uut
inatsi¦voq	V	–nngilaq
Indonesiam¦eersoq	N	{–eersup, –eertup, –inngaanneersup, –inngaanneertup}, {–eersut, –eertut, –inngaanneersut, –inngaanneertut}
Indonesiamiu	N	–p, –t
in¦eeraq	N	{–eeqqap, –iaqqap}, {–eeqqat, –iaqqat}
ineqaraluanngilaq	V	(no generation)
ineqarfi¦k	N	–up, –it
ineqarne¦q	N	–rup, –rit
ineqa¦rpoq	V	–nngilaq
ineqart¦oq	N	–up, –ut
ineqartussanngortitsine¦q	N	–rup, –rit
ineqat	N	–ip, –it
ineqataa¦voq	V	–nngilaq
ineqatig¦aa	V	–inngilaa
ineqatigiinne¦q	N	–rup, –rit
inequg¦aa	V	–inngilaa
inequnaa¦ppoq	V	–nngilaq
inequnaats¦oq	N	–up, –ut
inequnaqaaq	V	(no generation)
inequnarpallaanngikkaluarpoq	V	(no generation)
inequnarpallaarnera¦rpaa	V	–nngilaa
inequna¦rpoq	V	–nngilaq
inequnart¦oq	N	–up, –ut
inequnavi¦ssoq	N	{–ssup, –ttup}, {–ssut, –ttut}
inequ¦ppaa	V	–tinngilaa
inequ¦ppoq	V	–tinngilaq
inequssuu¦ppaa	V	–tinngilaa
inequsu¦ppoq	V	–nngilaq
inequtsaa¦ppaa	V	–tinngilaa
inequtsaassi¦voq	V	–nngilaq
ineraa¦rpaa	V	–nngilaa
inerallassavaa	V	(no generation)
inera¦ppaa	V	–nngilaa
inera¦ppoq	V	–nngilaq
inera¦rpaa	V	–nngilaa
inera¦rpoq	V	–nngilaq
inerasua¦rpaa	V	–nngilaa
inereruttorne¦q	N	–rup, –rit
inererutt¦orpoq	V	–unngilaq
ineriaarpallaart¦oq	N	–up, –ut
ineriartoqqinne¦q	N	–rup, –rit
ineriartorfiusinnaas¦oq	N	–up, –ut
ineriartorluarpoq	V	(no generation)
ineriartorne¦q	N	–rup, –rit
ineriart¦orpoq	V	–unngilaq
ineriartorteqqi¦ppaa	V	–nngilaa
ineriartortinneqarnik¦oq	N	–up, –ut
ineriartorti¦ppaa	V	–nngilaa
ineriartortitsine¦q	N	–rup, –rit
ineriartortitsisart¦oq	N	–up, –ut
ineriartortitsis¦oq	N	–up, –ut
ineriartortitsi¦voq	V	–nngilaq
ineriartortitta¦rpaa	V	–nngilaa
inerikkiart¦orpoq	V	–unngilaq
inerinne¦q	N	–rup, –rit
ineri¦ppoq	V	–nngilaq
Inerisaavi¦k	N	{–iup, –up}, {–iit, –it}
Inerisaavi¦k	N	–up, –it
Inerisaavi¦k	Prop	–up, –it
inerisimassu¦seq	N	–tsip, –tsit
ineriti¦ppaa	V	–nngilaa
inerit¦ippaa	V	{–inngilaa, –sinngilaa}
inerititaaru¦ppoq	V	–tinngilaq
inerit¦itaaruppoq	V	{–itaarutinngilaq, –sitaarutinngilaq}
inerititaats¦oq	N	–up, –ut
ineritita¦q	N	–p, –t
inerit¦itaq	N	{–itap, –sitap}, {–itat, –sitat}
inerititaqarlua¦rpoq	V	–nngilaq
inerit¦itaqarluarpoq	V	{–itaqarluanngilaq, –sitaqarluanngilaq}
inerititaqarluart¦oq	N	–up, –ut
inerit¦itaqarluartoq	N	{–itaqarluartup, –sitaqarluartup}, {–itaqarluartut, –sitaqarluartut}
inerititaqarusussu¦seq	N	–tsip, –tsit
inerit¦itaqarusussuseq	N	{–itaqarusussutsip, –sitaqarusussutsip}, {–itaqarusussutsit, –sitaqarusussutsit}
inerititat	N, pl.	-
inerit¦itat	N, pl.	{–itat, –sitat}
ineritt¦oq	N	–up, –ut
inerittut	N, pl.	-
inerne¦q	N	–rup, –rit
inerneqanngits¦oq	N	–up, –ut
inernil¦erpaa	V	–inngilaa
inerniliine¦q	N	–rup, –rit
in¦erpaa	V	–inngilaa
in¦erpoq	V	–inngilaq
inersimal¦erpoq	V	–inngilaq
inersimanngits¦oq	N	–up, –ut
inersimas¦oq	N	–up, –ut
inersimasorpalaa¦rpoq	V	–nngilaq
inersimasunngulerne¦q	N	–rup, –rit
inersima¦voq	V	–nngilaq
inersu¦aq	N	–up, –it
inerteqqut	N	–ip, –it
inerteqqutaas¦oq	N	–up, –ut
inerteqqutaa¦voq	V	–nngilaq
inerteqquteqarne¦q	N	–rup, –rit
inerteqquteqa¦rpoq	V	–nngilaq
inerteqqutig¦aa	V	–inngilaa
inerteri¦voq	V	–nngilaq
inert¦erpaa	V	–inngilaa
inerterseria¦rpoq	V	–nngilaq
inerterserii¦ppoq	V	–nngilaq
inerterseriissu¦seq	N	–tsip, –tsit
inerterseriits¦oq	N	–up, –ut
inerterut	N	–ip, –it
inerterutig¦aa	V	–inngilaa
inertiterilluart¦oq	N	–up, –ut
inertuusaarne¦q	N	–rup, –rit
inertuusaa¦rpoq	V	–nngilaq
ingakkujoq	V	(no generation)
ingalannia¦rpaa	V	–nngilaa
ingala¦ppaa	V	–nngilaa
ingala¦ppoq	V	–nngilaq
ingalassaanngilaq	V	(no generation)
ingalas¦simaarfigaa	V	{–simaarfiginngilaa, –imaarfiginngilaa}
ingalassimati¦ppaa	V	–nngilaa
ingalassima¦vaa	V	–nngilaa
ingalats¦erpaa	V	–inngilaa
ingappallaaqaaq	V	(no generation)
inga¦ppoq	V	–nngilaq
ingasaa¦ppaa	V	–tinngilaa
ingasaassinaveersaarne¦q	N	–rup, –rit
ingasaassinaveersaa¦rpoq	V	–nngilaq
ingasaassine¦q	N	–rup, –rit
ingasaassinersu¦aq	N	–up, –it
ingasaassi¦voq	V	–nngilaq
ingasak	Interj	(no generation)
ingasaluatsia¦rpoq	V	–nngilaq
ingasa¦ppaa	V	–nngilaa
ingasa¦ppoq	V	–nngilaq
ingasattajaari¦voq	V	–nngilaq
ingasattajaarpallaart¦oq	N	–up, –ut
ingasattajaa¦rpoq	V	–nngilaq
ingasatt¦oq	N	–up, –ut
ingatsi¦ppaa	V	–nngilaa
ingatsi¦ppoq	V	–nngilaq
ingattaa¦ppaa	V	–tinngilaa
ingattaassine¦q	N	–rup, –rit
ingatta¦rpoq	V	–nngilaq
ingattarsert¦oq	N	–up, –ut
ingattarser¦toq	N	{–sup, –tup}, {–sut, –tut}
ingatt¦oq	N	–up, –ut
ing¦eerpoq	V	–iinngilaq
ingeersa¦rpaa	V	–nngilaa
ingeersa¦rpoq	V	–nngilaq
ing¦eq	N	–ip, –it
ingeqqu¦aa	V	–nngilaa
ingerlaanna¦q	N	–ap, –at
ingerlaanna¦q	N	–p, –t
ingerlaannarallassaaq	V	(no generation)
ingerlaanna¦rpoq	V	–nngilaq
ingerlaannart¦oq	N	–up, –ut
ingerlaa¦q	N	–p, –t
ingerlaaqatigiinne¦q	N	–rup, –rit
ingerlaaqatigiit	N, pl.	-
ingerlaarfig¦aa	V	–inngilaa
ingerlaarne¦q	N	–rup, –rit
ingerlaarnissa¦q	N	–p, –t
ingerlaa¦rpoq	V	–nngilaq
ingerlaartitsine¦q	N	–rup, –rit
ingerlaa¦seq	N	–tsip, –tsit
ingerlaavart¦oq	N	–up, –ut
ingerla¦avartoq	N	{–avartup, –juartup, –tuartup}, {–avartut, –juartut, –tuartut}
ingerlaffigisassa¦q	N	–p, –t
ingerlagallarnaviarunanngilaq	V	(no generation)
ingerlajaaqqunavianngilaa	V	(no generation)
ingerlajaaqqusimagaluarpaa	V	(no generation)
ingerlajaaqqusimavaa	V	(no generation)
ingerlajaarsimavoq	V	(no generation)
ingerlajaartariaqanngilaq	V	(no generation)
ingerlajaartariaqa¦rpoq	V	–nngilaq
ingerlajaarta¦rpoq	V	–nngilaq
ingerlajaassa¦aq	V	–nngilaq
ingerlajumajunnaarniarpoq	V	(no generation)
ingerlajumanngikkaluarpoq	V	(no generation)
ingerlakkunnaa¦rpaa	V	–nngilaa
ingerlalaarallarpoq	V	(no generation)
ingerlaleqqaarpoq	V	(no generation)
ingerlallua¦rpoq	V	–nngilaq
ingerlalluart¦oq	N	–up, –ut
ingerlane¦q	N	–rup, –rit
ingerlanerliulerpoq	V	(no generation)
ingerlaniataa¦rpoq	V	–nngilaq
ingerlaniu¦ppaa	V	–tinngilaa
ingerlanneqarne¦q	N	–rup, –rit
ingerlanngilaq	V	(no generation)
ingerla¦ppaa	V	–tinngilaa
ingerlaqat	N	–ip, –it
ingerlaqatig¦aa	V	–inngilaa
ingerlaqatigiit	N, pl.	-
ingerlaqqinne¦q	N	–rup, –rit
ingerlariaqqinngitsoortut	N, pl.	-
ingerlars¦orpoq	V	–unngilaq
ingerlarujutaa¦rpoq	V	–nngilaq
ingerlarusaa¦rpoq	V	–nngilaq
ingerlarusunnerugalua¦rpoq	V	–nngilaq
ingerlasaa¦rpaa	V	–nngilaa
ingerlasaarut	N	–ip, –it
ingerlasariaqalersima¦voq	V	–nngilaq
ingerlasimane¦q	N	–rup, –rit
ingerlasinnaane¦q	N	–rup, –rit
ingerlassaqarfi¦k	N	–up, –it
ingerlassine¦q	N	–rup, –rit
ingerla¦ssivik	N	{–ssiffiup, –ssiviup, –tsiviup}, {–ssiffiit, –ssiviit, –tsiviit}
ingerlassi¦voq	V	–nngilaq
ingerlassutiss¦aliorfik	N	{–aliorfiup, –iorfiup}, {–aliorfiit, –iorfiit}
ingerlata¦q	N	–p, –t
ingerlataqarfi¦k	N	–up, –it
ingerlataqart¦oq	N	–up, –ut
ingerlateqqilerpaa	V	(no generation)
ingerlateqqi¦ppaa	V	–nngilaa
ingerlateqqi¦tassanngortippaa	V	{–sassanngortinngilaa, –tassanngortinngilaa}
ingerlateqqi¦tassanngortitsineq	N	{–sassanngortitsinerup, –tassanngortitsinerup}, {–sassanngortitsinerit, –tassanngortitsinerit}
ingerlatiinna¦rpaa	V	–nngilaa
ingerlatitseqqilerne¦q	N	–rup, –rit
ingerlatitseqqinne¦q	N	–rup, –rit
ingerlatitsine¦q	N	–rup, –rit
ingerlatitsis¦oq	N	–up, –ut
ingerlatseqatigiiffi¦k	N	–up, –it
ingerla¦tseqatigiiffik	N	{–teqatigiiffiup, –titeqatigiiffiup, –tseqatigiiffiup, –sseqatigiiffiup}, {–teqatigiiffiit, –titeqatigiiffiit, –tseqatigiiffiit, –sseqatigiiffiit}
ingerlatseqatigiiffissu¦aq	N	–up, –it
ingerla¦tseqatigiiffissuaq	N	{–teqatigiiffissuup, –titeqatigiiffissuup, –tseqatigiiffissuup, –sseqatigiiffissuup}, {–teqatigiiffissuit, –titeqatigiiffissuit, –tseqatigiiffissuit, –sseqatigiiffissuit}
ingerlatseqatigiiffiutigisa¦q	N	–p, –t
ingerla¦tseqatigiiffiutigisaq	N	{–teqatigiiffiutigisap, –titeqatigiiffiutigisap, –tseqatigiiffiutigisap, –sseqatigiiffiutigisap}, {–teqatigiiffiutigisat, –titeqatigiiffiutigisat, –tseqatigiiffiutigisat, –sseqatigiiffiutigisat}
ingerla¦tseqatigiit	N, pl.	{–teqatigiit, –titeqatigiit, –tseqatigiit, –sseqatigiit}
ingerla¦tseriaaseq	N	{–titeriaatsip, –tseriaatsip, –sseriaatsip}, {–titeriaatsit, –tseriaatsit, –sseriaatsit}
ingerlatsilerne¦q	N	–rup, –rit
ingerla¦tsilerneq	N	{–tilernerup, –tsilernerup, –ssilernerup}, {–tilernerit, –tsilernerit, –ssilernerit}
ingerla¦tsineq	N	{–ssinerup, –tsinerup}, {–ssinerit, –tsinerit}
ingerla¦tsisoq	N	{–ssisup, –tsisup}, {–ssisut, –tsisut}
ingerla¦tsisoqarfik	N	{–ssisoqarfiup, –tsisoqarfiup}, {–ssisoqarfiit, –tsisoqarfiit}
ingerla¦tsisoqarneq	N	{–ssisoqarnerup, –tsisoqarnerup}, {–ssisoqarnerit, –tsisoqarnerit}
ingerla¦tsisut	N, pl.	{–ssisut, –tsisut}
ingerlatsiuarpoq	V	(no generation)
ingerla¦tsiveqarfik	N	{–ssiffeqarfiup, –tsiveqarfiup}, {–ssiffeqarfiit, –tsiveqarfiit}
ingerla¦tsivik	N	{–ssiffiup, –tsiviup}, {–ssiffiit, –tsiviit}
ingerla¦tsivoq	V	{–ssinngilaq, –tsinngilaq}
ingerla¦vaa	V	–nngilaa
ingerlavi¦k	N	–up, –it
ingerla¦voq	V	–nngilaq
ingerlu¦ppoq	V	–nngilaq
ingermi¦ppoq	V	–nngilaq
ingers¦ooq	N	–uup, –uut
ingi	N	–p, –t
ingiaania¦rpoq	V	–nngilaq
ingiall¦orpaa	V	–unngilaa
ingiallortar¦aa	V	–inngilaa
ingiallortig¦aa	V	–inngilaa
ingialluine¦q	N	–rup, –rit
ingialluu¦ppoq	V	–tinngilaq
ingiaqasiu¦ppaa	V	–tinngilaa
ingiaqa¦siuppaa	V	{–siutinngilaa, –tiliutinngilaa}
ingiaqat	N	–ip, –it
ingiaqataa¦voq	V	–nngilaq
ingiaqatig¦aa	V	–inngilaa
ingiarniussis¦oq	N	–up, –ut
ingia¦rpaa	V	–nngilaa
ingiarsaar¦aa	V	–inngilaa
ingiffig¦aa	V	–inngilaa
ingiffi¦k	N	–up, –it
ingiffissaaru¦ppoq	V	–tinngilaq
ingiffissa¦q	N	–p, –t
ingikkiartoqqaarallarpoq	V	(no generation)
ingikkiartoqqaarumagaluarpoq	V	(no generation)
ingikkiartoqqinniarpoq	V	(no generation)
ingikkiartoqqippoq	V	(no generation)
ingikkiartoqqissimagaluarpoq	V	(no generation)
ingikkiartoqqissimavoq	V	(no generation)
ingikkiartoqqu¦aa	V	–nngilaa
ingikkiartorusaaginnarpoq	V	(no generation)
ingikkiartorusaarpoq	V	(no generation)
ingikkiartussanngilaq	V	(no generation)
ingimi¦ppaa	V	–nngilaa
ingimi¦ppoq	V	–nngilaq
ingimitsi¦ppaa	V	–nngilaa
ingimi¦tsippaa	V	{–ssinngilaa, –tsinngilaa}
ingimitt¦oorpoq	V	–uunngilaq
ingimi¦ttoorpoq	V	{–ssuunngilaq, –ttuunngilaq}
ingiorlua¦rpaa	V	–nngilaa
ingi¦orpaa	V	–unngilaa
ingiortaa¦voq	V	–nngilaq
ingi¦ppoq	V	–nngilaq
ingiti¦ppaa	V	–nngilaa
ingi¦tippaa	V	{–sinngilaa, –tinngilaa, –tsinngilaa}
ingitserine¦q	N	–rup, –rit
ingits¦erpaa	V	–inngilaa
ingits¦erpoq	V	–inngilaq
ingitsertuinnaa¦voq	V	–nngilaq
ingitser¦tuinnaavoq	V	{–suinnaanngilaq, –tuinnaanngilaq}
ingitsigaa¦voq	V	–nngilaq
ingitsi¦gaq	N	–kkap, –kkat
ingitsigassa¦q	N	–p, –t
ingitsilajunnaa¦rpoq	V	–nngilaq
ingitsilane¦q	N	–rup, –rit
ingitsilas¦oq	N	–up, –ut
ingitsila¦voq	V	–nngilaq
ingittariaqalersinnaa¦voq	V	–nngilaq
ingittariaqa¦rpoq	V	–nngilaq
ingiuleeru¦ppoq	V	–tinngilaq
ingiuleerutivi¦ppoq	V	–nngilaq
ingiuligaa¦rpoq	V	–nngilaq
ingiul¦ik	N	{–iup, –lip, –lup}, –lit
ingiuli¦ppoq	V	–nngilaq
ingiulissi¦orpoq	V	–unngilaq
ingiuliss¦iorpoq	V	{–iunngilaq, –aliunngilaq}
ingiulissu¦aq	N	–up, –it
ingiul¦issuaq	N	{–ersuup, –issuup}, {–ersuit, –issuit}
ingiulittorsuu¦voq	V	–nngilaq
ingiulittorsu¦uvoq	V	{–aanngilaq, –unngilaq}
ingiuli¦ttorsuuvoq	V	{–ssorsuaanngilaq, –ssorsuunngilaq, –ttorsuaanngilaq, –ttorsuunngilaq}
ingiullerajuppoq	V	(no generation)
ingiullerajussi¦voq	V	–nngilaq
ingiull¦erpoq	V	–inngilaq
ingiullersorsuu¦voq	V	–nngilaq
ingiuller¦sorsuuvoq	V	{–sorsuaanngilaq, –sorsuunngilaq, –torsuaanngilaq, –torsuunngilaq}
ingivi¦ppoq	V	–nngilaq
ingo¦raq	N	–qqap, –qqat
ingor¦eq	N	–ip, –it
inguffig¦aa	V	–inngilaa
ingumi¦ppaa	V	–nngilaa
ingumippoq	V	(no generation)
ingune¦q	N	–rup, –rit
ingunerit	N, pl.	-
ingu¦ppaa	V	–nngilaa
ingus¦oorpoq	V	–uunngilaq
ingussi¦ppaa	V	–nngilaa
ingussora¦rpoq	V	–nngilaq
inguss¦orpoq	V	–unngilaq
inguts¦erpaa	V	–inngilaa
inguts¦erpoq	V	–inngilaq
ingutsi¦gaq	N	–kkap, –kkat
ingut¦sigaq	N	{–ikkap, –sikkap}, {–ikkat, –sikkat}
ingutsilas¦oq	N	–up, –ut
ingutsila¦voq	V	–nngilaq
ingutsine¦q	N	–rup, –rit
ingutsis¦oq	N	–up, –ut
ingutsi¦voq	V	–nngilaq
ingu¦voq	V	–nngilaq
ini	N	–p, –t
inigaqartart¦oq	N	–up, –ut
inigineqarsinnaas¦oq	N	–up, –ut
inigineqart¦oq	N	–up, –ut
inigisa¦q	N	–p, –t
inikilli¦orpoq	V	–unngilaq
inikillisi¦ppaa	V	–nngilaa
inikilli¦sippaa	V	{–sinngilaa, –tinngilaa}
inikilli¦voq	V	–nngilaq
iniki¦ppoq	V	–nngilaq
inikitsuu¦voq	V	–nngilaq
inikkumina¦rpoq	V	–nngilaq
iniler¦soq	N	{–sup, –tup}, {–sut, –tut}
inilia¦q	N	–p, –t
inil¦ik	N	{–iup, –lip, –lup}, –lit
inili¦orpoq	V	–unngilaq
inili¦ppoq	V	–nngilaq
inilissi¦voq	V	–nngilaq
inilukkunnaa¦rpoq	V	–nngilaq
inilulluinna¦rpoq	V	–nngilaq
inilu¦ppoq	V	–nngilaq
inilussi¦voq	V	–nngilaq
inimiut¦aq	N	{–ap, –tap}, {–at, –tat}
ininnguaat	N	–ip, –it
inioqqaagajuppoq	V	(no generation)
inioqqaasaanna¦rpoq	V	–nngilaq
inioqqaavi¦k	N	–up, –it
inioqqaa¦vik	N	{–ffiup, –viup}, {–ffiit, –viit}
inioqqaa¦voq	V	–nngilaq
inioqqa¦serpaa	V	{–sinngilaa, –tilinngilaa}
inioqqa¦sersorpaa	V	{–sersunngilaa, –tilersunngilaa}
inioqqat	N	–ip, –it
inioqqavi¦k	N	–up, –it
inioraavi¦k	N	–up, –it
inipalaarpoq	V	(no generation)
inisimaffi¦k	N	–up, –it
inisimas¦oq	N	–up, –ut
inisimasor¦aa	V	–inngilaa
inisimmaveeru¦ppoq	V	–tinngilaq
inisimmavigisa¦q	N	–p, –t
inisimmavi¦k	N	–up, –it
inisimmaviki¦ppoq	V	–nngilaq
inisimmavissaaru¦ppoq	V	–tinngilaq
inisivi¦k	N	–up, –it
inisi¦voq	V	–nngilaq
inissaaleqine¦q	N	–rup, –rit
inissaa¦leqineq	N	{–leqinerup, –rleqinerup}, {–leqinerit, –rleqinerit}
inissaaleqis¦oq	N	–up, –ut
inissaa¦leqisoq	N	{–leqisup, –rleqisup}, {–leqisut, –rleqisut}
inissaaleqi¦voq	V	–nngilaq
inissaanna¦q	N	–ap, –at
inissaanngits¦oq	N	–up, –ut
inissaarukkallarsimas¦oq	N	–up, –ut
inissaarukkallarsimavoq	V	(no generation)
inissaaru¦ppoq	V	–tinngilaq
inissaarutt¦oq	N	–up, –ut
inissaasuati¦ppaa	V	–nngilaa
inissaasuatitaa¦voq	V	–nngilaq
inissaasua¦voq	V	–nngilaq
inissakilliorne¦q	N	–rup, –rit
inissa¦q	N	–p, –t
inissaqa¦rpoq	V	–nngilaq
inissaqarti¦ppaa	V	–nngilaa
inissaqartitsine¦q	N	–rup, –rit
inissarsi¦orpaa	V	–unngilaa
inissarsi¦orpoq	V	–unngilaq
inissarsiort¦oq	N	–up, –ut
inissarsiuussisarfi¦k	N	–up, –it
inissarsi¦vaa	V	–nngilaa
inissarsi¦voq	V	–nngilaq
inisseeqqinne¦q	N	–rup, –rit
inissiaat	N	–ip, –it
inissiaa¦tileqatigiiffik	N	{–tileqatigiiffiup, –seqatigiiffiup}, {–tileqatigiiffiit, –seqatigiiffiit}
inissialiorfissa¦q	N	–p, –t
inissialiortit¦erneq	N	{–ernerup, –sernerup}, {–ernerit, –sernerit}
inissia¦q	N	–p, –t
inissiaqarfi¦k	N	–up, –it
inissiarsu¦aq	N	–up, –it
inissiat	N, pl.	-
inissiffig¦aa	V	–inngilaa
inissiffissaaru¦ppoq	V	–tinngilaq
inissiine¦q	N	–rup, –rit
inissiisarfi¦k	N	–up, –it
inissiisarfimmiittussanngortitsine¦q	N	–rup, –rit
inissii¦vik	N	{–ffiup, –viup}, {–ffiit, –viit}
inissinneqarne¦q	N	–rup, –rit
inissinneqart¦oq	N	–up, –ut
iniss¦iorpoq	V	{–aliunngilaq, –iunngilaq}
inissi¦ppaa	V	–nngilaa
inissi¦ppoq	V	–nngilaq
inissisimaffi¦k	N	–up, –it
inissis¦imaffik	N	{–imaffiup, –simaffiup}, {–imaffiit, –simaffiit}
inissisimane¦q	N	–rup, –rit
inissis¦imaneq	N	{–imanerup, –simanerup}, {–imanerit, –simanerit}
inissisimas¦oq	N	–up, –ut
inissis¦imasoq	N	{–imasup, –simasup}, {–imasut, –simasut}
inissitaa¦voq	V	–nngilaq
inissita¦q	N	–p, –t
inissititerne¦q	N	–rup, –rit
inissit¦itigaq	N	{–itikkap, –sitikkap}, {–itikkat, –sitikkat}
inissitsiterine¦q	N	–rup, –rit
initaa¦rpoq	V	–nngilaq
inital¦ik	N	{–iup, –lip, –lup}, –lit
init¦ooq	N	–uup, –uut
initoorsu¦aq	N	–up, –it
initoqaaq	V	(no generation)
inittorneru¦voq	V	–nngilaq
initt¦orpaa	V	–unngilaa
initt¦orpoq	V	–unngilaq
inittorsa¦rpaa	V	–nngilaa
inittorti¦ppaa	V	–nngilaa
inituallaaqaaq	V	(no generation)
initunaa¦rpaa	V	–nngilaa
initunersaa¦voq	V	–nngilaq
initunersa¦q	N	–p, –t
initussu¦seq	N	–tsip, –tsit
initu¦voq	V	–nngilaq
ini¦vaa	V	–nngilaa
innaallagi¦aq	N	–ssap, –ssat
innaallagiaqarne¦q	N	–rup, –rit
innaallagiarsu¦aq	N	–up, –it
innaallagisseris¦oq	N	–up, –ut
innaallagissiorfi¦k	N	–up, –it
innaallanne¦q	N	–rup, –rit
innaalla¦ppoq	V	–nngilaq
innaallassaat	N	–ip, –it
innaallattaat	N	–ip, –it
innaallatta¦rpoq	V	–nngilaq
innaaluttua¦rpoq	V	–nngilaq
Innaangane¦q	N	–rup, –rit
innaannaa¦voq	V	–nngilaq
innaanna¦q	N	–ap, –at
innaannarsu¦aq	N	–up, –it
innaa¦ppaa	V	–tinngilaa
innaaqqilluinna¦rpoq	V	–nngilaq
innaaqqi¦ppoq	V	–nngilaq
innaaqqissuinnaa¦voq	V	–nngilaq
innaaqqi¦ssuinnaavoq	V	{–ssuinnaanngilaq, –ttuinnaanngilaq}
innaarsuinnaa¦voq	V	–nngilaq
Innaarsuit	N, pl.	-
innaarsu¦k	N	–up, –it
innaarsussu¦aq	N	–up, –it
innaarsutta¦q	N	–p, –t
innaassaa¦voq	V	–nngilaq
innaassi¦voq	V	–nngilaq
innajaallusi¦voq	V	–nngilaq
innajaallu¦voq	V	–nngilaq
innajaanngilaq	V	(no generation)
innajaa¦rpoq	V	–nngilaq
innajuatt¦oq	N	–up, –ut
innanganertu¦voq	V	–nngilaq
innangavoq	V	(no generation)
innanngavi¦k	N	–up, –it
innanngavissaaru¦ppoq	V	–tinngilaq
innanngavissa¦q	N	–p, –t
innanngavissi¦orpoq	V	–unngilaq
innanngaviss¦iorpoq	V	{–iunngilaq, –aliunngilaq}
innannia¦rpoq	V	–nngilaq
innanniut	N	–ip, –it
innanniut	N, pl.	-
inna¦ppoq	V	–nngilaq
inna¦q	N	–ap, –at
innaqatsillaqqi¦ppoq	V	–nngilaq
innaqat¦sillaqqippoq	V	{–italillaqqinngilaq, –sillaqqinngilaq}
innaqatsine¦q	N	–rup, –rit
innaqatsi¦voq	V	–nngilaq
innarlerneqanngits¦oq	N	–up, –ut
innarlerneqart¦oq	N	–up, –ut
innarl¦erpaa	V	–inngilaa
innarl¦erpoq	V	–inngilaq
innarlersi¦ppaa	V	–nngilaa
innarler¦sippaa	V	{–sinngilaa, –tinngilaa}
innarligaane¦q	N	–rup, –rit
innarligassaannginne¦q	N	–rup, –rit
innarliine¦q	N	–rup, –rit
innarliis¦oq	N	–up, –ut
innarlii¦voq	V	–nngilaq
innarli¦orpoq	V	–unngilaq
innarlitsaaliugaanissa¦q	N	–p, –t
innarliu¦ppoq	V	–tinngilaq
innarlui¦ppoq	V	–nngilaq
innarluissu¦seq	N	–tsip, –tsit
innarluissut	N	–ip, –it
innarlui¦ssut	N, pl.	{–ssut, –ttut}
innarlu¦k	N	–up, –it
innarlulaa¦rpoq	V	–nngilaq
innarlumm¦oorpoq	V	–uunngilaq
innarlummut	N, pl.	-
innarlunne¦q	N	–rup, –rit
innarlu¦ppoq	V	–nngilaq
innarlutt¦oq	N	–up, –ut
innarluttuliorfigisaane¦q	N	–rup, –rit
innarluttuliorne¦q	N	–rup, –rit
innarluut	N	–ip, –it
innarluutaa¦voq	V	–nngilaq
innarluuteqannginne¦q	N	–rup, –rit
innarluuteqanngits¦oq	N	–up, –ut
innarluuteqarne¦q	N	–rup, –rit
innarluutig¦aa	V	–inngilaa
innarluutil¦ik	N	{–iup, –lip, –lup}, –lit
innarluutillit	N, pl.	-
innarnerli¦orpoq	V	–unngilaq
inna¦rpoq	V	–nngilaq
innarsi¦orpoq	V	–unngilaq
innarsu¦aq	N	–up, –it
innartarfi¦k	N	–up, –it
innarti¦ppaa	V	–nngilaa
innartorne¦q	N	–rup, –rit
innart¦orpoq	V	–unngilaq
innarumagaluarpoq	V	(no generation)
innatsia¦q	N	–ap, –at
innatsia¦q	N	–p, –t
innattaa¦q	N	–p, –t
innattaat	N	–ip, –it
innattaat	N, pl.	-
innattarfi¦k	N	–up, –it
innavissu¦aq	N	–up, –it
inne¦q	N	–rup, –rit
innerfi¦k	N	–up, –it
innerituallaa¦rpoq	V	–nngilaq
inneri¦voq	V	–nngilaq
inn¦erpaa	V	–inngilaa
inn¦erpoq	V	–inngilaq
innersa¦q	N	–p, –t
innersi¦voq	V	–nngilaq
in¦nersorpaa	V	{–nersunngilaa, –ulersunngilaa}
innersu¦aq	N	–up, –it
innersuit	N, pl.	-
in¦nersuivoq	V	{–nersuinngilaq, –ulersuinngilaq}
innersuu¦ppaa	V	–tinngilaa
innersuussa¦q	N	–p, –t
innersuussiffi¦k	N	–up, –it
inner¦suussiffik	N	{–suussiffiup, –tuussiffiup}, {–suussiffiit, –tuussiffiit}
innersuussine¦q	N	–rup, –rit
inner¦suussineq	N	{–suussinerup, –tuussinerup}, {–suussinerit, –tuussinerit}
innersuussinissa¦q	N	–p, –t
inner¦suussinissaq	N	{–suussinissap, –tuussinissap}, {–suussinissat, –tuussinissat}
innersuussissut	N	–ip, –it
inner¦suussissut	N	{–suussissutip, –tuussissutip}, {–suussissutit, –tuussissutit}
innersuussi¦voq	V	–nngilaq
inner¦suussivoq	V	{–suussinngilaq, –tuussinngilaq}
innersuussut	N	–ip, –it
innersu¦ussut	N	{–aassutip, –ussutip}, {–aassutit, –ussutit}
inner¦suussut	N	{–suussutip, –tuussutip}, {–suussutit, –tuussutit}
innersuussuteqarne¦q	N	–rup, –rit
innersu¦ussuteqarneq	N	{–aassuteqarnerup, –ussuteqarnerup}, {–aassuteqarnerit, –ussuteqarnerit}
inner¦suussuteqarneq	N	{–suussuteqarnerup, –tuussuteqarnerup}, {–suussuteqarnerit, –tuussuteqarnerit}
innersuussuteqa¦rpoq	V	–nngilaq
innersu¦ussuteqarpoq	V	{–aassuteqanngilaq, –ussuteqanngilaq}
inner¦suussuteqarpoq	V	{–suussuteqanngilaq, –tuussuteqanngilaq}
innersuussutig¦aa	V	–inngilaa
innersu¦ussutigaa	V	{–aassutiginngilaa, –ussutiginngilaa}
inner¦suussutigaa	V	{–suussutiginngilaa, –tuussutiginngilaa}
innersuussutigisa¦q	N	–p, –t
innersu¦ussutigisaq	N	{–aassutigisap, –ussutigisap}, {–aassutigisat, –ussutigisat}
inner¦suussutigisaq	N	{–suussutigisap, –tuussutigisap}, {–suussutigisat, –tuussutigisat}
innersuussutissa¦q	N	–p, –t
innersu¦ussutissaq	N	{–aassutissap, –ussutissap}, {–aassutissat, –ussutissat}
inner¦suussutissaq	N	{–suussutissap, –tuussutissap}, {–suussutissat, –tuussutissat}
innersuut	N	–ip, –it
inner¦suut	N	{–suutip, –tuutip}, {–suutit, –tuutit}
innertaarne¦q	N	–rup, –rit
inner¦taarneq	N	{–saarnerup, –taarnerup}, {–saarnerit, –taarnerit}
inneruulaa¦raq	N	–qqap, –qqat
inneruulani¦ppoq	V	–nngilaq
inneruula¦q	N	–p, –t
inneruula¦voq	V	–nngilaq
i¦nnga	Pron	–ssuma, {–kku, –kkua}
inngaalla¦ppoq	V	–nngilaq
inngaalu¦ppoq	V	–nngilaq
innga¦neq	N	{–nerup, –rnup}, {–nerit, –rnit}
innganersi¦orpaa	V	–unngilaa
innganersi¦orpoq	V	–unngilaq
innganikut	N, pl.	-
inngasu¦ppoq	V	–nngilaq
inngeerullu¦innarpoq	V	{–innanngilaq, –aannanngilaq}
inngeeru¦ppoq	V	–tinngilaq
inng¦eq	N	–ip, –it
inng¦erpoq	V	–inngilaq
inngersuu¦voq	V	–nngilaq
inngersu¦uvoq	V	{–aanngilaq, –unngilaq}
innger¦suuvoq	V	{–suunngilaq, –tuunngilaq}
inngertaa¦rpoq	V	–nngilaq
inngerusi¦orpoq	V	–unngilaq
inngeru¦siorpoq	V	{–siunngilaq, –tiliunngilaq}
inngerut	N	–ip, –it
inngerut	N, pl.	-
inngiag¦aa	V	–inngilaa
inngianaqaaq	V	(no generation)
inngiana¦rpoq	V	–nngilaq
inngia¦rpaa	V	–nngilaa
inngiartaanna¦rpoq	V	–nngilaq
inngiasu¦ppoq	V	–nngilaq
inngigeqqissaa¦rpoq	V	–nngilaq
inngigillu¦innarpoq	V	{–aannanngilaq, –innanngilaq}
inngigillu¦innartoq	N	{–aannartup, –innartup}, {–aannartut, –innartut}
inngigi¦ppoq	V	–nngilaq
inngigisa¦rpaa	V	–nngilaa
inngigi¦ssaat	N	{–ssaatip, –ttaatip}, {–ssaatit, –ttaatit}
inngigissaa¦voq	V	–nngilaq
inngigissa¦rpaa	V	–nngilaa
inngigi¦ssoq	N	{–ssup, –ttup}, {–ssut, –ttut}
inngiissut	N	–ip, –it
Inngi¦k	N	–up, –it
inngi¦k	N	–up, –it
inngiki¦ppoq	V	–nngilaq
Inngikitsul¦ik	N	{–iup, –lip, –lup}, –lit
Inngikitsul¦ik	Prop	{–iup, –lip, –lup}
inngikitsul¦ik	N	{–iup, –lip, –lup}, –lit
inngikuj¦ooq	N	–uup, –uut
inngikujoorsu¦aq	N	–up, –it
inngikujuul¦ik	N	{–iup, –lip, –lup}, –lit
inngili	N	–p, –t
inngiliune¦q	N	–rup, –rit
inngillu¦ppoq	V	–nngilaq
inngi¦ppaa	V	–nngilaa
inngitt¦ooq	N	–uup, –uut
inngiulaa¦rpoq	V	–nngilaq
inng¦oq	N	–up, –ut
innia¦rpoq	V	–nngilaq
inniffig¦aa	V	–inngilaa
inniffi¦k	N	–up, –it
innigia¦rpoq	V	–nngilaq
innikulu¦k	N	–up, –it
innimig¦aa	V	–inngilaa
innimiginninne¦q	N	–rup, –rit
innimiginnittussaane¦q	N	–rup, –rit
innimiilliorne¦q	N	–rup, –rit
innimiilli¦orpoq	V	–unngilaq
innimii¦ppoq	V	–nngilaq
innimiis¦erpoq	V	–inngilaq
innimina¦rpoq	V	–nngilaq
inniminart¦oq	N	–up, –ut
inniminassu¦seq	N	–tsip, –tsit
inniminn¦erpaa	V	–inngilaa
inniminni¦gaq	N	–kkap, –kkat
inniminniine¦q	N	–rup, –rit
inniminniis¦oq	N	–up, –ut
inniminnii¦voq	V	–nngilaq
innimisunna¦rpoq	V	–nngilaq
innimisu¦ppoq	V	–nngilaq
innimittart¦oq	N	–up, –ut
inningiannaqaaq	V	(no generation)
inningia¦ppoq	V	–nngilaq
inninnguuju¦k	N	–up, –it
inni¦ppoq	V	–nngilaq
innisaasat	N, pl.	-
innisalers¦orpaa	V	–unngilaa
inni¦saq	N	–tsap, –tsat
innissiaa¦voq	V	–nngilaq
innissia¦q	N	–p, –t
innitsat	N, pl.	-
innitsers¦orpaa	V	–unngilaa
innius¦erpoq	V	–inngilaq
inniu¦serpoq	V	{–sinngilaq, –tilinngilaq}
inniut	N	–ip, –it
inniut	N, pl.	-
inniutaa¦voq	V	–nngilaq
innorlu¦ppoq	V	–nngilaq
innorlutt¦oq	N	–up, –ut
innuarsaalers¦oq	N	–up, –ut
innuarsaaler¦soq	N	{–sup, –tup}, {–sut, –tut}
innuarsaa¦rpoq	V	–nngilaq
innuffi¦k	N	–up, –it
innunniaa¦voq	V	–nngilaq
innunnia¦q	N	–p, –t
innu¦ppoq	V	–nngilaq
innuttaane¦q	N	–rup, –rit
innuttaaqatigiinnilerine¦q	N	–rup, –rit
innu¦ttaaqatigiinnilerineq	N	{–ssaaqatigiinnilerinerup, –ttaaqatigiinnilerinerup}, {–ssaaqatigiinnilerinerit, –ttaaqatigiinnilerinerit}
innuttaas¦oq	N	–up, –ut
innuttaassu¦seq	N	–tsip, –tsit
innu¦ttaassuseq	N	{–ssaassutsip, –ttaassutsip}, {–ssaassutsit, –ttaassutsit}
innuttaassuseqarne¦q	N	–rup, –rit
innu¦ttaassuseqarneq	N	{–ssaassuseqarnerup, –ttaassuseqarnerup}, {–ssaassuseqarnerit, –ttaassuseqarnerit}
innuttaasulerine¦q	N	–rup, –rit
innuttaasut	N, pl.	-
innuttaatitaane¦q	N	–rup, –rit
innuttaa¦voq	V	–nngilaq
innuttal¦ik	N	{–iup, –lip, –lup}, –lit
innuttalissu¦aq	N	–up, –it
innutta¦q	N	–p, –t
innuttar¦aa	V	–inngilaa
innuttassarsi¦voq	V	–nngilaq
inooqat	N	–ip, –it
inooqataaleriartorne¦q	N	–rup, –rit
inooqataaler¦sitsineq	N	{–sitsinerup, –titsinerup}, {–sitsinerit, –titsinerit}
inooqateqanngilaq	V	(no generation)
inooqateqarne¦q	N	–rup, –rit
inooqatig¦aa	V	–inngilaa
inooqatigiinne¦q	N	–rup, –rit
in¦ooqatigiinneq	N	{–ooqatigiinnerup, –uuteqatigiinnerup}, {–ooqatigiinnerit, –uuteqatigiinnerit}
inooqqaa¦q	N	–p, –t
inooriaa¦seq	N	–tsip, –tsit
inoorlaanngu¦aq	N	–up, –it
inoorlaa¦q	N	–p, –t
inoorsaa¦rpaa	V	–nngilaa
inoorsaa¦rpoq	V	–nngilaq
inoorusunne¦q	N	–rup, –rit
inoqajuits¦oq	N	–up, –ut
inoqajuitsorsu¦aq	N	–up, –it
inoqajuitsumii¦ppoq	V	–nngilaq
inoqanngilaq	V	(no generation)
inoqannginnersa¦q	N	–p, –t
inoqanngits¦oq	N	–up, –ut
inoqanngitsumiinnilersaarutit	N, pl.	-
inoqaqaaq	V	(no generation)
inoqarfi¦k	N	–up, –it
inoqa¦rpoq	V	–nngilaq
inoqasiu¦ppaa	V	–tinngilaa
inoqa¦siuppaa	V	{–siutinngilaa, –tiliutinngilaa}
inoqat	N	–ip, –it
inoqataa¦voq	V	–nngilaq
inoqqaat	N, pl.	-
inoqqi¦k	N	–up, –it
inoqqiviu¦voq	V	–nngilaq
inoqquassaa¦q	N	–p, –t
inoqusiu¦ppaa	V	–tinngilaa
inoqu¦siuppaa	V	{–siutinngilaa, –tiliutinngilaa}
inoqut	N	–ip, –it
inoqutaa¦voq	V	–nngilaq
inoqutigiit	N, pl.	-
ino¦raq	N	–qqap, –qqat
inor¦erpoq	V	–inngilaq
inorers¦oq	N	–up, –ut
inorer¦soq	N	{–sup, –tup}, {–sut, –tut}
inorersorsu¦aq	N	–up, –it
inorer¦sorsuaq	N	{–sorsuup, –torsuup}, {–sorsuit, –torsuit}
inoriaqq¦orpoq	V	–unngilaq
inoriaqqul¦erpoq	V	–inngilaq
inoria¦rpoq	V	–nngilaq
inorlu¦k	N	–up, –it
inorluu¦voq	V	–nngilaq
inorna¦rpoq	V	–nngilaq
inornart¦oq	N	–up, –ut
inornartorsiorne¦q	N	–rup, –rit
inorneroqaaq	V	(no generation)
inor¦oorpoq	V	–uunngilaq
inoroorsaarne¦q	N	–rup, –rit
inoroorsaa¦rpoq	V	–nngilaq
inoroorsaat	N	–ip, –it
inor¦orpoq	V	–unngilaq
inororsaarfig¦aa	V	–inngilaa
inororsaa¦rpoq	V	–nngilaq
inororsaa¦voq	V	–nngilaq
inororsarfi¦k	N	–up, –it
inororsa¦rpaa	V	–nngilaa
inororsa¦rpoq	V	–nngilaq
inorort¦oq	N	–up, –ut
in¦orpaa	V	–unngilaa
in¦orpoq	V	–unngilaq
inorr¦oorpoq	V	–uunngilaq
inorroortitsi¦voq	V	–nngilaq
inorsaatig¦aa	V	–inngilaa
inorsa¦rpoq	V	–nngilaq
inort¦oq	N	–up, –ut
inort¦orpaa	V	–unngilaa
inortueqqinnaarpoq	V	(no generation)
inortuer¦eerpoq	V	–iinngilaq
inortuigaju¦ppoq	V	–nngilaq
inortui¦voq	V	–nngilaq
inortusunga¦rpaa	V	–nngilaa
inortuu¦ppaa	V	–tinngilaa
inortuu¦ppoq	V	–tinngilaq
inortuutil¦erpoq	V	–inngilaq
inortuu¦tilerpoq	V	{–sinngilaq, –tilinngilaq}
inortuutivi¦ppoq	V	–nngilaq
inoruju¦k	N	–up, –it
inorujussu¦aq	N	–up, –it
inorujussuaqa¦rpoq	V	–nngilaq
inoru¦seq	N	–tsip, –tsit
inoruut	N	–ip, –it
inoruutit¦orpoq	V	–unngilaq
inuaa¦raq	N	–qqap, –qqat
inuaaru¦ppoq	V	–tinngilaq
inu¦ak	N	–ssap, –ssat
inualuit	N, pl.	-
inualul¦ik	N	{–iup, –lip, –lup}, –lit
inualussunni	N	–p, –t
inu¦aq	N	{–ap, –ssap}, {–at, –ssat}
inuaqerpalu¦ppoq	V	–nngilaq
inuaqi¦voq	V	–nngilaq
inuarajuppoq	V	(no generation)
inuarakasi¦k	N	–up, –it
inuaranngu¦aq	N	–up, –it
inua¦raq	N	–qqap, –qqat
inuarfi¦k	N	–up, –it
Inuarfissu¦aq	N	–up, –it
inuarne¦q	N	–rup, –rit
inua¦rpoq	V	–nngilaq
inuarsaa¦rpoq	V	–nngilaq
inuarsimas¦oq	N	–up, –ut
inuarsorala¦k	N	–ap, –at
inuarta¦q	N	–p, –t
inuartar¦aa	V	–inngilaa
inuart¦oq	N	–up, –ut
inuarulliganngoriartorne¦q	N	–rup, –rit
inuarulli¦gaq	N	–kkap, –kkat
inuerne¦q	N	–rup, –rit
inuerniaa¦voq	V	–nngilaq
inuernia¦q	N	–p, –t
inu¦erpaa	V	–inngilaa
inu¦erpoq	V	–inngilaq
inuerukkiartorne¦q	N	–rup, –rit
inuerunne¦q	N	–rup, –rit
inuerunnik¦oq	N	–up, –ut
inueru¦ppaa	V	–tinngilaa
inueru¦ppoq	V	–tinngilaq
inuerussimas¦oq	N	–up, –ut
inuerussima¦voq	V	–nngilaq
inugaaru¦ppoq	V	–tinngilaq
inugaa¦voq	V	–nngilaq
inugallaqqi¦ppoq	V	–nngilaq
inu¦gaq	N	–kkap, –kkat
inugarajuppoq	V	(no generation)
inuga¦rpoq	V	–nngilaq
inugasaanngilaq	V	(no generation)
inugasaa¦rpoq	V	–nngilaq
inugasaarunnaa¦rpoq	V	–nngilaq
inugia¦ppoq	V	–nngilaq
inugi¦ppoq	V	–nngilaq
inugissuu¦voq	V	–nngilaq
inugi¦ssuuvoq	V	{–ssuunngilaq, –ttuunngilaq}
inuiaassu¦seq	N	–tsip, –tsit
inuiaat	N	–ip, –it
Inuiaat Kulturiannut Oqaluttuarisaanerannullu Immikkoortorta¦q	Prop	–p
inuiaa¦voq	V	–nngilaq
inuia¦k	N	–ap, –at
inuia¦ppoq	V	–nngilaq
inuiaqat	N	–ip, –it
inuiaqatigeeriaa¦seq	N	–tsip, –tsit
inuiaqatigiiffi¦k	N	–up, –it
inuiaqatigiilerine¦q	N	–rup, –rit
inuiaqatigiissu¦seq	N	–tsip, –tsit
inuiaqatigiit	N, pl.	-
inuia¦rpaa	V	–nngilaa
inui¦k	N	–up, –it
inuilaa¦q	N	–p, –t
inuilaarsioqatigiit	N, pl.	-
inuilaarsi¦orpoq	V	–unngilaq
inuilaarsu¦aq	N	–up, –it
inuila¦q	N	–p, –t
inuilarsi¦orpoq	V	–unngilaq
inuilatsinaqaaq	V	(no generation)
inuilatsi¦voq	V	–nngilaq
inuilline¦q	N	–rup, –rit
inuilli¦voq	V	–nngilaq
inuinnaat	N	–ip, –it
inuinnaat	N, pl.	-
inuinna¦q	N	–ap, –at
Inuit	N, pl.	-
Inuit	Prop, pl.	-
Inuit Ataqatigiit	Prop, pl.	-
inu¦k	N	–up, –it
inukassa¦k	N	–ap, –at
inukinaa¦rpaa	V	–nngilaa
inukkaa¦ppaa	V	–tinngilaa
inukkat	N, pl.	-
inukk¦oorpoq	V	–uunngilaq
inukkoorut	N	–ip, –it
inukkoorut	N, pl.	-
inukkutig¦aa	V	–inngilaa
inukkutigisaa¦voq	V	–nngilaq
inukkutilliigajuppoq	V	(no generation)
inukkutilliigajutt¦oq	N	–up, –ut
inukkutilliine¦q	N	–rup, –rit
inukkutillii¦voq	V	–nngilaq
inukullerne¦q	N	–rup, –rit
inukull¦erpoq	V	–inngilaq
inukullersarne¦q	N	–rup, –rit
inukulliatari¦voq	V	–nngilaq
inukulu¦k	N	–up, –it
inuleri¦voq	V	–nngilaq
inulers¦orpaa	V	–unngilaa
in¦ulersorpaa	V	{–nersunngilaa, –ulersunngilaa}
inul¦ik	N	{–iup, –lip, –lup}, –lit
inulimmii¦ppoq	V	–nngilaq
inulu¦ppoq	V	–nngilaq
inuluug¦aa	V	–inngilaa
inuluugaju¦ppoq	V	–nngilaq
inuluusaanna¦rpoq	V	–nngilaq
inuluu¦voq	V	–nngilaq
inum¦ineq	N	{–ernup, –inerup}, {–ernit, –inerit}
inum¦ineq	N	–ernup, –ernit
inummataa¦voq	V	–nngilaq
inummata¦k	N	–ap, –at
inungaaffig¦aa	V	–inngilaa
inungaalli¦orpoq	V	–unngilaq
inungaa¦ppoq	V	–nngilaq
inungaqaaq	V	(no generation)
inunga¦voq	V	–nngilaq
inunippallaa¦rpoq	V	–nngilaq
inuni¦ppoq	V	–nngilaq
inunngoqqinne¦q	N	–rup, –rit
inunngorfi¦k	N	–up, –it
inunng¦orpoq	V	–unngilaq
inunngort¦oq	N	–up, –ut
inunnguakkulu¦k	N	–up, –it
inunnguu¦seq	N	–tsip, –tsit
inunnguuserisa¦q	N	–p, –t
inupalaanng¦orpoq	V	–unngilaq
inupala¦aq	N	{–ap, –up}, {–at, –it}
inupalaarsu¦aq	N	–up, –it
inupalaa¦voq	V	–nngilaq
inupiluissu¦aq	N	–up, –it
inupilu¦k	N	–up, –it
inupilussu¦uvoq	V	{–aanngilaq, –unngilaq}
inuppaa¦q	N	–p, –t
inuppaat	N, pl.	-
inuppaa¦voq	V	–nngilaq
inuppalaa¦rpoq	V	–nngilaq
inup¦palaarpoq	V	{–alaanngilaq, –palaanngilaq}
inuppalaart¦oq	N	–up, –ut
inup¦palaartoq	N	{–alaartup, –palaartup}, {–alaartut, –palaartut}
inuppalaassu¦seq	N	–tsip, –tsit
inup¦palaassuseq	N	{–alaassutsip, –palaassutsip}, {–alaassutsit, –palaassutsit}
inuppalussu¦seq	N	–tsip, –tsit
inuppassuit	N, pl.	-
inussaania¦rpoq	V	–nngilaq
inussaarsu¦aq	N	–up, –it
inussa¦rpoq	V	–nngilaq
inussat	N, pl.	-
inu¦ssat	N, pl.	{–at, –ssat}
inussiaanngits¦oq	N	–up, –ut
inussiaarnia¦q	N	–p, –t
inussiaa¦voq	V	–nngilaq
inussia¦q	N	–p, –t
inussiarnerfig¦aa	V	–inngilaa
inussiarn¦erpoq	V	–inngilaq
inussiarnersaarne¦q	N	–rup, –rit
inussiarner¦saarneq	N	{–saarnerup, –taarnerup}, {–saarnerit, –taarnerit}
inussiarnersaa¦rpoq	V	–nngilaq
inussiarnersigaluttuinnarpoq	V	(no generation)
inussiarner¦soq	N	{–sup, –tup}, {–sut, –tut}
inussiarnersorsuu¦voq	V	–nngilaq
inussiarner¦sorsuuvoq	V	{–sorsuaanngilaq, –sorsuunngilaq, –torsuaanngilaq, –torsuunngilaq}
inussiarner¦suuneq	N	{–suunerup, –tuunerup}, {–suunerit, –tuunerit}
inussiarniiffig¦aa	V	–inngilaa
inussiarniilikaa¦rpoq	V	–nngilaq
inussiarniilli¦voq	V	–nngilaq
inussiarnii¦ppoq	V	–nngilaq
inussiarniissu¦seq	N	–tsip, –tsit
inussiarniits¦oq	N	–up, –ut
inuss¦iorpoq	V	{–iunngilaq, –aliunngilaq}
inussiortuunngits¦oq	N	–up, –ut
inuss¦iortuunngitsoq	N	{–iortuunngitsup, –aliortuunngitsup}, {–iortuunngitsut, –aliortuunngitsut}
inussisimanngits¦oq	N	–up, –ut
Inussivi¦k	Prop	–up, –it
inussi¦voq	V	–nngilaq
Inussu¦aq	N	–up, –it
Inussu¦aq	Prop	–up
inussu¦aq	N	–up, –it
inussu¦gaq	N	–kkap, –kkat
inussu¦k	N	–up, –it
inussukkia¦q	N	–p, –t
inussukki¦orpoq	V	–unngilaq
inussunni	N	–p, –t
inussuppalaa¦rpoq	V	–nngilaq
inussup¦palaarpoq	V	{–alaanngilaq, –palaanngilaq}
inussussu¦aq	N	–up, –it
inussuttaa¦q	N	–p, –t
inutsiala¦k	N	–ap, –at
inuttaaffeqarne¦q	N	–rup, –rit
inuttaa¦q	N	–p, –t
inuttaas¦oq	N	–up, –ut
inuttalersuisut	N, pl.	-
inuttal¦ik	N	{–iup, –lip, –lup}, –lit
inutta¦q	N	–p, –t
inuttaqanngikkallart¦oq	N	–up, –ut
inuttar¦aa	V	–inngilaa
inuttassarsine¦q	N	–rup, –rit
inuttassarsiuu¦ppaa	V	–tinngilaa
inuttassarsiuussine¦q	N	–rup, –rit
inuttassarsiuussi¦voq	V	–nngilaq
inuttassarsiuut	N	–ip, –it
inuttassarsiuuteqqita¦q	N	–p, –t
inuttassarsiuuteqqi¦taq	N	{–sap, –tap}, {–sat, –tat}
inuttat	N, pl.	-
inutt¦ooq	N	–uup, –uut
inutt¦orpoq	V	–unngilaq
inuttujaa¦rpoq	V	–nngilaq
inuttusiartorne¦q	N	–rup, –rit
inuttusiartupiloorne¦q	N	–rup, –rit
inuttusi¦voq	V	–nngilaq
inuttussu¦seq	N	–tsip, –tsit
inuttuumas¦oq	N	–up, –ut
inuttuuma¦voq	V	–nngilaq
inuttuut	N, pl.	-
inuuaa¦rpoq	V	–nngilaq
inuua¦rpoq	V	–nngilaq
inuuarsinna¦rpoq	V	–nngilaq
inuueqat	N	–ip, –it
inuueqatig¦aa	V	–inngilaa
inuuffig¦aa	V	–inngilaa
inuuffi¦k	N	–up, –it
inuugujoq	V	(no generation)
inuui¦k	N	–up, –it
inuuissi¦orpoq	V	–unngilaq
inuuiss¦iorpoq	V	{–iunngilaq, –aliunngilaq}
inuuissiort¦oq	N	–up, –ut
inuuiss¦iortoq	N	{–iortup, –aliortup}, {–iortut, –aliortut}
inuujuaa¦rpoq	V	–nngilaq
inuukatappoq	V	(no generation)
inuukkunnaa¦rpoq	V	–nngilaq
inuuleqqi¦ppoq	V	–nngilaq
inuuleqqissi¦ppaa	V	–nngilaa
inuuleqqi¦ssippaa	V	{–ssinngilaa, –tsinngilaa}
inuul¦erpoq	V	–inngilaq
inuulert¦orpoq	V	–unngilaq
inuulluaat	N	–ip, –it
inuulluaataa¦voq	V	–nngilaq
inuulluapilunne¦q	N	–rup, –rit
inuulluaqqu¦aa	V	–nngilaa
inuulluaqqusi¦voq	V	–nngilaq
inuulluaqqussut	N	–ip, –it
inuulluaqqussuteqarne¦q	N	–rup, –rit
inuulluarnaa¦ppoq	V	–nngilaq
inuulluarnart¦oq	N	–up, –ut
inuulluarne¦q	N	–rup, –rit
inuulluarniut	N	–ip, –it
inuulluarniutit	N, pl.	-
inuullua¦rpoq	V	–nngilaq
inuulluarti¦ppaa	V	–nngilaa
inuulluartitsi¦voq	V	–nngilaq
inuulluataa¦rpoq	V	–nngilaq
inuulluut	N	–ip, –it
inuulluutaa¦voq	V	–nngilaq
inuulluutit	N, pl.	-
inuuluttaa¦rpoq	V	–nngilaq
inuummarikkunnaa¦rpoq	V	–nngilaq
inuummarinna¦rpoq	V	–nngilaq
inuummarinnart¦oq	N	–up, –ut
inuummari¦ppoq	V	–nngilaq
inuummarissaa¦rpoq	V	–nngilaq
inuummarissaa¦serpaa	V	{–sinngilaa, –tilinngilaa}
inuummari¦ssaaserpaa	V	{–ssaasinngilaa, –ssaatilinngilaa, –ttaasinngilaa, –ttaatilinngilaa}
inuummarissaat	N	–ip, –it
inuummari¦ssaat	N	{–ssaatip, –ttaatip}, {–ssaatit, –ttaatit}
inuummarissaataas¦oq	N	–up, –ut
inuummari¦ssaataasoq	N	{–ssaataasup, –ttaataasup}, {–ssaataasut, –ttaataasut}
inuummarissaatit	N, pl.	-
inuummari¦ssaatit	N, pl.	{–ssaatit, –ttaatit}
inuummarissarfi¦k	N	–up, –it
inuummari¦ssarfik	N	{–ssarfiup, –ttarfiup}, {–ssarfiit, –ttarfiit}
inuummarissarne¦q	N	–rup, –rit
inuummari¦ssarneq	N	{–ssarnerup, –ttarnerup}, {–ssarnerit, –ttarnerit}
inuummarissa¦rpaa	V	–nngilaa
inuummarissa¦rpoq	V	–nngilaq
inuummari¦ssarpoq	V	–ttanngilaq
inuummarissina¦rpoq	V	–nngilaq
inuummarissi¦voq	V	–nngilaq
inuummarissu¦seq	N	–tsip, –tsit
inuummarli¦orpoq	V	–unngilaq
inuummers¦orpoq	V	–unngilaq
inuummersul¦erpoq	V	–inngilaq
inuummer¦sulerpoq	V	{–sulinngilaq, –tulinngilaq}
inuummersuutig¦aa	V	–inngilaa
inuummer¦suutigaa	V	{–suutiginngilaa, –tuutiginngilaa}
inuunanngits¦oq	N	–up, –ut
inuuna¦rpoq	V	–nngilaq
inuunart¦oq	N	–up, –ut
inuunartui¦k	N	–up, –it
inuunartul¦ik	N	{–iup, –lip, –lup}, –lit
inuune¦q	N	–rup, –rit
inuuneri¦ppoq	V	–nngilaq
inuunerissaane¦q	N	–rup, –rit
inuunerissaas¦oq	N	–up, –ut
inuuneri¦ssarfik	N	{–ssarfiup, –ttarfiup}, {–ssarfiit, –ttarfiit}
inuunerlu¦ppoq	V	–nngilaq
inuunert¦ooq	N	–uup, –uut
inuunertoorsu¦aq	N	–up, –it
inuunertu¦voq	V	–nngilaq
inuuniarne¦q	N	–rup, –rit
inuuniki¦ppoq	V	–nngilaq
inuunilu¦ppoq	V	–nngilaq
inuuniut	N	–ip, –it
inuunnguarpa¦ppoq	V	–nngilaq
inuu¦ppoq	V	–tinngilaq
inuusaa¦raq	N	–qqap, –qqat
inuusaarnert¦ooq	N	–uup, –uut
inuusaa¦rpoq	V	–nngilaq
inuusaarti¦ppaa	V	–nngilaa
inuusaa¦seq	N	–tsip, –tsit
inuusaliali¦orpoq	V	–unngilaq
inuusalianngu¦aq	N	–up, –it
inuusalia¦q	N	–p, –t
inuusaliort¦oq	N	–up, –ut
inuusa¦q	N	–p, –t
inuusa¦rpoq	V	–nngilaq
inuusartaa¦rpoq	V	–nngilaq
inuu¦seq	N	–tsip, –tsit
inuuser¦aa	V	–inngilaa
inuuseri¦ppoq	V	–nngilaq
inuuseriss¦oq	N	–up, –ut
inuuseri¦ssoq	N	{–ssup, –ttup}, {–ssut, –ttut}
inuuserissu¦seq	N	–tsip, –tsit
inuu¦serissuseq	N	{–serissutsip, –tilerissutsip}, {–serissutsit, –tilerissutsit}
inuuserlerajuppoq	V	(no generation)
inuuserlerne¦q	N	–rup, –rit
inuus¦erlerneq	N	{–erlernerup, –ilernerup}, {–erlernerit, –ilernerit}
inuuserl¦erpoq	V	–inngilaq
inuus¦erlerpoq	V	{–erlinngilaq, –ilinngilaq}
inuuserlersarne¦q	N	–rup, –rit
inuus¦erlersarneq	N	{–erlersarnerup, –ilersarnerup}, {–erlersarnerit, –ilersarnerit}
inuuserliorna¦rpoq	V	–nngilaq
inuuserli¦orpoq	V	–unngilaq
inuuserlu¦ppoq	V	–nngilaq
inuusia¦q	N	–p, –t
inuu¦siaq	N	{–siap, –tiliap}, {–siat, –tiliat}
inuu¦siorpoq	V	{–siunngilaq, –tiliunngilaq}
inuus¦oq	N	–up, –ut
inuussu¦seq	N	–tsip, –tsit
inuussut	N	–ip, –it
inuussutaa¦voq	V	–nngilaq
inuussuteqarne¦q	N	–rup, –rit
inuussuteqarti¦ppaa	V	–nngilaa
inuussutig¦aa	V	–inngilaa
inuussutissaatit	N, pl.	-
inuussutissalerine¦q	N	–rup, –rit
inuussutissa¦q	N	–p, –t
inuussutissarsiorne¦q	N	–rup, –rit
inuussutissarsiorsinnaajunnaapajaarpoq	V	(no generation)
inuussutissarsiorsinnaajunnaarnersiutil¦ik	N	{–iup, –lip, –lup}, –lit
inuussutissarsiorsinnaane¦q	N	–rup, –rit
inuussutissarsiorsinnaas¦oq	N	–up, –ut
inuussutissarsiortut	N, pl.	-
inuussutissarsiut	N	–ip, –it
Inuussutissarsiuteqarsinnaane¦q	N	–rup, –rit
inuussutissarsiutil¦ik	N	{–iup, –lip, –lup}, –lit
inuussutissat	N, pl.	-
inuusuit	N, pl.	-
inuusukaa¦q	N	–p, –t
inuusukaaqaqaaq	V	(no generation)
inuusukkaluaqaaq	V	(no generation)
inuusunne¦q	N	–rup, –rit
inuusuppallaa¦rpoq	V	–nngilaq
inuusuppalu¦ppoq	V	–nngilaq
inuusu¦ppoq	V	–nngilaq
inuusussi¦voq	V	–nngilaq
inuusutt¦oq	N	–up, –ut
inuusuttua¦raq	N	–qqap, –qqat
inuusuttuararpaalussuit	N, pl.	-
inuusuttuararpassuit	N, pl.	-
inuusuttupalaa¦q	N	–p, –t
inuusuttut	N, pl.	-
inuut	N	–ip, –it
inuutig¦aa	V	–inngilaa
inuutikkallassavaa	V	(no generation)
inuutinngilaq	V	(no generation)
inuutissa¦q	N	–p, –t
inuutissarsiorsinnaajunnaarnersiutit	N, pl.	-
inuutissarsiorsinnaane¦q	N	–rup, –rit
inuutissarsiut	N	–ip, –it
inuutitar¦aa	V	–inngilaa
inuut¦itaraa	V	{–itarinngilaa, –sitarinngilaa}
inuutivi¦ppoq	V	–nngilaq
inuutsa¦ppoq	V	–nngilaq
inuutsari¦ppoq	V	–nngilaq
inuutsarlu¦ppoq	V	–nngilaq
inuutsarutt¦orpoq	V	–unngilaq
inuutsassutig¦aa	V	–inngilaa
inuutsorlu¦ppoq	V	–nngilaq
inuutt¦oorpoq	V	–uunngilaq
inuutt¦oq	N	–up, –ut
inuuttuinnarfi¦k	N	–up, –it
inuuttuinna¦rpoq	V	–nngilaq
inuuttuunngilaq	V	(no generation)
inuu¦voq	V	–nngilaq
ipaats¦oq	N	–up, –ut
ipagilluinna¦rpoq	V	–nngilaq
ipagillu¦innarpoq	V	{–aannanngilaq, –innanngilaq}
ipagi¦ppoq	V	–nngilaq
ipagissaa¦rpoq	V	–nngilaq
ipaguaa¦rpoq	V	–nngilaq
ipagu¦aq	N	–ssap, –ssat
ipaguarsa¦rpaa	V	–nngilaa
ipajaa¦rpoq	V	–nngilaq
ipa¦k	N	–ap, –at
ipakilluinnaqaaq	V	(no generation)
ipaki¦ppoq	V	–nngilaq
ipallu¦ppoq	V	–nngilaq
ipaqqari¦ppoq	V	–nngilaq
ipaqq¦erpaa	V	–inngilaa
ipaqqissaa¦rpaa	V	–nngilaa
iparaat¦aq	N	{–ap, –tap}, {–at, –tat}
ipa¦raq	N	–qqap, –qqat
ipara¦rpaa	V	–nngilaa
iparartornerit	N, pl.	-
iparar¦tornerit	N, pl.	{–sornerit, –tornerit}
iparart¦orpaa	V	–unngilaa
iparartorsar¦aa	V	–inngilaa
ipatt¦ooq	N	–uup, –uut
ipattoorsu¦aq	N	–up, –it
ipattu¦voq	V	–nngilaq
ipeerluernaqaaq	V	(no generation)
ipeerlu¦erpaa	V	–inngilaa
ipeerlu¦erpoq	V	–inngilaq
ipeersaagaa¦voq	V	–nngilaq
ipeersaarne¦q	N	–rup, –rit
ipeersaa¦rpoq	V	–nngilaq
ipeersaaru¦ppaa	V	–tinngilaa
ipeeru¦ppoq	V	–tinngilaq
ipeerutivi¦ppoq	V	–nngilaq
ipeq	N	eqqup, eqqit
ipeqanngilaq	V	(no generation)
ipeqart¦oq	N	–up, –ut
ipeqassu¦seq	N	–tsip, –tsit
ipeqqareers¦oq	N	–up, –ut
ipeqqareer¦soq	N	{–sup, –tup}, {–sut, –tut}
ipeqqat	N, pl.	-
ipeqqa¦voq	V	–nngilaq
ipeqq¦erpaa	V	–inngilaa
ipeqqersui¦voq	V	–nngilaq
ipeqqiu¦ppaa	V	–tinngilaa
iperaa¦ppaa	V	–tinngilaa
iperaa¦ppoq	V	–tinngilaq
iperaari¦aq	N	–ssap, –ssat
iperaa¦rpoq	V	–nngilaq
iperaass¦orpaa	V	–unngilaa
iperaataaru¦ppoq	V	–tinngilaq
iperaata¦q	N	–p, –t
iperaat¦aq	N	{–ap, –tap}, {–at, –tat}
iperaatars¦orpoq	V	–unngilaq
iperaatar¦sorpoq	V	{–sunngilaq, –tunngilaq}
iperagaalluinna¦rpoq	V	–nngilaq
iperagaa¦voq	V	–nngilaq
ipera¦gaq	N	–kkap, –kkat
iperallagaane¦q	N	–rup, –rit
ipe¦raq	N	–qqap, –qqat
ipera¦rpaa	V	–nngilaa
iperartaanngilaq	V	(no generation)
iperarta¦q	N	–p, –t
iperart¦oorpaa	V	–uunngilaa
iperartornerit	N, pl.	-
iperar¦tornerit	N, pl.	{–sornerit, –tornerit}
iperart¦orpaa	V	–unngilaa
iperart¦orpoq	V	–unngilaq
iperar¦torpoq	V	{–sunngilaq, –tunngilaq}
iperartui¦voq	V	–nngilaq
iperassia¦q	N	–p, –t
iperi¦ppoq	V	–nngilaq
ip¦erpoq	V	–inngilaq
ipert¦ooq	N	–uup, –uut
ipertoorsu¦aq	N	–up, –it
ipertoorujussu¦uvoq	V	{–aanngilaq, –unngilaq}
ipertuallaaqaaq	V	(no generation)
ipertu¦voq	V	–nngilaq
iperuulluinna¦rpoq	V	–nngilaq
iperuu¦ppoq	V	–tinngilaq
ipi	N	–p, –t
ipiana¦rpoq	V	–nngilaq
ipiane¦q	N	–rup, –rit
ipia¦voq	V	–nngilaq
ipigunarsaa¦voq	V	–nngilaq
ipiiarlua¦rpaa	V	–nngilaa
ipi¦iarluarpaa	V	{–ajarluanngilaa, –iarluanngilaa}
ipiiarlua¦rpoq	V	–nngilaq
ipi¦iarluarpoq	V	{–ajarluanngilaq, –iarluanngilaq}
ipiiarneqanngits¦oq	N	–up, –ut
ipi¦iarneqanngitsoq	N	{–ajarneqanngitsup, –iarneqanngitsup}, {–ajarneqanngitsut, –iarneqanngitsut}
ipiia¦rpaa	V	–nngilaa
ipi¦iarpaa	V	{–ajanngilaa, –ianngilaa}
ipiia¦rpoq	V	–nngilaq
ipiikkunnaa¦rpoq	V	–nngilaq
ipiillisaa¦rpoq	V	–nngilaq
ipiilli¦voq	V	–nngilaq
ipiinnaa¦voq	V	–nngilaq
ipiinnarsu¦uvoq	V	{–aanngilaq, –unngilaq}
ipii¦ppoq	V	–nngilaq
ipiits¦oq	N	–up, –ut
ipikaassi¦ppoq	V	–nngilaq
ipikkunnaa¦rpoq	V	–nngilaq
ipikuju¦ppoq	V	–nngilaq
ipikujutt¦oq	N	–up, –ut
ipikujuttorujussu¦uvoq	V	{–aanngilaq, –unngilaq}
ipil¦erpoq	V	–inngilaq
ipillu¦innarpoq	V	{–aannanngilaq, –innanngilaq}
ipinarlu¦k	N	–up, –it
ipine¦q	N	–rup, –rit
ipinert¦orpoq	V	–unngilaq
ipi¦ppaa	V	–nngilaa
ipi¦ppoq	V	–nngilaq
ipisaanngu¦voq	V	–nngilaq
ipisa¦rpaa	V	–nngilaa
ipisorta¦q	N	–p, –t
ipissaanna¦q	N	–ap, –at
ipissaasart¦oq	N	–up, –ut
ipissaa¦voq	V	–nngilaq
ipissa¦rpaa	V	–nngilaa
ipissi¦voq	V	–nngilaq
ipistili	N	(no generation)
ipitaqqu¦ppaa	V	–tinngilaa
ipiteri¦voq	V	–nngilaq
ipit¦erpaa	V	–inngilaa
ipiterussu¦aq	N	–up, –it
ipiterut	N	–ip, –it
ipiterutaaja¦rpoq	V	–nngilaq
ipiti¦ppaa	V	–nngilaa
ipit¦ippaa	V	{–inngilaa, –sinngilaa}
ipititsi¦voq	V	–nngilaq
ipit¦itsivoq	V	{–itsinngilaq, –sitsinngilaq}
ipittaas¦erpaa	V	–inngilaa
ipittaa¦serpaa	V	{–sinngilaa, –tilinngilaa}
ipittaat	N	–ip, –it
ipittaavi¦k	N	–up, –it
ipittaa¦voq	V	–nngilaq
ipitt¦oq	N	–up, –ut
ipiutaa¦raq	N	–qqap, –qqat
ipiutaasanitt¦oq	N	–up, –ut
ipiuta¦k	N	–ap, –at
ipiutaki¦ppoq	V	–nngilaq
ipiutal¦ik	N	{–iup, –lip, –lup}, –lit
ipiut¦aq	N	{–ap, –tap}, {–at, –tat}
ipivi¦ppoq	V	–nngilaq
ipi¦voq	V	–nngilaq
ip¦oriarneq	N	{–oriarnerup, –uperiarnerup}, {–oriarnerit, –uperiarnerit}
iporsuunne¦q	N	–rup, –rit
iporsuu¦ppaa	V	–tinngilaa
ippaa	V	(no generation)
ippaakkaluttuinna¦rpoq	V	–nngilaq
ippaalluinna¦rpoq	V	–nngilaq
ippaallu¦innarpoq	V	{–aannanngilaq, –innanngilaq}
ippaa¦ppaa	V	–nngilaa
ippaa¦ppoq	V	–nngilaq
ippaat	N	–ip, –it
ippaat	N, pl.	-
ippajaa¦ppoq	V	–nngilaq
ippajanngilaq	V	(no generation)
ippaja¦voq	V	–nngilaq
ippa¦k	N	–ap, –at
ippalu¦ppaa	V	–nngilaa
ippalu¦ppoq	V	–nngilaq
ippammii¦ppoq	V	–nngilaq
ippammiiti¦ppaa	V	–nngilaa
ippammii¦tippaa	V	{–sinngilaa, –tinngilaa, –tsinngilaa}
ippammiu	N	–p, –t
ippa¦ppaa	V	–nngilaa
ippappallaaqaaq	V	(no generation)
ippappallaarnaveersaarpoq	V	(no generation)
ippa¦ppoq	V	–nngilaq
ippa¦rpaa	V	–nngilaa
ippa¦rpoq	V	–nngilaq
ippasi¦orpoq	V	–unngilaq
ippa¦siorpoq	V	{–siunngilaq, –tiliunngilaq}
ippassaan¦iinnaq	N	{–erinnaap, –iinnaap}, {–erinnaat, –iinnaat}
ippassaaniisaanna¦q	N	–ap, –at
ippassaa¦voq	V	–nngilaq
ippassa¦q	N	–p, –t
ippassarni¦saq	N	–tsap, –tsat
ippat	N	–ip, –it
ippataanii¦ppoq	V	–nngilaq
ippeqinaqaaq	V	(no generation)
ippeqi¦voq	V	–nngilaq
ipperfi¦k	N	–up, –it
ippernaaqqut	N	–ip, –it
ippernaa¦raq	N	–qqap, –qqat
ippernaarsaa¦rpoq	V	–nngilaq
ippernaasa¦q	N	–p, –t
ipperna¦q	N	–p, –t
ippernarsu¦aq	N	–up, –it
ipp¦erpaa	V	–inngilaa
ippert¦ooq	N	–uup, –uut
ippertoorsu¦aq	N	–up, –it
ippertu¦voq	V	–nngilaq
Ippiarsu¦k	N	–up, –it
ippiarsu¦k	N	–up, –it
ippiarsuusa¦q	N	–p, –t
ippig¦aa	V	–inngilaa
ippig¦aaq	V	–inngilaq
ippiga¦rpoq	V	–nngilaq
ippiginni¦ppoq	V	–nngilaq
ippigisaaru¦ppoq	V	–tinngilaq
ippigisa¦q	N	–p, –t
ippigusunnaqaaq	V	(no generation)
ippigusu¦ppoq	V	–nngilaq
Ippi¦k	N	–up, –it
ippi¦k	N	–up, –it
ippiki¦ppoq	V	–nngilaq
ippiliugal¦ik	N	{–iup, –lip, –lup}, –lit
ippiliu¦gaq	N	–kkap, –kkat
ippiliugarsu¦aq	N	–up, –it
ippingiag¦aa	V	–inngilaa
ippingianaqaaq	V	(no generation)
ippingiana¦rpoq	V	–nngilaq
ippingianart¦oq	N	–up, –ut
ippingianassu¦seq	N	–tsip, –tsit
ippingia¦ppoq	V	–nngilaq
ippingiat¦orpoq	V	–unngilaq
ippinnaannart¦oq	N	–up, –ut
ippinnaat	N	–ip, –it
ippinnaat	N, pl.	-
ippinna¦rpoq	V	–nngilaq
ippinnarsigaluttuinnarpoq	V	(no generation)
ippinnarsi¦voq	V	–nngilaq
ippinnart¦oq	N	–up, –ut
ippinnarunnaa¦rpoq	V	–nngilaq
ippi¦orpoq	V	–unngilaq
ippisaa¦rpoq	V	–nngilaq
ippisa¦rpoq	V	–nngilaq
ippissu¦aq	N	–up, –it
i¦ppoq	V	–nngilaq
ipporippallaanngilaq	V	(no generation)
ippori¦ppoq	V	–nngilaq
ipporissaa¦rpoq	V	–nngilaq
ipporissi¦voq	V	–nngilaq
ipporlukkunnaa¦rpoq	V	–nngilaq
ipporlu¦ppoq	V	–nngilaq
ipporluttuiu¦voq	V	–nngilaq
ippuissaa¦rpoq	V	–nngilaq
ippulluinna¦rpaa	V	–nngilaa
ippullu¦innarpaa	V	{–aannanngilaa, –innanngilaa}
ippu¦ppaa	V	–nngilaa
ippus¦erpoq	V	–inngilaq
ipputingaja¦ppaa	V	–nngilaa
ipputivi¦ppaa	V	–nngilaa
ipu	N	–p, –t
ipuanii¦ppoq	V	–nngilaq
ipuari¦ppoq	V	–nngilaq
ipueru¦ppoq	V	–tinngilaq
ipuerutivi¦ppoq	V	–nngilaq
ipuerutt¦oorpoq	V	–uunngilaq
ipuits¦oq	N	–up, –ut
ipul¦erpaa	V	–inngilaa
ipuli¦gaq	N	–kkap, –kkat
ipul¦ik	N	{–iup, –lip, –lup}, –lit
ipulikk¦erpaa	V	–inngilaa
ipulittatuaa¦voq	V	–nngilaq
ipulit¦tatuaavoq	V	{–atuaanngilaq, –tatuaanngilaq}
ipulutaki¦ppoq	V	–nngilaq
ipulut¦aq	N	{–ap, –tap}, {–at, –tat}
ipummerlua¦rpoq	V	–nngilaq
ipumm¦erpoq	V	–inngilaq
ipummersi¦ppaa	V	–nngilaa
ipummingavi¦ppoq	V	–nngilaq
ipumminga¦voq	V	–nngilaq
ipummiu¦ppaa	V	–tinngilaa
ipummiussa¦q	N	–p, –t
ipummiussisima¦voq	V	–nngilaq
ipummiussi¦voq	V	–nngilaq
ipunne¦q	N	–rup, –rit
ipu¦ppaa	V	–nngilaa
ipu¦ppoq	V	–nngilaq
ipuserfi¦k	N	–up, –it
ipu¦serfik	N	{–serfiup, –tilerfiup}, {–serfiit, –tilerfiit}
ipuserfilers¦orpaa	V	–unngilaa
ipu¦serfilersorpaa	V	{–serfilersunngilaa, –tilerfilersunngilaa}
ipus¦erpaa	V	–inngilaa
ipu¦serpaa	V	{–sinngilaa, –tilinngilaa}
ipusers¦orpoq	V	–unngilaq
ipu¦sersorpoq	V	{–sersunngilaq, –tilersunngilaq}
ipusi¦orpoq	V	–unngilaq
ipu¦siorpoq	V	{–siunngilaq, –tiliunngilaq}
ipussaa¦rpoq	V	–nngilaq
ipussinnaa¦voq	V	–nngilaq
ipussorataa¦rpoq	V	–nngilaq
iput	N	–ip, –it
iput	N, pl.	-
iputaajarajuppoq	V	(no generation)
iputaaja¦rpaa	V	–nngilaa
iputaaja¦rpoq	V	–nngilaq
iputaa¦rpaa	V	–nngilaa
iputaa¦rpoq	V	–nngilaq
iputaars¦erpoq	V	–inngilaq
iputisseri¦voq	V	–nngilaq
iputissiaa¦voq	V	–nngilaq
iputissia¦q	N	–p, –t
iput¦ooq	N	–uup, –uut
iputsi	N	–p, –t
iputtaa¦voq	V	–nngilaq
iputt¦oq	N	–up, –ut
Irakim¦eersoq	N	{–eersup, –eertup, –inngaanneersup, –inngaanneertup}, {–eersut, –eertut, –inngaanneersut, –inngaanneertut}
Irakimioq	N	(no generation)
Irak¦imiu	N	{–ermiup, –imiup}, {–ermiut, –imiut}
Iranim¦eersoq	N	{–eersup, –eertup, –inngaanneersup, –inngaanneertup}, {–eersut, –eertut, –inngaanneersut, –inngaanneertut}
Iranimioq	N	(no generation)
Iran¦imiu	N	{–ermiup, –imiup}, {–ermiut, –imiut}
isa	N	–p, –t
isaaffig¦aa	V	–inngilaa
isaaffi¦k	N	–up, –it
isaaffissu¦aq	N	–up, –it
isaaffiusa¦q	N	–p, –t
isaa¦gaq	N	–kkap, –kkat
isaajaa¦ppaa	V	–tinngilaa
isaaja¦rpaa	V	–nngilaa
isaaja¦rpoq	V	–nngilaq
isaanne¦q	N	–rup, –rit
isaa¦ppaa	V	–tinngilaa
isaa¦ppoq	V	–nngilaq
isaariaki¦ppoq	V	–nngilaq
isaari¦aq	N	–ssap, –ssat
isaariartaa¦rpoq	V	–nngilaq
isaarnik¦oq	N	–up, –ut
isaa¦rpaa	V	–nngilaa
isaa¦rpoq	V	–nngilaq
isaarti¦ppoq	V	–nngilaq
isaasa¦q	N	–p, –t
isaasat	N, pl.	-
isaassi¦voq	V	–nngilaq
isaasuki¦ppoq	V	–nngilaq
isaatitsissut	N	–ip, –it
isaatitsi¦voq	V	–nngilaq
isaats¦oq	N	–up, –ut
isaavi¦k	N	–up, –it
isaa¦voq	V	–nngilaq
isa¦gaq	N	–kkap, –kkat
isagui¦ppoq	V	–nngilaq
isagu¦ppaa	V	–tinngilaa
isajannga¦ppaa	V	–nngilaa
isajanngassa¦q	N	–p, –t
isajanngassi¦voq	V	–nngilaq
isalunne¦q	N	–rup, –rit
isane¦q	N	–rup, –rit
isanne¦q	N	–rup, –rit
isa¦ppaa	V	–nngilaa
isa¦ppoq	V	–nngilaq
isaqqajaa¦voq	V	–nngilaq
isaqqilaa¦rpoq	V	–nngilaq
isaqqilarpalunne¦q	N	–rup, –rit
isaqqila¦voq	V	–nngilaq
isaqqilla¦ppoq	V	–nngilaq
isaqqi¦voq	V	–nngilaq
isaqu¦k	N	–up, –it
isaqu¦ppoq	V	–tinngilaq
isaria¦rpoq	V	–nngilaq
isa¦roq	N	–qqup, –qqut
isar¦orpaa	V	–unngilaa
isarorti¦ppoq	V	–nngilaq
isarrat	N	–ip, –it
isaruaaja¦rpoq	V	–nngilaq
isarualersarpoq	V	(no generation)
isarualer¦tarpoq	V	{–sanngilaq, –tanngilaq}
isaru¦aq	N	–ssap, –ssat
isaruaria¦rpoq	V	–nngilaq
isarua¦rpaa	V	–nngilaa
isarua¦rpoq	V	–nngilaq
isaruarta¦q	N	–p, –t
isarukits¦oq	N	–up, –ut
isarukitsorsu¦aq	N	–up, –it
isarussat	N, pl.	-
isaruss¦erpoq	V	–inngilaq
isarussi¦orpoq	V	–unngilaq
isaruss¦iorpoq	V	{–aliunngilaq, –iunngilaq}
isarussiortuu¦voq	V	–nngilaq
isaruss¦iortuuvoq	V	{–aliortuunngilaq, –iortuunngilaq}
isasarfi¦k	N	–up, –it
isasoorne¦q	N	–rup, –rit
isas¦oorpoq	V	–uunngilaq
isas¦oq	N	–up, –ut
isassi¦voq	V	–nngilaq
isasso¦raq	N	–qqap, –qqat
isassorart¦orpoq	V	–unngilaq
isassorar¦torpoq	V	{–sunngilaq, –tunngilaq}
isataki¦ppoq	V	–nngilaq
isata¦q	N	–p, –t
isat¦aq	N	{–ap, –tap}, {–at, –tat}
isaterine¦q	N	–rup, –rit
isat¦erpaa	V	–inngilaa
isatsi¦ppaa	V	–nngilaa
isatsi¦ppoq	V	–nngilaq
isatsita¦q	N	–p, –t
isat¦sitaq	N	{–sitap, –itap}, {–sitat, –itat}
isatsi¦voq	V	–nngilaq
isatsui¦ppoq	V	–nngilaq
isattari¦aq	N	{–ssap, –ap}, {–ssat, –at}
isattari¦aq	N	–ssap, –ssat
isatta¦rpaa	V	–nngilaa
isatt¦orpaa	V	–unngilaa
isatt¦orpoq	V	–unngilaq
isa¦voq	V	–nngilaq
is¦eq	N	–ip, –it
iseqqaarfi¦k	N	–up, –it
iseqqat	N, pl.	-
iseqqa¦voq	V	–nngilaq
iseqqimisaa¦rpoq	V	–nngilaq
iseqqiusaa¦rpoq	V	–nngilaq
iseqqi¦vaa	V	–nngilaa
iseqqumisaa¦rpoq	V	–nngilaq
iseqqusaanngilaq	V	(no generation)
iseralua¦rpoq	V	–nngilaq
ise¦raq	N	–qqap, –qqat
iserart¦orpoq	V	–unngilaq
iserar¦torpoq	V	{–sunngilaq, –tunngilaq}
iserfig¦aa	V	–inngilaa
iserfi¦k	N	–up, –it
iserfiki¦ppoq	V	–nngilaq
iserfilu¦k	N	–up, –it
iserfissa¦q	N	–p, –t
iseria¦k	N	–ap, –at
iseria¦ppoq	V	–nngilaq
iseriassu¦aq	N	–up, –it
iseriatt¦oq	N	–up, –ut
iseriattorsu¦uvoq	V	{–aanngilaq, –unngilaq}
iseriss¦erpoq	V	–inngilaq
iseriusaa¦rpoq	V	–nngilaq
isermi¦oq	N	–up, –ut
iserne¦q	N	–rup, –rit
isernia¦q	N	–p, –t
isernia¦rpoq	V	–nngilaq
is¦erpaa	V	–inngilaa
iserpalla¦ppoq	V	–nngilaq
is¦erpallappoq	V	{–erpallanngilaq, –ipallanngilaq}
iserpallassa¦aq	V	–nngilaq
iserpallatta¦rpoq	V	–nngilaq
is¦erpallattarpoq	V	{–erpallattanngilaq, –ipallattanngilaq}
is¦erpoq	V	–inngilaq
isersarnaanngu¦aq	N	–up, –it
isersarne¦q	N	–rup, –rit
isersarnerajuppoq	V	(no generation)
isersarn¦erpoq	V	–inngilaq
isersarnersu¦aq	N	–up, –it
isersimaannaqqusaaffi¦k	N	–up, –it
isersimaartarfi¦k	N	–up, –it
isersimaffissaanngilaq	V	(no generation)
isersima¦voq	V	–nngilaq
isersimmas¦erpoq	V	–inngilaq
isersimma¦serpoq	V	{–sinngilaq, –tilinngilaq}
isersimmat	N	–ip, –it
isersimmatit	N, pl.	-
isersinnaatitaane¦q	N	–rup, –rit
isersinnaatitsis¦oq	N	–up, –ut
isersiut	N	–ip, –it
isers¦orpoq	V	–unngilaq
iser¦sorpoq	V	{–sunngilaq, –tunngilaq}
isersorsuu¦voq	V	–nngilaq
isersorsu¦uvoq	V	{–aanngilaq, –unngilaq}
iser¦sorsuuvoq	V	{–sorsuaanngilaq, –sorsuunngilaq, –torsuaanngilaq, –torsuunngilaq}
iserta¦q	N	–p, –t
isertar¦aa	V	–inngilaa
isertarfi¦k	N	–up, –it
iserterfi¦k	N	–up, –it
iserterivi¦k	N	–up, –it
iserteri¦voq	V	–nngilaq
iserterne¦q	N	–rup, –rit
isert¦erpaa	V	–inngilaa
isert¦erpoq	V	–inngilaq
iser¦tippaa	V	{–tinngilaa, –sinngilaa}
iser¦titaq	N	{–titap, –sitap}, {–titat, –sitat}
iser¦titseqattaarneq	N	{–titseqattaarnerup, –sitseqattaarnerup}, {–titseqattaarnerit, –sitseqattaarnerit}
iser¦titseriarneq	N	{–titseriarnerup, –sitseriarnerup}, {–titseriarnerit, –sitseriarnerit}
iser¦titsineq	N	{–titsinerup, –sitsinerup}, {–titsinerit, –sitsinerit}
isertitsisarfi¦k	N	–up, –it
iser¦titsisarfik	N	{–titsisarfiup, –sitsisarfiup}, {–titsisarfiit, –sitsisarfiit}
isertitsiviit	N, pl.	-
isertitsi¦viit	N, pl.	{–ffiit, –viit}
Isertitsivi¦k	N	{–iup, –up}, {–iit, –it}
Isertitsivi¦k	N	–up, –it
isertitsivi¦k	N	–up, –it
isertitsi¦vik	N	{–ffiup, –viup}, {–ffiit, –viit}
isertitsivimmiittussanng¦orpaa	V	–unngilaa
isertitsi¦vimmiittussanngorpaa	V	{–ffimmiittussanngunngilaa, –vimmiittussanngunngilaa}
isertitsivimmiittussanngorti¦ppaa	V	–nngilaa
isertitsi¦vimmiittussanngortippaa	V	{–ffimmiittussanngortinngilaa, –vimmiittussanngortinngilaa}
iser¦titsivoq	V	{–titsinngilaq, –sitsinngilaq}
iser¦toq	N	{–tup, –sup}, {–tut, –sut}
isertoqassanngilaq	V	(no generation)
isertorniarfi¦k	N	–up, –it
iser¦torniarfik	N	{–sorniarfiup, –torniarfiup}, {–sorniarfiit, –torniarfiit}
isertorniarneqanngits¦oq	N	–up, –ut
iser¦torniarneqanngitsoq	N	{–sorniarneqanngitsup, –torniarneqanngitsup}, {–sorniarneqanngitsut, –torniarneqanngitsut}
isert¦orpaa	V	–unngilaa
isert¦orpoq	V	–unngilaq
iser¦torpoq	V	{–sunngilaq, –tunngilaq}
isertort¦oq	N	–up, –ut
iser¦tortoq	N	{–sortup, –tortup}, {–sortut, –tortut}
isertoruminaassinnaasa¦rpoq	V	–nngilaq
iser¦toruminaassinnaasarpoq	V	{–soruminaassinnaasanngilaq, –toruminaassinnaasanngilaq}
isertuanngilaq	V	(no generation)
isertuannginne¦q	N	–rup, –rit
isertuanngissu¦seq	N	–tsip, –tsit
isertuanngits¦oq	N	–up, –ut
isertua¦rpoq	V	–nngilaq
isertugaaru¦ppaa	V	–tinngilaa
iser¦tugaaruppaa	V	{–sugaarutinngilaa, –tugaarutinngilaa}
isertu¦gaq	N	–kkap, –kkat
iser¦tugaq	N	{–sukkap, –tukkap}, {–sukkat, –tukkat}
isertuiui¦ppoq	V	–nngilaq
iser¦tuiuippoq	V	{–tuiuinngilaq, –suiuinngilaq}
isertujui¦ppoq	V	–nngilaq
isertuu¦ppaa	V	–tinngilaa
isertuussa¦q	N	–p, –t
isertuussis¦oq	N	–up, –ut
iser¦tuussisoq	N	{–tuussisup, –suussisup}, {–tuussisut, –suussisut}
isertuussisussaatitaane¦q	N	–rup, –rit
iser¦tuussisussaatitaaneq	N	{–tuussisussaatitaanerup, –suussisussaatitaanerup}, {–tuussisussaatitaanerit, –suussisussaatitaanerit}
isertuussi¦voq	V	–nngilaq
iser¦tuussivoq	V	{–tuussinngilaq, –suussinngilaq}
iserumajunnaarsi¦ppaa	V	–nngilaa
iserunnarsivoq	V	(no generation)
iserusulernikuunngilaq	V	(no generation)
isi	N	–p, –t
isiarni	Interj	(no generation)
isiffalla¦ppoq	V	–nngilaq
isiffi¦k	N	–up, –it
isiffissaannaa¦voq	V	–nngilaq
isiffiusa¦rpoq	V	–nngilaq
isig¦aa	V	–inngilaa
isigaal¦erpoq	V	–inngilaq
isig¦aaq	V	–inngilaq
isigaarsigaju¦ppoq	V	–nngilaq
isigaarsiisa¦rpoq	V	–nngilaq
isigaarsilaa¦rpoq	V	–nngilaq
isigaarsi¦voq	V	–nngilaq
isigaasa¦q	N	–p, –t
isigaat	N	–ip, –it
isi¦gaat	N	{–gaat, –kkat, –gaatip}, –gaatit
isi¦gak	N	{–gaap, –kkap}, {–gaat, –kkat}
isigammaa¦q	N	–p, –t
isigammi¦ppaa	V	–nngilaa
isigappa¦k	N	–ap, –at
isigassiut	N	–ip, –it
isigassiut	N, pl.	-
isigassorial¦ik	N	{–iup, –lip, –lup}, –lit
isigassori¦aq	N	–ssap, –ssat
isigass¦orpoq	V	–unngilaq
isiga¦ssorpoq	V	{–ssunngilaq, –ttunngilaq}
isigassortari¦aq	N	–ssap, –ssat
isiga¦ssortariaq	N	{–ssortarissap, –ttortarissap}, {–ssortarissat, –ttortarissat}
isigatt¦ooq	N	–uup, –uut
isigeqqajaasarpaa	V	(no generation)
isigeqqusaa¦rpaa	V	–nngilaa
isigerlu¦ppaa	V	–nngilaa
isigerul¦oorpaa	V	–uunngilaa
isigerulu¦ppaa	V	–nngilaa
isigiarsunne¦q	N	–rup, –rit
isigiarsu¦ppaa	V	–tinngilaa
isigiarsu¦ppoq	V	–nngilaq
isigiarsutt¦oq	N	–up, –ut
isigilereersimavaa	V	(no generation)
isigilersimanerpaa	V	(no generation)
isigilersima¦vaa	V	–nngilaa
isigileruttorpaa	V	(no generation)
isigillua¦rpaa	V	–nngilaa
isigillua¦rpoq	V	–nngilaq
isigilluarunnaarpoq	V	(no generation)
isiginiut	N	–ip, –it
isiginnaagassialiort¦oq	N	–up, –ut
isiginnaagassia¦q	N	–p, –t
isiginnaamisaarpaa	V	(no generation)
isiginnaaria¦q	N	–p, –t
isiginnaariartarfi¦k	N	–up, –it
isiginnaariart¦oq	N	–up, –ut
isiginnaa¦rpaa	V	–nngilaa
isiginnaa¦rpoq	V	–nngilaq
isiginnaartart¦oq	N	–up, –ut
isiginnaarti¦ppaa	V	–nngilaa
isiginnaartitsine¦q	N	–rup, –rit
isiginnaartitsisarfiit	N, pl.	-
isiginnaartitsisarfi¦k	N	–up, –it
isiginnaartitsisart¦oq	N	–up, –ut
isiginnaartitsisartoqatigiit	N, pl.	-
isiginnaartitsissu¦siortartoq	N	{–siortartup, –tiliortartup}, {–siortartut, –tiliortartut}
isiginnaartitsissut	N	–ip, –it
isiginnaartitsissutig¦aa	V	–inngilaa
isiginnaartitsissutigineqartussat	N, pl.	-
isiginnaartitsissutigisassat	N, pl.	-
isiginnaartitsisut	N, pl.	-
isiginnaartitsi¦voq	V	–nngilaq
isiginnaart¦oq	N	–up, –ut
isiginnaartut	N, pl.	-
isiginnartitsisarfi¦k	N	–up, –it
isiginnartitsisart¦oq	N	–up, –ut
isiginneriaa¦seq	N	–tsip, –tsit
isiginngitsuusaa¦gaq	N	–kkap, –kkat
isiginngitsuusaa¦rpaa	V	–nngilaa
isiginniffi¦k	N	–up, –it
isiginninne¦q	N	–rup, –rit
isiginni¦ppoq	V	–nngilaq
isiginnitt¦oq	N	–up, –ut
isiginnittuus¦oq	N	–up, –ut
isigi¦ppoq	V	–nngilaq
isigisaarukkaluttuinnarpoq	V	(no generation)
isigisa¦q	N	–p, –t
isigisaqanngilaq	V	(no generation)
isigisaqarne¦q	N	–rup, –rit
isigisaria¦q	N	–p, –t
isigisinnaassu¦seq	N	–tsip, –tsit
isigis¦oorpaa	V	–uunngilaa
isigis¦oq	N	–up, –ut
isigissaat	N	–ip, –it
isigi¦ssaat	N	{–ssaatip, –ttaatip}, {–ssaatit, –ttaatit}
isigissaa¦voq	V	–nngilaq
isigissi¦voq	V	–nngilaq
isigissut	N, pl.	-
isigi¦ssut	N, pl.	{–ssut, –ttut}
isigissuu¦voq	V	–nngilaq
isigi¦ssuuvoq	V	{–ssuunngilaq, –ttuunngilaq}
isigiunnaa¦rpaa	V	–nngilaa
isikig¦aa	V	–inngilaa
isikilli¦voq	V	–nngilaq
isikinne¦q	N	–rup, –rit
isikippallaa¦rpoq	V	–nngilaq
isiki¦ppoq	V	–nngilaq
isikkaarti¦ppaa	V	–nngilaa
isikka¦neq	Num	{–rngup, –rnup}, {–rngit, –rnit}
isikkaneq tallimat	Num, pl.	-
isikkaneq-marluk	Num, pl.	-
isikkaneq-pingasut	Num, pl.	-
isikkaneq-sisamat	Num, pl.	-
isikkaneq-tallimat	Num, pl.	-
isikkanillit	Num, pl.	-
isikkanniu¦ppaa	V	–tinngilaa
isikka¦rpoq	V	–nngilaq
isikkat	N, pl.	-
isi¦kkat	N, pl.	{–gaat, –kkat}
isikkil¦eerpoq	V	–iinngilaq
isikkileersi¦ppaa	V	–nngilaa
isikkileersitsi¦voq	V	–nngilaq
isikkiveeru¦ppoq	V	–tinngilaq
isikkivigi¦ppoq	V	–nngilaq
Isikkivi¦k	N	–up, –it
isikkivi¦k	N	–up, –it
isikkiviki¦ppoq	V	–nngilaq
isikkivikkaa¦q	N	–p, –t
isikkivitt¦ooq	N	–uup, –uut
isikk¦oq	N	–up, –ut
isikkoqa¦rpoq	V	–nngilaq
isikkori¦ppoq	V	–nngilaq
isikkorissu¦seq	N	–tsip, –tsit
isikkorlu¦ppaa	V	–nngilaa
isikkorlu¦ppoq	V	–nngilaq
isikkort¦ooq	N	–uup, –uut
isikkortunersaat	N	–ip, –it
isikkortu¦voq	V	–nngilaq
isikku	N	–p, –t
isikkulu¦ppoq	V	–nngilaq
isikkumina¦rpoq	V	–nngilaq
isikkuminarsi¦voq	V	–nngilaq
isikkuminart¦oq	N	–up, –ut
isikkuni¦ppoq	V	–nngilaq
isikku¦ppaa	V	–tinngilaa
isikujoorfig¦aa	V	–inngilaa
isikuj¦oorpoq	V	–uunngilaq
isikulaarpallaarpoq	V	(no generation)
isikulaarpoq	V	(no generation)
isikula¦voq	V	–nngilaq
isilaarallarpoq	V	(no generation)
isilerfi¦k	N	–up, –it
isileri¦voq	V	–nngilaq
isil¦erpaa	V	–inngilaa
isil¦erpoq	V	–inngilaq
isilersaarpoq	V	(no generation)
isillattaaginnarpoq	V	(no generation)
isillattaarpoq	V	(no generation)
isillernaqaaq	V	(no generation)
isill¦erpoq	V	–inngilaq
isillersaatig¦aa	V	–inngilaa
isiller¦saatigaa	V	{–saatiginngilaa, –taatiginngilaa}
isillersa¦rpoq	V	–nngilaq
isilukkunnaa¦rpoq	V	–nngilaq
isilunne¦q	N	–rup, –rit
isiluppallaaqaaq	V	(no generation)
isilu¦ppoq	V	–nngilaq
isimmari¦ppoq	V	–nngilaq
isimma¦rpoq	V	–nngilaq
isimmarsa¦rpaa	V	–nngilaa
isimmarsarti¦ppaa	V	–nngilaa
isimmarti¦ppaa	V	–nngilaa
isimmart¦oorpoq	V	–uunngilaq
isimmiffig¦aa	V	–inngilaa
isimmiga¦rpaa	V	–nngilaa
isimmigarpoq	V	(no generation)
isimmigart¦orpaa	V	–unngilaa
isimmikatta¦rpaa	V	–nngilaa
isimmi¦ppaa	V	–nngilaa
isimmi¦ppoq	V	–nngilaq
isimmissa¦rpaa	V	–nngilaa
isimmi¦tsineq	N	{–inerup, –tsinerup}, {–inerit, –tsinerit}
isimmi¦tsinneq	N	{–ssinnerup, –tsinnerup, –tinnerup}, {–ssinnerit, –tsinnerit, –tinnerit}
isingas¦oorpoq	V	–uunngilaq
isingavallaa¦rpoq	V	–nngilaq
isinga¦voq	V	–nngilaq
isinngaanna¦rpoq	V	–nngilaq
isinngallua¦rpoq	V	–nngilaq
isinngas¦oq	N	–up, –ut
isinnga¦voq	V	–nngilaq
isinngilluinnarpoq	V	(no generation)
isip¦allappoq	V	{–allanngilaq, –pallanngilaq}
is¦ipallappoq	V	{–erpallanngilaq, –ipallanngilaq}
isipallassaaq	V	(no generation)
isippa¦k	N	–ap, –at
isipp¦eerpaa	V	–iinngilaa
isi¦ppoq	V	–nngilaq
isissaa¦rpoq	V	–nngilaq
isissaa¦voq	V	–nngilaq
isissa¦q	N	–p, –t
isissari¦ppoq	V	–nngilaq
isissua¦rpaa	V	–nngilaa
isissutissa¦q	N	–p, –t
isissutissarsi¦voq	V	–nngilaq
isitalaa¦rpoq	V	–nngilaq
isitalaarti¦ppaa	V	–nngilaa
isit¦ooq	N	–uup, –uut
isitoo¦raq	N	–qqap, –qqat
isitooraqaqaaq	V	(no generation)
isitoorsu¦aq	N	–up, –it
isitsaalivaa	V	(no generation)
isits¦erpaa	V	–inngilaa
isit¦serpaa	V	{–italinngilaa, –sinngilaa}
isitsersima¦voq	V	–nngilaq
isit¦sersimavoq	V	{–italersimanngilaq, –sersimanngilaq}
isittua¦raq	N	–qqap, –qqat
isi¦ttuaraq	N	{–ssuaqqap, –ttuaqqap}, {–ssuaqqat, –ttuaqqat}
isituua¦q	N	–p, –t
isituua¦raq	N	–qqap, –qqat
isitu¦voq	V	–nngilaq
isiula¦voq	V	–nngilaq
isiusa¦q	N	–p, –t
isivi¦ppaa	V	–nngilaa
isivi¦ppoq	V	–nngilaq
isivisa¦rpaa	V	–nngilaa
isivissimas¦oq	N	–up, –ut
isivis¦simasoq	N	{–imasup, –simasup}, {–imasut, –simasut}
isivita¦q	N	–p, –t
isiviti¦ppaa	V	–nngilaa
isi¦voq	V	–nngilaq
Island¦imiu	N	{–ermiup, –imiup}, {–ermiut, –imiut}
is¦oq	N	–up, –ut
isoqanngilaq	V	(no generation)
isoqa¦rpoq	V	–nngilaq
isoqus¦erpaa	V	–inngilaa
isoqu¦serpaa	V	{–sinngilaa, –tilinngilaa}
isoqut	N	–ip, –it
isor¦aa	V	–inngilaa
isorajuppoq	V	(no generation)
isorakilli¦vaa	V	–nngilaa
isorakinaa¦rpaa	V	–nngilaa
isoraki¦ppoq	V	–nngilaq
isorakits¦oq	N	–up, –ut
isorart¦ooq	N	–uup, –uut
isorartoorsu¦aq	N	–up, –it
isorartunaa¦rpaa	V	–nngilaa
isorartune¦q	N	–rup, –rit
isorartussu¦seq	N	–tsip, –tsit
isorartu¦voq	V	–nngilaq
isorinni¦ppoq	V	–nngilaq
isorisassarsiorne¦q	N	–rup, –rit
isorl¦eq	N	–iup, –iit
isorlutaaqinaqaaq	V	(no generation)
isorlutaaqi¦voq	V	–nngilaq
isorluta¦k	N	–ap, –at
isorlutaki¦ppoq	V	–nngilaq
isorluta¦q	N	–p, –t
isorlutart¦ooq	N	–uup, –uut
isornaalluinnart¦oq	N	–up, –ut
isornaa¦ppoq	V	–nngilaq
isornaat	N	–ip, –it
isorna¦rpoq	V	–nngilaq
isornart¦oq	N	–up, –ut
isornartorsiorneqarne¦q	N	–rup, –rit
isornartorsiorneqa¦rpoq	V	–nngilaq
isornartorsi¦orpaa	V	–unngilaa
isornartorsiuine¦q	N	–rup, –rit
isornartorsiuis¦oq	N	–up, –ut
isornartorsiui¦voq	V	–nngilaq
isornartorsiungaa¦rpaa	V	–nngilaa
isornartorsiut	N	–ip, –it
isornartorsiuteqarne¦q	N	–rup, –rit
isorniannginne¦q	N	–rup, –rit
isornianngits¦oq	N	–up, –ut
is¦orpoq	V	–unngilaq
isorta¦q	N	–p, –t
isortikkiart¦orpoq	V	–unngilaq
isorti¦ppoq	V	–nngilaq
Isort¦oq	N	–up, –ut
Isort¦oq	Prop	–up
isort¦oq	N	–up, –ut
isortorsuu¦voq	V	–nngilaq
isortorsu¦uvoq	V	{–aanngilaq, –unngilaq}
isortuarsu¦k	N	–up, –it
israelikkut	N, pl.	-
Israel¦imiu	N	{–ermiup, –imiup}, {–ermiut, –imiut}
issaaja¦rpoq	V	–nngilaq
issaalla¦ppoq	V	–nngilaq
issaallaqattaa¦rpoq	V	–nngilaq
issaallattuinnaa¦voq	V	–nngilaq
issaanna¦q	N	–ap, –at
issaasa¦ppoq	V	–nngilaq
issaasassi¦voq	V	–nngilaq
issaasatsi¦ppoq	V	–nngilaq
issaasueru¦ppoq	V	–tinngilaq
issa¦gaq	N	–kkap, –kkat
issakajaarfi¦k	N	–up, –it
issakajaa¦rpoq	V	–nngilaq
issakajaarti¦ppaa	V	–nngilaa
issakajaat	N, pl.	-
issakatsiaarfi¦k	N	–up, –it
issakatsiaa¦rpoq	V	–nngilaq
issakatsiaarut	N	–ip, –it
issalersarpoq	V	(no generation)
issangerne¦q	N	–rup, –rit
issang¦erpoq	V	–inngilaq
issangersarpoq	V	(no generation)
issangersimaannal¦erpoq	V	–inngilaq
issangial¦erpoq	V	–inngilaq
issangi¦aq	N	–ssap, –ssat
issangiarpalla¦ppoq	V	–nngilaq
issangia¦rpallappoq	V	{–pallanngilaq, –rpallanngilaq}
issangiarpalu¦ppoq	V	–nngilaq
issangia¦rpoq	V	–nngilaq
issangiataa¦rpoq	V	–nngilaq
issangisserajussi¦voq	V	–nngilaq
issangiss¦erpoq	V	–inngilaq
issangissertaanna¦rpoq	V	–nngilaq
issanng¦orpoq	V	–unngilaq
issannguat¦orpoq	V	–unngilaq
issanngunaqaaq	V	(no generation)
issannguna¦rpoq	V	–nngilaq
issanngune¦q	N	–rup, –rit
issanngusarne¦q	N	–rup, –rit
issanngusa¦rpoq	V	–nngilaq
issannguu¦ppaa	V	–tinngilaa
issanngu¦voq	V	–nngilaq
issa¦q	N	–p, –t
issaralaanngu¦aq	N	–up, –it
issariarne¦q	N	–rup, –rit
issaria¦rpoq	V	–nngilaq
issarne¦q	N	–rup, –rit
issa¦rpaa	V	–nngilaa
issarpaluk	N	–up, –it
issarpalu¦k	N	–up, –it
issa¦rpoq	V	–nngilaq
issart¦oq	N	–up, –ut
issarus¦erpaa	V	–inngilaa
issaru¦serpaa	V	{–sinngilaa, –tilinngilaa}
issarut	N	–ip, –it
issat	N, pl.	-
isseerulluanngilaq	V	(no generation)
isseerutivi¦ppoq	V	–nngilaq
isse¦q	N	–rup, –rit
isseqarlua¦rpoq	V	–nngilaq
isseqa¦rpoq	V	–nngilaq
isser¦aa	V	–inngilaa
isserfi¦k	N	–up, –it
isseri¦voq	V	–nngilaq
iss¦erpaa	V	–inngilaa
iss¦erpoq	V	–inngilaq
issers¦orpoq	V	–unngilaq
issersu¦aq	N	–up, –it
issi	N	–p, –t
issiaa¦rpoq	V	–nngilaq
issiaat¦aq	N	{–ap, –tap}, {–at, –tat}
issiaatartaa¦rpoq	V	–nngilaq
issiaat¦serpaa	V	{–alinngilaa, –sinngilaa}
issiaatserpoq	V	(no generation)
issiaatsersorpoq	V	(no generation)
issiaava¦rpoq	V	–nngilaq
issiaffig¦aa	V	–inngilaa
issiaffi¦k	N	–up, –it
issiakata¦ppoq	V	–nngilaq
issiallaa¦ppaa	V	–tinngilaa
issiallannart¦oq	N	–up, –ut
issialla¦ppoq	V	–nngilaq
issiallatsi¦ppaa	V	–nngilaa
issiallua¦rpoq	V	–nngilaq
issianaqaaq	V	(no generation)
issiaqqissaa¦rpoq	V	–nngilaq
issiat¦erpoq	V	–inngilaq
issiavig¦aa	V	–inngilaa
issiaviit	N, pl.	-
issiavi¦k	N	–up, –it
issiavimmii¦ppoq	V	–nngilaq
issiavissaarsu¦aq	N	–up, –it
issiavissaqarti¦ppaa	V	–nngilaa
issiavissi¦voq	V	–nngilaq
issiavissu¦aq	N	–up, –it
issiavittaa¦rpoq	V	–nngilaq
issia¦voq	V	–nngilaq
issiffari¦ppoq	V	–nngilaq
issiffarissaa¦rpoq	V	–nngilaq
issiffarlu¦ppoq	V	–nngilaq
issiffa¦seq	N	–tsip, –tsit
issiffatig¦aa	V	–inngilaa
issiia¦rpaa	V	–nngilaa
issi¦iarpaa	V	{–ajanngilaa, –ianngilaa}
issi¦k	N	{–ngup, –up}, {–it, –ngit}
issikilliart¦orpoq	V	–unngilaq
issikilli¦voq	V	–nngilaq
issikinaa¦rpaa	V	–nngilaa
issiki¦ppoq	V	–nngilaq
issikkunnaa¦rpoq	V	–nngilaq
issil¦erpoq	V	–inngilaq
issillua¦rpoq	V	–nngilaq
issimavoq	V	(no generation)
issinga¦voq	V	–nngilaq
issing¦erpaa	V	–inngilaa
issingersit	N	–ip, –it
issingigaa¦voq	V	–nngilaq
issingi¦gaq	N	–kkap, –kkat
issingigassassat	N, pl.	-
issingigassat	N, pl.	-
issing¦iivoq	V	{–ersinngilaq, –iinngilaq}
issingu¦voq	V	–nngilaq
issinna¦rpaa	V	–nngilaa
issinne¦q	N	–rup, –rit
issinnerit	N, pl.	-
issinngu¦voq	V	–nngilaq
issipi¦ppoq	V	–nngilaq
issippallaanngilaq	V	(no generation)
issippallaaqaaq	V	(no generation)
issi¦ppoq	V	–nngilaq
issisiornaqaaq	V	(no generation)
issisiornarunnaarpoq	V	(no generation)
issisi¦orpoq	V	–unngilaq
issisiut	N	–ip, –it
issisiutaa¦voq	V	–nngilaq
ississusiugajunnerusart¦oq	N	–up, –ut
issit¦ooq	N	–uup, –uut
issit¦oorpoq	V	–uunngilaq
issitoorsu¦aq	N	–up, –it
issitoorsu¦uvoq	V	{–aanngilaq, –unngilaq}
Issitt¦oq	N	–up, –ut
Issitt¦oq	Prop	–up
issitt¦oq	N	–up, –ut
issittoqarfi¦k	N	–up, –it
Issittormiu	N	–p, –t
issittormiut	N, pl.	-
issittorsu¦aq	N	–up, –it
Issittup qullii	Prop	–p
issittut	N, pl.	-
issitukuluppoq	V	(no generation)
issitunersaat	N	–ip, –it
issitu¦voq	V	–nngilaq
issiut	N	–ip, –it
issiut	N, pl.	-
issiutaa¦rpaa	V	–nngilaa
issi¦vaa	V	–nngilaa
issivi¦k	N	–up, –it
issi¦voq	V	–nngilaq
iss¦oq	N	–up, –ut
issoqqaari¦ppoq	V	–nngilaq
issoqqaariss¦oq	N	–up, –ut
issoqqaari¦ssoq	N	{–ssup, –ttup}, {–ssut, –ttut}
issoqqaa¦voq	V	–nngilaq
issoqqa¦k	N	–ap, –at
issoqqa¦q	N	–p, –t
issoqqassu¦aq	N	–up, –it
isso¦qqerpaa	V	{–qqinngilaa, –ralinngilaa}
issoqqerpoq	V	(no generation)
isso¦qqersorpaa	V	{–qqersunngilaa, –ralersunngilaa}
issoqqiu¦ppaa	V	–tinngilaa
isso¦qqiuppaa	V	{–qqiutinngilaa, –raliutinngilaa}
issoraaja¦rpoq	V	–nngilaq
issoraa¦voq	V	–nngilaq
issoraki¦ppoq	V	–nngilaq
isso¦raq	N	–qqap, –qqat
issorarpoq	V	(no generation)
issorarsima¦voq	V	–nngilaq
issorartaa¦rpoq	V	–nngilaq
issorartarfi¦k	N	–up, –it
issoravi¦ppoq	V	–nngilaq
issormiuta¦q	N	–p, –t
issornikoqarfi¦k	N	–up, –it
iss¦orpoq	V	–unngilaq
issorraju¦k	N	–up, –it
issorsimas¦oq	N	–up, –ut
issorsima¦voq	V	–nngilaq
issorsiut	N	–ip, –it
issorsunni¦ppoq	V	–nngilaq
issortaat	N	–ip, –it
issortaat	N, pl.	-
issorta¦q	N	–p, –t
issorta¦rpoq	V	–nngilaq
issorti¦ppaa	V	–nngilaa
issorti¦ppoq	V	–nngilaq
issortita¦q	N	–p, –t
issortitsissut	N	–ip, –it
issortitsissutissat	N, pl.	-
issuaaginnarne¦q	N	–rup, –rit
issu¦aaginnarneq	N	{–aaginnarnerup, –jaaginnarnerup}, {–aaginnarnerit, –jaaginnarnerit}
issu¦aaginnarneq	N	{–aaginnarnerup, –uinnarnerup}, {–aaginnarnerit, –uinnarnerit}
issuaajumat¦ooq	N	–uup, –uut
issu¦aajumatooq	N	{–aajumatuup, –ujumatuup}, {–aajumatuut, –ujumatuut}
issuaane¦q	N	–rup, –rit
issu¦aaneq	N	{–aanerup, –unerup}, {–aanerit, –unerit}
issuaaqqusinnginne¦q	N	–rup, –rit
iss¦uaaqqusinnginneq	N	{–ooqqusinnginnerup, –uaaqqusinnginnerup}, {–ooqqusinnginnerit, –uaaqqusinnginnerit}
issuaasi¦orpoq	V	–unngilaq
issuaa¦siorpoq	V	{–siunngilaq, –tiliunngilaq}
issuaat	N	–ip, –it
issuaa¦voq	V	–nngilaq
issu¦aavoq	V	{–aanngilaq, –unngilaq}
issua¦gaq	N	–kkap, –kkat
issuagassa¦q	N	–p, –t
issuakkat	N, pl.	-
issuallaaqaaq	V	(no generation)
issu¦aq	N	–up, –it
issua¦rpaa	V	–nngilaa
issua¦rpoq	V	–nngilaq
issuatsia¦q	N	–ap, –at
issuatsi¦aq	N	–up, –it
issugiu¦ppaa	V	–tinngilaa
issugiussaa¦voq	V	–nngilaq
issuia¦gaq	N	–kkap, –kkat
issu¦iagaq	N	{–ajakkap, –iakkap}, {–ajakkat, –iakkat}
issui¦ppoq	V	–nngilaq
issuis¦orpoq	V	–unngilaq
issuit	N, pl.	-
issujaarsu¦aq	N	–up, –it
issu¦k	N	–up, –it
issulaa¦rpoq	V	–nngilaq
issulaartitsi¦voq	V	–nngilaq
issulaartuinnaa¦voq	V	–nngilaq
issulaar¦tuinnaavoq	V	{–tuinnaanngilaq, –suinnaanngilaq}
issulersuine¦q	N	–rup, –rit
issul¦ik	N	{–iup, –lip, –lup}, –lit
issulikkunnaa¦rpoq	V	–nngilaq
issuli¦ppoq	V	–nngilaq
issulittaat	N	–ip, –it
issuli¦ttaat	N	{–ssaatip, –ttaatip}, {–ssaatit, –ttaatit}
issulitta¦rpoq	V	–nngilaq
issullua¦rpaa	V	–nngilaa
issum¦eerpaa	V	–iinngilaa
issuni¦ppoq	V	–nngilaq
issunngilaq	V	(no generation)
issunngoriart¦orpoq	V	–unngilaq
issunng¦orpoq	V	–unngilaq
issu¦ppaa	V	–nngilaa
issu¦ppoq	V	–nngilaq
issus¦ooq	N	–uup, –uut
issu¦sooq	N	{–suup, –tuup}, {–suut, –tuut}
issussat	N, pl.	-
issussi¦voq	V	–nngilaq
issu¦ssivoq	V	{–ssinngilaq, –tsinngilaq}
issutaasat	N, pl.	-
issuta¦q	N	–p, –t
issutassaaleqi¦voq	V	–nngilaq
issutit	N, pl.	-
issutsi¦ppoq	V	–nngilaq
issutsi¦ssaat	N	{–ssaatip, –ttaatip}, {–ssaatit, –ttaatit}
issuttaa¦rpoq	V	–nngilaq
issutta¦gaq	N	–kkap, –kkat
issuttaqattaa¦rpaa	V	–nngilaa
issutt¦orpaa	V	–unngilaa
issutt¦orpoq	V	–unngilaq
issuttuu¦ppaa	V	–tinngilaa
issuuma¦voq	V	–nngilaq
issuusa¦q	N	–p, –t
issu¦voq	V	–nngilaq
isu	N	–p, –t
isualaa¦rpoq	V	–nngilaq
isuanii¦ppoq	V	–nngilaq
isuanne¦q	N	–rup, –rit
isua¦rpoq	V	–nngilaq
isugutaa¦ppoq	V	–nngilaq
isugutaars¦erpaa	V	–inngilaa
isugutaars¦erpoq	V	–inngilaq
isugutaarukkiart¦orpoq	V	–unngilaq
isugutaaru¦ppoq	V	–tinngilaq
isugutaavi¦ppoq	V	–nngilaq
isuguta¦k	N	–ap, –at
isugutalaa¦rpoq	V	–nngilaq
isugutalaavi¦ppoq	V	–nngilaq
isugutana¦rpoq	V	–nngilaq
isugutane¦q	N	–rup, –rit
isuguta¦ppoq	V	–nngilaq
isugutas¦oq	N	–up, –ut
isugutassu¦aq	N	–up, –it
isugutattorsuu¦voq	V	–nngilaq
isugutattorsu¦uvoq	V	{–aanngilaq, –unngilaq}
isuguta¦voq	V	–nngilaq
isugutserne¦q	N	–rup, –rit
isuguts¦erpoq	V	–inngilaq
isugutsiu¦ppoq	V	–tinngilaq
isuguttaa¦ppaa	V	–tinngilaa
isuguttarnaveeqqut	N	–ip, –it
isugutta¦rpoq	V	–nngilaq
isuguttarsa¦rpaa	V	–nngilaa
isuguttart¦erpaa	V	–inngilaa
isuguttarti¦ppaa	V	–nngilaa
isui¦ppoq	V	–nngilaq
isui¦ssoq	N	{–ssup, –ttup}, {–ssut, –ttut}
isuits¦oq	N	–up, –ut
isuitsuu¦voq	V	–nngilaq
isukkaarti¦ppaa	V	–nngilaa
isukkarlua¦rpoq	V	–nngilaq
isukka¦rpaa	V	–nngilaa
isukka¦rpoq	V	–nngilaq
isukkarti¦ppaa	V	–nngilaa
isuli¦ppoq	V	–nngilaq
isull¦eq	N	–iup, –iit
isullu¦k	N	–up, –it
isulluttaa¦rpoq	V	–nngilaq
isum¦a	N	{–ap, –map}, {–at, –mat}
isumaakkunnaa¦rpoq	V	–nngilaq
isumaalliorne¦q	N	–rup, –rit
isumaalli¦orpoq	V	–unngilaq
isumaalug¦aa	V	–inngilaa
isumaalukkajuppoq	V	(no generation)
isumaalunna¦rpoq	V	–nngilaq
isumaalunnart¦oq	N	–up, –ut
isumaaluppallaaqaaq	V	(no generation)
isumaalu¦ppoq	V	–nngilaq
isumaannaagallart¦oq	N	–up, –ut
isumaa¦ppoq	V	–nngilaq
isumaarukkiart¦orpoq	V	–unngilaq
isumaaru¦ppoq	V	–tinngilaq
isumaarussinnaanngilaq	V	(no generation)
isumaassu¦seq	N	–tsip, –tsit
isumaats¦oorpoq	V	–uunngilaq
isumag¦aa	V	–inngilaa
isumagineqarne¦q	N	–rup, –rit
isumaginniffi¦k	N	–up, –it
isumaginninne¦q	N	–rup, –rit
Isumaginninnermik Suliaqarnermi Immikkoortorta¦q	Prop	–p
isumaginni¦ppoq	V	–nngilaq
isumaginnitt¦oq	N	–up, –ut
Isumaginnittoqarfi¦k	N	–up, –it
isumaginnittoqarfi¦k	N	–up, –it
isumaginnittussaane¦q	N	–rup, –rit
isumagi¦ppoq	V	–nngilaq
isumagisassa¦q	N	–p, –t
isumagissaa¦rpoq	V	–nngilaq
isumagissi¦voq	V	–nngilaq
isumagi¦ssoq	N	{–ssup, –ttup}, {–ssut, –ttut}
isumagiunnaa¦rpaa	V	–nngilaa
isumakilli¦orpoq	V	–unngilaq
isumaki¦ppoq	V	–nngilaq
isumakits¦oq	N	–up, –ut
isumakkeerfig¦aa	V	–inngilaa
isumakkeerfiginninne¦q	N	–rup, –rit
isumakkeerinninne¦q	N	–rup, –rit
isumakk¦eerpaa	V	–iinngilaa
isumakkeersinnaanngilaa	V	(no generation)
isumakkerfig¦aa	V	–inngilaa
isumakk¦erpoq	V	–inngilaq
isumakkiigassanngorti¦ppaa	V	–nngilaa
isumakkiiginna¦gaq	N	–kkap, –kkat
isumakkiiginna¦rpaa	V	–nngilaa
isumakkiss¦erpoq	V	–inngilaq
isumakkissiu¦ppaa	V	–tinngilaa
isumakull¦erpoq	V	–inngilaq
isumakulliu¦ppaa	V	–tinngilaa
isumakuluppoq	V	(no generation)
isumakuluttaanna¦rpoq	V	–nngilaq
isumakuluut	N	–ip, –it
isumakuluut	N, pl.	-
isumakuluuteqarne¦q	N	–rup, –rit
isumakuluuteqa¦rpoq	V	–nngilaq
isumaleris¦oq	N	–up, –ut
isumalerit¦ooq	N	–uup, –uut
isum¦alerpoq	V	{–alinngilaq, –minngilaq}
isumalersuiui¦ppoq	V	–nngilaq
isumaler¦suiuippoq	V	{–suiuinngilaq, –tuiuinngilaq}
isumalersui¦voq	V	–nngilaq
isumal¦ik	N	{–iup, –lip, –lup}, –lit
isumalioqatigiissita¦q	N	–p, –t
isumalioqatigiissitat	N, pl.	-
isumalioqatigii¦ssitat	N, pl.	{–ssitat, –tsitat}
isumalioqqissaarne¦q	N	–rup, –rit
isumalioqqissaa¦rpoq	V	–nngilaq
isumalioqqutig¦aa	V	–inngilaa
isumaliorajuppoq	V	(no generation)
isumali¦orpoq	V	–unngilaq
isumaliortaa¦seq	N	–tsip, –tsit
isumaliorulunne¦q	N	–rup, –rit
isumaliu¦t	N	{–tip, –utip}, {–tit, –utit}
isumaliu¦taavoq	V	{–taanngilaq, –utaanngilaq}
isumaliuter¦suutit	N, pl.	{–suutit, –tuutit}
isumaliu¦tigaa	V	{–tiginngilaa, –utiginngilaa}
isumaliu¦tigeqqippaa	V	{–tigeqqinngilaa, –utigeqqinngilaa}
isumaliu¦tiginnilluaqqaartartoq	N	{–tiginnilluaqqaartartup, –utiginnilluaqqaartartup}, {–tiginnilluaqqaartartut, –utiginnilluaqqaartartut}
isumaliu¦tiginninneq	N	{–tiginninnerup, –utiginninnerup}, {–tiginninnerit, –utiginninnerit}
isumaliutissiissut	N	–ip, –it
isumaliu¦tissiissut	N	{–tissaliissutip, –tissiissutip, –utissaliissutip, –utissiissutip}, {–tissaliissutit, –tissiissutit, –utissaliissutit, –utissiissutit}
isumaliutissi¦ppaa	V	–nngilaa
isumaliu¦tissippaa	V	{–tissinngilaa, –utissinngilaa}
isumaliuutersuut	N	–ip, –it
isumaliu¦utigaa	V	{–tiginngilaa, –utiginngilaa}
isumalli¦orpoq	V	–unngilaq
isumalluanngits¦oq	N	–up, –ut
isumalluarfig¦aa	V	–inngilaa
isumalluarne¦q	N	–rup, –rit
isumallua¦rpoq	V	–nngilaq
isumalluart¦oq	N	–up, –ut
isumalluus¦erpoq	V	–inngilaq
isumalluu¦serpoq	V	{–sinngilaq, –tilinngilaq}
isumalluusia¦q	N	–p, –t
isumalluu¦siaq	N	{–siap, –tiliap}, {–siat, –tiliat}
isumalluut	N	–ip, –it
isumalluutig¦aa	V	–inngilaa
isumaluffig¦aa	V	–inngilaa
isumalu¦ppoq	V	–nngilaq
isumalutt¦oq	N	–up, –ut
isumaluttorsu¦aq	N	–up, –it
isumaluutig¦aa	V	–inngilaa
isumamineeri¦voq	V	–nngilaq
isumamin¦eerpaa	V	–iinngilaa
isumamin¦eerpoq	V	–iinngilaq
isum¦amineerpoq	V	{–aminiinngilaq, –amininngaanniinngilaq, –maminiinngilaq, –mamininngaanniinngilaq}
isumamineers¦oq	N	–up, –ut
isumamineer¦soq	N	{–sup, –tup}, {–sut, –tut}
isum¦amineersoq	N	{–amineersup, –amineertup, –amininngaanneersup, –amininngaanneertup, –mamineersup, –mamineertup, –mamininngaanneersup, –mamininngaanneertup}, {–amineersut, –amineertut, –amininngaanneersut, –amininngaanneertut, –mamineersut, –mamineertut, –mamininngaanneersut, –mamininngaanneertut}
isumanerluffig¦aa	V	–inngilaa
isumanerlul¦erpoq	V	–inngilaq
isumanerlunne¦q	N	–rup, –rit
isumanerlu¦ppoq	V	–nngilaq
isumanerluttarne¦q	N	–rup, –rit
isumanerluttart¦oq	N	–up, –ut
isumanerlutt¦oq	N	–up, –ut
isumanerluutig¦aa	V	–inngilaa
isumannaaja¦rpaa	V	–nngilaa
isumannaallisaane¦q	N	–rup, –rit
isumannaallisaasut	N, pl.	-
isumannaallisaat	N	–ip, –it
isumannaallisaatiss¦iineq	N	{–aliinerup, –iinerup}, {–aliinerit, –iinerit}
isumannaallisa¦rpaa	V	–nngilaa
isumannaa¦ppoq	V	–nngilaq
isumannaarfig¦aa	V	–inngilaa
isumannaarine¦q	N	–rup, –rit
isumannaa¦rpaa	V	–nngilaa
isumannaarsarpaa	V	(no generation)
isumannaarut	N	–ip, –it
isumannaassu¦seq	N	–tsip, –tsit
isumannaats¦oq	N	–up, –ut
isumannaatsuune¦q	N	–rup, –rit
isumannanngissu¦seq	N	–tsip, –tsit
isumannanngits¦oq	N	–up, –ut
isumanna¦rpoq	V	–nngilaq
isumannarsi¦voq	V	–nngilaq
isumannarunnaa¦rpoq	V	–nngilaq
isumapiloqarfigigaluarsimavaa	V	(no generation)
isumapilul¦ik	N	{–iup, –lip, –lup}, –lit
isumapilu¦ppoq	V	–nngilaq
isumaqalertippoq	V	(no generation)
isumaqalerunnarsivoq	V	(no generation)
isumaqanngilluinnart¦oq	N	–up, –ut
isumaqanngissu¦seq	N	–tsip, –tsit
isumaqanngits¦oq	N	–up, –ut
isumaqanngitsuusaart¦oq	N	–up, –ut
isumaqaqqajaasa¦rpoq	V	–nngilaq
isumaqarfig¦aa	V	–inngilaa
isumaqarluart¦oq	N	–up, –ut
isumaqarne¦q	N	–rup, –rit
isumaqa¦rpoq	V	–nngilaq
isumaqarti¦ppaa	V	–nngilaa
isumaqartita¦q	N	–p, –t
isumaqartitsis¦oq	N	–up, –ut
isumaqart¦oq	N	–up, –ut
isumaqat	N	–ip, –it
isumaqataane¦q	N	–rup, –rit
isumaqataanngits¦oq	N	–up, –ut
isumaqataas¦oq	N	–up, –ut
isumaqataa¦voq	V	–nngilaq
isumaqatig¦aa	V	–inngilaa
isumaqatigiikkunnaarne¦q	N	–rup, –rit
isumaqatigiilerne¦q	N	–rup, –rit
isumaqatigiinne¦q	N	–rup, –rit
isumaqatigiinnginne¦q	N	–rup, –rit
isumaqatigiinngissut	N	–ip, –it
isumaqatigiinngissutigineqart¦oq	N	–up, –ut
isumaqatigiinniaqateqarne¦q	N	–rup, –rit
isumaqatigiinniarne¦q	N	–rup, –rit
isumaqatigiinniartuusaarne¦q	N	–rup, –rit
isumaqatigiinniuteqarne¦q	N	–rup, –rit
isumaqatigiinniuteqarniarne¦q	N	–rup, –rit
isumaqatigiinniutig¦aa	V	–inngilaa
isumaqatigiissaane¦q	N	–rup, –rit
isumaqatigiissitsiniaasarfi¦k	N	–up, –it
isumaqatigii¦ssitsiniaasarfik	N	{–ssitsiniaasarfiup, –tsitsiniaasarfiup}, {–ssitsiniaasarfiit, –tsitsiniaasarfiit}
isumaqatigiissitsiniarne¦q	N	–rup, –rit
isumaqatigii¦ssitsiniarneq	N	{–ssitsiniarnerup, –tsitsiniarnerup}, {–ssitsiniarnerit, –tsitsiniarnerit}
isumaqatigiissitsiniartarfi¦k	N	–up, –it
isumaqatigii¦ssitsiniartarfik	N	{–ssitsiniartarfiup, –tsitsiniartarfiup}, {–ssitsiniartarfiit, –tsitsiniartarfiit}
isumaqatigiissitsiniartart¦oq	N	–up, –ut
isumaqatigii¦ssitsiniartartoq	N	{–ssitsiniartartup, –tsitsiniartartup}, {–ssitsiniartartut, –tsitsiniartartut}
isumaqatigiissitsiniart¦oq	N	–up, –ut
isumaqatigii¦ssitsiniartoq	N	{–ssitsiniartup, –tsitsiniartup}, {–ssitsiniartut, –tsitsiniartut}
isumaqatigiissitsiniartuu¦voq	V	–nngilaq
isumaqatigii¦ssitsiniartuuvoq	V	{–ssitsiniartuunngilaq, –tsitsiniartuunngilaq}
isumaqatigiissitsi¦voq	V	–nngilaq
isumaqatigii¦ssut	N	{–ssut, –ttut, –ssutip}, –ssutit
isumaqatigiissutaas¦oq	N	–up, –ut
isumaqatigiissuteqaqataas¦oq	N	–up, –ut
isumaqatigiissuteqarne¦q	N	–rup, –rit
isumaqatigiissuteqa¦rpoq	V	–nngilaq
isumaqatigiissuteqartaa¦seq	N	–tsip, –tsit
isumaqatigiissutig¦aa	V	–inngilaa
isumaqatigiissutit	N, pl.	-
isumaqatigillua¦rpaa	V	–nngilaa
isumaqatiginninniarne¦q	N	–rup, –rit
isumaqatiginninniarnerit	N, pl.	-
isumaqatiginninniartarfi¦k	N	–up, –it
isumaqatiginninniavinne¦q	N	–rup, –rit
isumaqatissarsiorne¦q	N	–rup, –rit
isumaqatissarsi¦orpoq	V	–unngilaq
isumaqatissarsiortart¦oq	N	–up, –ut
isumaqatissarsiortartut	N, pl.	-
isumaqatissarsiort¦oq	N	–up, –ut
isumarujunne¦q	N	–rup, –rit
isumaruju¦ppoq	V	–nngilaq
isumarujuttarne¦q	N	–rup, –rit
isumarujutt¦oq	N	–up, –ut
isumasioqatigiinne¦q	N	–rup, –rit
isumasi¦orpaa	V	–unngilaa
isumasiuine¦q	N	–rup, –rit
isumasiu¦ipallanneq	N	{–erpallannerup, –ipallannerup}, {–erpallannerit, –ipallannerit}
isumasiuut	N	–ip, –it
isumasi¦vaa	V	–nngilaa
isumasi¦voq	V	–nngilaq
isumassaaleqis¦oq	N	–up, –ut
isumassaaru¦ppoq	V	–tinngilaq
isumassaasuane¦q	N	–rup, –rit
isumassaavallaaqaaq	V	(no generation)
isumassaa¦voq	V	–nngilaq
isumassa¦q	N	–p, –t
isumassarseriallaqqi¦ssoq	N	{–ssup, –ttup}, {–ssut, –ttut}
isumassarseriataartart¦oq	N	–up, –ut
isumassarseria¦taartartoq	N	{–saartartup, –taartartup}, {–saartartut, –taartartut}
isumassarsia¦q	N	–p, –t
isumassarsiar¦aa	V	–inngilaa
isumassarsiatsiala¦k	N	–ap, –at
isumassarsioqatigiinne¦q	N	–rup, –rit
isumassarsiorfig¦aa	V	–inngilaa
isumassarsiorfi¦k	N	–up, –it
isumassarsiorne¦q	N	–rup, –rit
isumassarsi¦orpoq	V	–unngilaq
isumassarsiorsinnaassu¦seq	N	–tsip, –tsit
isumassarsisinnaane¦q	N	–rup, –rit
isumassarsisitaane¦q	N	–rup, –rit
isumassarsisitsis¦oq	N	–up, –ut
isumassarsi¦voq	V	–nngilaq
isumass¦orpaa	V	–unngilaa
isumassuiffi¦k	N	–up, –it
isumassuine¦q	N	–rup, –rit
isumassuingaarne¦q	N	–rup, –rit
isumassuis¦oq	N	–up, –ut
isumassuut	N	–ip, –it
isumataarne¦q	N	–rup, –rit
isumataa¦rpoq	V	–nngilaq
isumat¦ooq	N	–uup, –uut
isumatsangaalersi¦ppaa	V	–nngilaa
isumatsanne¦q	N	–rup, –rit
isumatsa¦ppoq	V	–nngilaq
isumatsassimangaarne¦q	N	–rup, –rit
isumatsassimas¦oq	N	–up, –ut
isumatsia¦rpoq	V	–nngilaq
isumatusaarne¦q	N	–rup, –rit
isumatusaa¦rpoq	V	–nngilaq
isumatusaart¦oq	N	–up, –ut
isumatu¦voq	V	–nngilaq
isuma¦voq	V	–nngilaq
isumma¦ppaa	V	–nngilaa
isummeqatig¦aa	V	–inngilaa
isummeqatigiinne¦q	N	–rup, –rit
isummereersimane¦q	N	–rup, –rit
isummerfig¦aa	V	–inngilaa
isummerne¦q	N	–rup, –rit
isumm¦erpaa	V	–inngilaa
isumm¦erpoq	V	–inngilaq
isummersoqatigiiffi¦k	N	–up, –it
isummer¦soqatigiiffik	N	{–soqatigiiffiup, –toqatigiiffiup}, {–soqatigiiffiit, –toqatigiiffiit}
isummersoqatigiinne¦q	N	–rup, –rit
isummer¦soqatigiinneq	N	{–soqatigiinnerup, –toqatigiinnerup}, {–soqatigiinnerit, –toqatigiinnerit}
isummersorne¦q	N	–rup, –rit
isummers¦orpaa	V	–unngilaa
isummers¦orpoq	V	–unngilaq
isummersortarne¦q	N	–rup, –rit
isummersuine¦q	N	–rup, –rit
isummersui¦voq	V	–nngilaq
isummersuut	N	–ip, –it
isummer¦suut	N	{–suutip, –tuutip}, {–suutit, –tuutit}
isummert¦oq	N	–up, –ut
isummer¦toq	N	{–sup, –tup}, {–sut, –tut}
isummiussa¦q	N	–p, –t
isummiusseriinnginne¦q	N	–rup, –rit
isummiusseriinngits¦oq	N	–up, –ut
isummiut	N	–ip, –it
isunngallua¦rpoq	V	–nngilaq
isunnga¦q	N	–p, –t
isunngarsu¦aq	N	–up, –it
isunngarujussu¦aq	N	–up, –it
isunnga¦voq	V	–nngilaq
isusissaanngilaq	V	(no generation)
isusissaanngits¦oq	N	–up, –ut
isusissaa¦voq	V	–nngilaq
isusi¦vaa	V	–nngilaa
isuss¦orpaa	V	–unngilaa
isuss¦orpoq	V	–unngilaq
isussualu¦ppoq	V	–nngilaq
isussuffig¦aa	V	–inngilaa
isussukuluppoq	V	(no generation)
isussu¦ppoq	V	–nngilaq
isussuu¦ppaa	V	–tinngilaa
isussuussis¦oq	N	–up, –ut
isussuut	N	–ip, –it
isussuutig¦aa	V	–inngilaa
isuts¦erpaa	V	–inngilaa
IT-qarfi¦k	N	–up, –it
itakassa¦k	N	–ap, –at
itala¦k	N	–ap, –at
itala¦ppaa	V	–nngilaa
itala¦ppoq	V	–nngilaq
it¦eerpaa	V	–iinngilaa
iteerulluinna¦rpoq	V	–nngilaq
iteerullu¦innarpoq	V	{–innanngilaq, –aannanngilaq}
iteeru¦ppoq	V	–tinngilaq
iteerutivi¦ppoq	V	–nngilaq
iteq	N	{eqqup, itip}, {eqqit, itit}
iteqqaanniuu	N	–p, –t
iteqqaanni¦voq	V	–nngilaq
iteqqaarluusi¦orpoq	V	–unngilaq
iteqqaarluu¦siorpoq	V	{–siunngilaq, –tiliunngilaq}
iteqqaarluut	N	–ip, –it
iteqqaas¦erpaa	V	–inngilaa
iteqqaa¦serpaa	V	{–sinngilaa, –tilinngilaa}
iteqqaas¦erpoq	V	–inngilaq
iteqqaa¦serpoq	V	{–sinngilaq, –tilinngilaq}
iteqqaat	N	–ip, –it
iteqqili¦vaa	V	–nngilaa
iteqqi¦ppaa	V	–nngilaa
iteqqi¦ppoq	V	–nngilaq
iteqqisaa¦rpoq	V	–nngilaq
iteqqisi¦ppaa	V	–nngilaa
iteriallus¦ooq	N	–uup, –uut
iteriallu¦sooq	N	{–suup, –tuup}, {–suut, –tuut}
iteriallu¦voq	V	–nngilaq
iteria¦rpoq	V	–nngilaq
iterlaama¦neq	N	{–nerup, –rnup}, {–nerit, –rnit}
iterla¦k	N	–ap, –at
iterlassu¦aq	N	–up, –it
iterlua¦rpoq	V	–nngilaq
iternerlu¦ppoq	V	–nngilaq
ite¦roq	N	–qqup, –qqut
iterorni¦ppoq	V	–nngilaq
iter¦orpoq	V	–unngilaq
iterortitsi¦voq	V	–nngilaq
it¦erpoq	V	–inngilaq
itersaama¦neq	N	{–nerup, –rnup}, {–nerit, –rnit}
itersaa¦voq	V	–nngilaq
itersalia¦q	N	–p, –t
itersali¦orpaa	V	–unngilaa
itersali¦orpoq	V	–unngilaq
itersa¦q	N	–p, –t
itersa¦rpaa	V	–nngilaa
itersarsu¦aq	N	–up, –it
itersart¦ooq	N	–uup, –uut
itersarua¦q	N	–p, –t
itersarua¦rpoq	V	–nngilaq
itersaruart¦ooq	N	–uup, –uut
iters¦erpaa	V	{–alinngilaa, –inngilaa}
iters¦erpaa	V	–inngilaa
iters¦erpoq	V	–inngilaq
iters¦ersorpaa	V	{–alersunngilaa, –ersunngilaa}
itersine¦q	N	–rup, –rit
itersiut	N	–ip, –it
itersiut	N, pl.	-
itersi¦vaa	V	–nngilaa
itersi¦voq	V	–nngilaq
iters¦orpoq	V	–unngilaq
iter¦sorpoq	V	{–sunngilaq, –tunngilaq}
iterti¦ppaa	V	–nngilaa
iteruinnarsuu¦voq	V	–nngilaq
iteruinnarsu¦uvoq	V	{–aanngilaq, –unngilaq}
iteruusivi¦k	N	–up, –it
iteruut	N	–ip, –it
itiaallu¦sooq	N	{–suup, –tuup}, {–suut, –tuut}
itiaallu¦voq	V	–nngilaq
itiaa¦rpoq	V	–nngilaq
itiga¦rpaa	V	–nngilaa
itiga¦rpoq	V	–nngilaq
itigarti¦ppaa	V	–nngilaa
itigartitaa¦voq	V	–nngilaq
itigartitsine¦q	N	–rup, –rit
itigartitsi¦voq	V	–nngilaq
itikilla¦k	N	–ap, –at
itikkaa¦voq	V	{–junngilaq, –nngilaq}
itikkaa¦voq	V	–nngilaq
itikkajaanngu¦aq	N	–up, –it
itikkajaa¦q	N	–p, –t
itikkajaarsu¦aq	N	–up, –it
itikkajaa¦voq	V	–nngilaq
itikkanga¦voq	V	–nngilaq
itileriallarpoq	V	(no generation)
Itill¦eq	N	–ip, –it
Itill¦eq	Prop	–ip
itill¦eq	N	–ip, –it
Itillermiu	N	–p, –t
itilliatsia¦q	N	–ap, –at
itilliatsi¦aq	N	–up, –it
itilligu¦ppoq	V	–nngilaq
itillingaasa¦rpoq	V	–nngilaq
itillingana¦rpoq	V	–nngilaq
itillingas¦oq	N	–up, –ut
itillinne¦q	N	–rup, –rit
itillioru¦ppoq	V	–nngilaq
itilli¦ppoq	V	–nngilaq
itillisi¦ppaa	V	–nngilaa
itilli¦ttarneq	N	{–ssarnerup, –ttarnerup}, {–ssarnerit, –ttarnerit}
itillitt¦oq	N	–up, –ut
itilli¦ttoq	N	{–ssup, –ttup}, {–ssut, –ttut}
itilliut	N	–ip, –it
itilli¦voq	V	–nngilaq
it¦ilunneq	N	{–erlunnerup, –ilunnerup}, {–erlunnerit, –ilunnerit}
itine¦q	N	–rup, –rit
it¦ineq	N	{–ernup, –inerup}, {–ernit, –inerit}
itinermii¦ppoq	V	–nngilaq
itinersi¦orpoq	V	–unngilaq
itinersiut	N	–ip, –it
itinersu¦aq	N	–up, –it
itinne¦q	N	–rup, –rit
itinneraaqaaq	V	(no generation)
itinneraa¦rpoq	V	–nngilaq
itinnert¦ooq	N	–uup, –uut
itinngug¦aa	V	–inngilaa
itinngunaqaaq	V	(no generation)
itinnguna¦rpoq	V	–nngilaq
itinnguu¦ppaa	V	–tinngilaa
itinngu¦voq	V	–nngilaq
itinni¦ppoq	V	–nngilaq
itisilerine¦q	N	–rup, –rit
itisil¦erpaa	V	–inngilaa
itisiliine¦q	N	–rup, –rit
itisioru¦ppoq	V	–nngilaq
itisisi¦ppaa	V	–nngilaa
itisi¦vaa	V	–nngilaa
itisi¦voq	V	–nngilaq
itis¦ooq	N	–uup, –uut
itisoormiu	N	–p, –t
itisoorsiut	N	–ip, –it
itisoorujussu¦aq	N	–up, –it
itisoorujussu¦uvoq	V	{–aanngilaq, –unngilaq}
itis¦oq	N	–up, –ut
itisorsiut	N	–ip, –it
itissaa¦q	N	–p, –t
itissa¦aq	V	–nngilaq
itissutig¦aa	V	–inngilaa
itiutig¦aa	V	–inngilaa
itivallaalersima¦voq	V	–nngilaq
itivi	N	–p, –t
itivigi¦aq	N	–ssap, –ssat
itivi¦ppaa	V	–nngilaa
itivi¦ppoq	V	–nngilaq
itivittarfi¦k	N	–up, –it
itivi¦ttarfik	N	{–ssarfiup, –ttarfiup}, {–ssarfiit, –ttarfiit}
itivittaria¦q	N	–p, –t
itivittari¦aq	N	{–ssap, –ap}, {–ssat, –at}
iti¦voq	V	–nngilaq
itoqqi¦ppoq	V	–nngilaq
itoqqisi¦ppaa	V	–nngilaa
itsaa¦rpoq	V	–nngilaq
itsakkajaa¦q	N	–p, –t
itsanng¦orpoq	V	–unngilaq
itsa¦q	N	–p, –t
itsarni¦saq	N	–tsap, –tsat
itsarnisarsi¦ooq	N	–uup, –uut
itsarnisarsiorne¦q	N	–rup, –rit
itsarnisarsu¦aq	N	–up, –it
itsarnitsat	N, pl.	-
itsarsu¦aq	N	–up, –it
itsarsuarni¦saq	N	–tsap, –tsat
itsat	N, pl.	-
itsiaarsaassi¦voq	V	–nngilaq
itsi¦k	N	{–ngup, –up}, {–it, –ngit}
itsikk¦oq	N	–up, –ut
itsinaqaaq	V	(no generation)
itsine¦q	N	–rup, –rit
its¦ineq	N	{–ernup, –inerup}, {–ernit, –inerit}
itsinert¦ooq	N	–uup, –uut
itsinertussu¦seq	N	–tsip, –tsit
itsinertu¦voq	V	–nngilaq
itsiniki¦ppoq	V	–nngilaq
itsi¦orpaa	V	–unngilaa
itsi¦voq	V	–nngilaq
its¦orpaa	V	–unngilaa
its¦orpoq	V	–unngilaq
itsuannisaarfi¦k	N	–up, –it
itsuannisaa¦rpaa	V	–nngilaa
itsuannisaa¦rpoq	V	–nngilaq
itsuarne¦q	N	–rup, –rit
itsua¦rpaa	V	–nngilaa
itsua¦rpoq	V	–nngilaq
itsuartorfi¦k	N	–up, –it
itsuart¦orpaa	V	–unngilaa
itsuart¦orpoq	V	–unngilaq
itsuartuut	N	–ip, –it
Ittaajimmi¦it	Prop, pl.	{–it, –ut}
Ittaajimmi¦ut	Prop, pl.	{–it, –ut}
ittanne¦q	N	–rup, –rit
ittannerus¦oq	N	–up, –ut
ittannerussu¦seq	N	–tsip, –tsit
ittanneru¦voq	V	–nngilaq
itta¦ppoq	V	–nngilaq
ittassaat	N	–ip, –it
ittassa¦rpoq	V	–nngilaq
ittoor¦aa	V	–inngilaa
ittoornaa¦ppoq	V	–nngilaq
ittoornanngits¦oq	N	–up, –ut
ittoorna¦rpoq	V	–nngilaq
ittoornart¦oq	N	–up, –ut
ittoorne¦q	N	–rup, –rit
itt¦oorpoq	V	–uunngilaq
ittoort¦oq	N	–up, –ut
ittoorunnaa¦rpoq	V	–nngilaq
ittoorut	N	–ip, –it
ittoorutig¦aa	V	–inngilaa
itt¦oq	N	–up, –ut
ittoqerne¦q	N	–rup, –rit
ittoq¦erpoq	V	–inngilaq
Ittoqqortoormi¦it	Prop, pl.	{–it, –ut}
ittoqut	N	–ip, –it
ittortaat	N	–ip, –it
ittortaat	N, pl.	-
ittu	N	–p, –t
ittuaannarpoq	V	(no generation)
ittualuppoq	V	(no generation)
ittuarpoq	V	(no generation)
ittuarsinnarne¦q	N	–rup, –rit
ittuarsinna¦rpoq	V	–nngilaq
ittuinna¦rpoq	V	–nngilaq
ittuinnart¦oq	N	–up, –ut
ittuinnassu¦seq	N	–tsip, –tsit
ittujaa¦rpaa	V	–nngilaa
ittujaarsaa¦voq	V	–nngilaq
ittujaarsa¦rpaa	V	–nngilaa
ittu¦k	N	–up, –it
ittulaarne¦q	N	–rup, –rit
ittulaarpalutt¦oq	N	–up, –ut
ittulaa¦rpoq	V	–nngilaq
ittulaartorsuu¦voq	V	–nngilaq
ittulaartorsu¦uvoq	V	{–aanngilaq, –unngilaq}
ittulisa¦rpoq	V	–nngilaq
ittunne¦q	N	–rup, –rit
ittuppalu¦k	N	–up, –it
ittuppalu¦ppoq	V	–nngilaq
ittu¦ppoq	V	–nngilaq
ittutsitsi¦voq	V	–nngilaq
ittuuju¦erpoq	V	–inngilaq
ittuujuilli¦voq	V	–nngilaq
ittuujui¦ppoq	V	–nngilaq
ittuujuisaart¦oq	N	–up, –ut
ittuujuissu¦seq	N	–tsip, –tsit
ittuujuits¦oq	N	–up, –ut
ittuukuluppoq	V	(no generation)
ittuungaanngilaq	V	(no generation)
ittuungaa¦rpoq	V	–nngilaq
ittuunnginne¦q	N	–rup, –rit
ittuunngits¦oq	N	–up, –ut
ittuupajaarallarpoq	V	(no generation)
ittuupajaaraluarpoq	V	(no generation)
ittuupajaarpoq	V	(no generation)
ittuupajaarunarpoq	V	(no generation)
ittuus¦oq	N	–up, –ut
ittuut¦ooq	N	–uup, –uut
ituiffi¦k	N	–up, –it
itui¦ppaa	V	–nngilaa
itui¦ppoq	V	–nngilaq
ituittarfi¦k	N	–up, –it
itui¦ttarfik	N	{–ssarfiup, –ttarfiup}, {–ssarfiit, –ttarfiit}
itullikkajuppoq	V	(no generation)
itulli¦ppoq	V	–nngilaq
itullisi¦ppaa	V	–nngilaa
itum¦ak	N	{–aap, –map}, {–aat, –mat}
itumammi¦ppaa	V	–nngilaa
itumammi¦ppoq	V	–nngilaq
itumatt¦ooq	N	–uup, –uut
itummia¦rpaa	V	–nngilaa
itummia¦rpoq	V	–nngilaq
itummiu¦ppaa	V	–tinngilaa
itunne¦q	N	–rup, –rit
itussaa¦q	N	–p, –t
itussa¦rpaa	V	–nngilaa
itussa¦rpoq	V	–nngilaq
ituss¦orpoq	V	–unngilaq
itussu¦ppaa	V	–nngilaa
iuju	Interj	(no generation)
iuu	Interj	(no generation)
iuujoort¦orpaa	V	–unngilaa
ivaall¦erpoq	V	–inngilaq
ivaa¦q	N	–p, –t
ivaar¦aa	V	–inngilaa
ivaarisa¦q	N	–p, –t
ivaffi¦k	N	–up, –it
ivagaju¦ppoq	V	–nngilaq
ivajumaller¦soq	N	{–sup, –tup}, {–sut, –tut}
ival¦erpaa	V	–inngilaa
ival¦erpoq	V	–inngilaq
ivallua¦rpaa	V	–nngilaa
ivallua¦rpoq	V	–nngilaq
ivammaffaari¦ppoq	V	–nngilaq
ivamma¦ppoq	V	–nngilaq
ivammattuinnaa¦voq	V	–nngilaq
ivanippallaaqaaq	V	(no generation)
ivani¦ppoq	V	–nngilaq
ivanits¦oq	N	–up, –ut
ivanni¦voq	V	–nngilaq
iva¦q	N	–p, –t
ivasa¦q	N	–p, –t
ivat¦orpoq	V	–unngilaq
ivatt¦orpoq	V	–unngilaq
iva¦vaa	V	–nngilaa
iva¦voq	V	–nngilaq
iv¦erpaa	V	–inngilaa
iv¦erpoq	V	–inngilaq
iversarne¦q	N	–rup, –rit
Iversut	N, pl.	-
Iver¦sut	N, pl.	{–sut, –tut}
iverteqqinneqarne¦q	N	–rup, –rit
iverteqqinneqa¦rpoq	V	–nngilaq
iverteqqi¦ppaa	V	–nngilaa
ivertinneqarne¦q	N	–rup, –rit
ivertinneqa¦rpoq	V	–nngilaq
iverti¦ppaa	V	–nngilaa
iverti¦ppoq	V	–nngilaq
ivertitaa¦voq	V	–nngilaq
ivertitsine¦q	N	–rup, –rit
ivertitsi¦voq	V	–nngilaq
iverus¦erpoq	V	–inngilaq
iveru¦serpoq	V	{–sinngilaq, –tilinngilaq}
iverussu¦aq	N	–up, –it
iverut	N	–ip, –it
iverutaars¦erpoq	V	–inngilaq
Ivi	Prop	–p
iviangeersinne¦q	N	–rup, –rit
ivian¦geq	N	{–gip, –ngip}, {–git, –ngit}
iviangequtit	N, pl.	-
iviangerlu¦ppoq	V	–nngilaq
iviangers¦ooq	N	–uup, –uut
ivigaa¦raq	N	–qqap, –qqat
ivigaasa¦q	N	–p, –t
ivigaat	N	–ip, –it
ivigakul¦ooq	N	–uup, –uut
ivigal¦ik	N	{–iup, –lip, –lup}, –lit
ivi¦gaq	N	–kkap, –kkat
ivigaqarfi¦k	N	–up, –it
ivigaqarfitta¦q	N	–p, –t
ivigarsu¦aq	N	–up, –it
ivigarsuit	N, pl.	-
ivigartarniarpoq	V	(no generation)
ivigarta¦rpoq	V	–nngilaq
ivi¦k	N	–up, –it
ivikkari¦ppoq	V	–nngilaq
ivikkat	N, pl.	-
ivikkeri¦voq	V	–nngilaq
ivikkia¦q	N	–p, –t
ivikkia¦rpoq	V	–nngilaq
ivikkiartaanna¦rpoq	V	–nngilaq
ivisaa¦q	N	–p, –t
ivisaa¦roq	N	–qqup, –qqut
ivisaaruni¦ppoq	V	–nngilaq
ivissi¦voq	V	–nngilaq
ivissu¦aq	N	–up, –it
ivissugaa¦q	N	–p, –t
ivissugaari¦ppoq	V	–nngilaq
ivitta¦rpoq	V	–nngilaq
Ivittuut	N	{–ip, –ip}, {–it, –it}
Ivittuut	N, pl.	-
Ivittuut	Prop, pl.	-
ivune¦q	N	–rup, –rit
ivu¦voq	V	–nngilaq
