Lexeme	WC	Flexion
saaffig¦aa	V	–inngilaa
saaffigigajuttarpaa	V	(no generation)
saaffigiinna¦rpaa	V	–nngilaa
saaffiginninne¦q	N	–rup, –rit
saaffiginni¦ppoq	V	–nngilaq
saaffiginnissut	N	–ip, –it
saaffiginnissuteqarne¦q	N	–rup, –rit
saaffiginnittarfi¦k	N	–up, –it
saaffiginnitt¦oq	N	–up, –ut
saaffigisat	N, pl.	-
saaffissaarunne¦q	N	–rup, –rit
saaffissaa¦voq	V	–nngilaq
saagiarsu¦aq	N	–up, –it
saaginnal¦ik	N	{–iup, –lip, –lup}, –lit
saaginna¦q	N	–ap, –at
saaginna¦q	N	–p, –t
saaginnaqa¦rpoq	V	–nngilaq
saaginna¦rpaa	V	–nngilaa
saa¦ginnarpaa	V	{–ginnanngilaa, –tiinnanngilaa}
saagi¦ppoq	V	–nngilaq
saagissisimaarna¦rpoq	V	–nngilaq
saagi¦ssisimaarnarpoq	V	{–ssisimaarnanngilaq, –ssissimaarnanngilaq, –tsisimaarnanngilaq, –tsissimaarnanngilaq}
saagissisimaa¦rpoq	V	–nngilaq
saagissisimaart¦oq	N	–up, –ut
saagi¦ssisimaartoq	N	{–ssisimaartup, –ssissimaartup, –tsisimaartup, –tsissimaartup}, {–ssisimaartut, –ssissimaartut, –tsisimaartut, –tsissimaartut}
saagooqqissaa¦rpoq	V	–nngilaq
saag¦oorpaa	V	–uunngilaa
saag¦oorpoq	V	–uunngilaq
saagoorsima¦voq	V	–nngilaq
saag¦oq	N	–up, –ut
saagorsu¦aq	N	–up, –it
saagortaa¦rpoq	V	–nngilaq
saagu¦aa	V	–nngilaa
saagu¦aq	N	–ssap, –ssat
saaguassia¦q	N	–p, –t
saagu¦erpaa	V	–inngilaa
saagu¦erpoq	V	–inngilaq
saaguers¦oorpoq	V	–uunngilaq
saagulerfi¦k	N	–up, –it
saagul¦erpaa	V	–inngilaa
saaguliu¦ppaa	V	–tinngilaa
saagusa¦rpoq	V	–nngilaq
saagusima¦voq	V	–nngilaq
saagu¦voq	V	–nngilaq
saakkasuarpaa	V	(no generation)
saakuli¦orpoq	V	–unngilaq
saakusi¦voq	V	–nngilaq
saakut	N	–ip, –it
saakut	N, pl.	-
saalaa¦voq	V	–nngilaq
saal¦erpaa	V	–inngilaa
saa¦lerpaa	V	{–linngilaa, –tilinngilaa}
saalers¦orpaa	V	–unngilaa
saalersuu¦ppaa	V	–tinngilaa
saaliaqus¦erpoq	V	–inngilaq
saaliaqu¦serpoq	V	{–sinngilaq, –tilinngilaq}
saaliaqut	N	–ip, –it
saaliaqut	N, pl.	-
saaliaqutaaru¦ppoq	V	–nngilaq
saaliaqutaaru¦ppoq	V	–tinngilaq
saaliaqutitaa¦rpoq	V	–nngilaq
saaliart¦orpoq	V	–unngilaq
saaliar¦torpoq	V	{–sunngilaq, –tunngilaq}
saalil¦erpaa	V	–inngilaa
saalimaa¦rpoq	V	–nngilaq
saali¦orpoq	V	–unngilaq
saalisa¦gaq	N	–kkap, –kkat
saalisa¦rpaa	V	–nngilaa
saalisi¦ppaa	V	–nngilaa
saali¦sippaa	V	{–sinngilaa, –tinngilaa}
saali¦vaa	V	–nngilaa
saali¦voq	V	–nngilaq
saall¦orpoq	V	–unngilaq
saallorsarpoq	V	(no generation)
saalualla¦k	N	–ap, –at
saalualla¦ppoq	V	–nngilaq
saamaqaaq	V	(no generation)
saamas¦oq	N	–up, –ut
saamasuunngilaq	V	(no generation)
saama¦voq	V	–nngilaq
saamerl¦eq	N	–iup, –iit
saamerler¦aa	V	–inngilaa
saamerliuniat	N, pl.	-
saamerliu¦voq	V	–nngilaq
saamiatatungaanii¦ppoq	V	–nngilaq
saamiatungaanii¦ppoq	V	–nngilaq
saamiit	N, pl.	-
saami¦k	N	–up, –it
saamille¦q	N	–rup, –rit
saamiller¦tut	N, pl.	{–sut, –tut}
saamiss¦orpoq	V	–unngilaq
saamiuliu¦ppaa	V	–tinngilaa
saamiunngilaq	V	(no generation)
saamiu¦voq	V	–nngilaq
saammaaffi¦k	N	–up, –it
saammaaffiu¦voq	V	–nngilaq
saammaanna¦rpoq	V	–nngilaq
saammaannarsisitaa¦voq	V	–nngilaq
saammaannarsi¦sitaavoq	V	{–sitaanngilaq, –titaanngilaq}
saammaannarsi¦voq	V	–nngilaq
saammaannarti¦ppaa	V	–nngilaa
saammaannartitaa¦voq	V	–nngilaq
saammaannartitsivi¦k	N	–up, –it
saammaannartitsi¦vik	N	{–ffiup, –viup}, {–ffiit, –viit}
saammaannartitsi¦voq	V	–nngilaq
saammaanne¦q	N	–rup, –rit
saammaannersi¦voq	V	–nngilaq
saammaa¦ppaa	V	–tinngilaa
saammaas¦oq	N	–up, –ut
saammaassaane¦q	N	–rup, –rit
saammaassaa¦voq	V	–nngilaq
saammaassa¦q	N	–p, –t
saammaasseqatigiinne¦q	N	–rup, –rit
saammaasseqatigiinnissa¦q	N	–p, –t
saammaassine¦q	N	–rup, –rit
saammaassi¦voq	V	–nngilaq
saammaassu¦seq	N	–tsip, –tsit
saammaassut	N	–ip, –it
saammaateqatigiinne¦q	N	–rup, –rit
saammaa¦teqatigiinneq	N	{–qatigiinnerup, –teqatigiinnerup, –tseqatigiinnerup, –titeqatigiinnerup}, {–qatigiinnerit, –teqatigiinnerit, –tseqatigiinnerit, –titeqatigiinnerit}
saammaatitikkuma¦voq	V	–nngilaq
saammaat¦itippaa	V	{–itsinngilaa, –sitsinngilaa, –itinngilaa, –sinngilaa}
saammaat¦itippoq	V	{–itsinngilaq, –sitsinngilaq, –itinngilaq, –sinngilaq}
saammaa¦voq	V	–nngilaq
saamma¦rpoq	V	–nngilaq
saammarsaas¦oq	N	–up, –ut
saammarsaat	N	–ip, –it
saammarsaa¦voq	V	–nngilaq
saammarsagassaanngilaq	V	(no generation)
saammarsa¦rpaa	V	–nngilaa
saammarti¦ppaa	V	–nngilaa
saammisaanngilaq	V	(no generation)
saammisaarajuppoq	V	(no generation)
saammisaa¦rpoq	V	–nngilaq
saanaa¦voq	V	–nngilaq
saane¦q	N	–rup, –rit
saa¦neq	N	{–nerup, –rnup}, {–nerit, –rnit}
saaner¦orpaa	V	–unngilaa
saan¦erpaa	V	–inngilaa
saanersu¦aq	N	–up, –it
saanerta¦q	N	–p, –t
saaner¦taq	N	{–sap, –tap}, {–sat, –tat}
saangerlua¦rpaa	V	–nngilaa
saang¦erpaa	V	–inngilaa
saangersima¦vaa	V	–nngilaa
saangers¦orpaa	V	–unngilaa
saangiukkiart¦orpoq	V	–unngilaq
saangiu¦ppaa	V	–tinngilaa
saangiu¦ppoq	V	–tinngilaq
saani	N	–p, –t
saaniia¦gaq	N	–kkap, –kkat
saani¦iagaq	N	{–ajakkap, –iakkap}, {–ajakkat, –iakkat}
saaniikkumall¦erpoq	V	–inngilaq
saanii¦ppoq	V	–nngilaq
saaniissa¦aq	V	–nngilaq
saani¦issaaq	V	{–issanngilaq, –nngaanniissanngilaq}, –issanngilaq
saanikoorfi¦k	N	–up, –it
saanik¦oorpoq	V	–uunngilaq
saanikoortaannarpoq	V	(no generation)
saanik¦oq	N	–up, –ut
saanikorsuit	N, pl.	-
saaniku	N	–p, –t
saanikuinnaa¦voq	V	–nngilaq
saanikulia¦q	N	–p, –t
saanikuliar¦aa	V	–inngilaa
saanikuliassa¦q	N	–p, –t
saanikut	N, pl.	-
saanileri¦voq	V	–nngilaq
saanilu¦k	N	–up, –it
saanilussu¦aq	N	–up, –it
saaniluusa¦q	N	–p, –t
saannaa¦voq	V	–nngilaq
saanna¦ppoq	V	–nngilaq
saannari¦ppoq	V	–nngilaq
saannarissuunngilaq	V	(no generation)
saannarivi¦ppoq	V	–nngilaq
saannarlu¦ppoq	V	–nngilaq
saanne¦q	N	–rup, –rit
saanneraa¦q	N	–p, –t
saanneralaa¦q	N	–p, –t
saanneralaarsi¦voq	V	–nngilaq
saanneri¦voq	V	–nngilaq
saannersa¦q	N	–p, –t
saannerseraa¦rpoq	V	–nngilaq
saannga¦rpaa	V	–nngilaa
saanngu¦sersorpaa	V	{–sersunngilaa, –tilersunngilaa}
saanngut	N	–ip, –it
saanngutaarlu¦erpoq	V	–inngilaq
saanngutaa¦voq	V	–nngilaq
saanniaqqamm¦erpoq	V	–inngilaq
saanniarne¦q	N	–rup, –rit
saannia¦rpoq	V	–nngilaq
saanni¦ppoq	V	–nngilaq
saanniut	N	–ip, –it
saanniut	N, pl.	-
saanniutaa¦voq	V	–nngilaq
saanni¦voq	V	–nngilaq
saapaqi¦voq	V	–nngilaq
saapersuu¦ppaa	V	–tinngilaa
saapersuussi¦voq	V	–nngilaq
saapiloorpaa	V	(no generation)
saa¦ppaa	V	{–nngilaa, –tinngilaa}
saappallaaqaaq	V	(no generation)
saa¦ppoq	V	–nngilaq
saa¦q	N	–p, –t
saaqqukkiart¦orpaa	V	–unngilaa
saaqqu¦ppaa	V	{–nngilaa, –tinngilaa}
saaqqu¦ppoq	V	–tinngilaq
saaqqusi¦orpaa	V	–unngilaa
saaqqusi¦orpoq	V	–unngilaq
saaqqu¦siorpoq	V	{–siunngilaq, –tiliunngilaq}
saaqqut	N	–ip, –it
saaqqut	N, pl.	-
saaqqutersorluarsinnaa¦voq	V	–nngilaq
saaqquters¦orpoq	V	–unngilaq
saaqqutinngisaanna¦rpaa	V	–nngilaa
saaqqu¦tinngisaannarpaa	V	{–tinngisaannanngilaa, –nngisaannanngilaa}
saaqqutissia¦q	N	–p, –t
saaqqutit	N, pl.	-
saaqqutitaa¦rpoq	V	–nngilaq
saarfaarsu¦gaq	N	–kkap, –kkat
saarfaarsu¦k	N	–up, –it
saarfaarsu¦ppoq	V	–nngilaq
saarfaarsussu¦aq	N	–up, –it
saariagassaaru¦ppoq	V	–tinngilaq
saa¦riagassaaruppoq	V	{–riagassaarutinngilaq, –teriagassaarutinngilaq}
saariarfissaaru¦ppoq	V	–tinngilaq
saa¦riarfissaaruppoq	V	{–riarfissaarutinngilaq, –teriarfissaarutinngilaq}
saariarfissaarut¦itippaa	V	{–itsinngilaa, –sitsinngilaa, –itinngilaa, –sinngilaa}
saa¦riarfissaarutitippaa	V	{–riarfissaarutitsinngilaa, –riarfissaarutsitsinngilaa, –riarfissaarutitinngilaa, –riarfissaarutsinngilaa, –teriarfissaarutitsinngilaa, –teriarfissaarutsitsinngilaa, –teriarfissaarutitinngilaa, –teriarfissaarutsinngilaa}
saariarfissaarut¦ititsineq	N	{–ititsinerup, –itsitsinerup, –sititsinerup, –sitsitsinerup}, {–ititsinerit, –itsitsinerit, –sititsinerit, –sitsitsinerit}
saa¦riarfissaarutititsineq	N	{–riarfissaarutititsinerup, –riarfissaarutitsitsinerup, –riarfissaarutsititsinerup, –riarfissaarutsitsitsinerup, –teriarfissaarutititsinerup, –teriarfissaarutitsitsinerup, –teriarfissaarutsititsinerup, –teriarfissaarutsitsitsinerup}, {–riarfissaarutititsinerit, –riarfissaarutitsitsinerit, –riarfissaarutsititsinerit, –riarfissaarutsitsitsinerit, –teriarfissaarutititsinerit, –teriarfissaarutitsitsinerit, –teriarfissaarutsititsinerit, –teriarfissaarutsitsitsinerit}
saariarfissaarutt¦oq	N	–up, –ut
saa¦riarfissaaruttoq	N	{–riarfissaaruttup, –teriarfissaaruttup}, {–riarfissaaruttut, –teriarfissaaruttut}
saariarfissaasua¦voq	V	–nngilaq
saa¦riarfissaasuavoq	V	{–riarfissaasuanngilaq, –teriarfissaasuanngilaq}
saaria¦rpaa	V	–nngilaa
saa¦riarpaa	V	{–rianngilaa, –terianngilaa}
saaria¦rpoq	V	–nngilaq
saa¦riarpoq	V	{–rianngilaq, –terianngilaq}
saarl¦eq	N	{–erup, –iup}, {–erit, –iit}
saarli¦ppoq	V	–nngilaq
saarlisaarfi¦k	N	–up, –it
saarli¦saarfik	N	{–saarfiup, –taarfiup}, {–saarfiit, –taarfiit}
saarlisaarne¦q	N	–rup, –rit
saarli¦saarneq	N	{–saarnerup, –taarnerup}, {–saarnerit, –taarnerit}
saarlisaa¦rpoq	V	–nngilaq
saarlisaart¦oq	N	–up, –ut
saarli¦saartoq	N	{–saartup, –taartup}, {–saartut, –taartut}
saarlisaarut	N	–ip, –it
saarlisaarutit	N, pl.	-
saarlisaat	N	–ip, –it
saarlisi¦ppaa	V	–nngilaa
saarli¦voq	V	–nngilaq
Saarl¦oq	N	–up, –ut
Saarl¦oq	Prop	–up
saarl¦oq	N	–up, –ut
saarlormiu	N	–p, –t
saarl¦orpoq	V	–unngilaq
saarlorsa¦q	N	–p, –t
saarlorsarpoq	V	(no generation)
saarlorsart¦ooq	N	–uup, –uut
saarlors¦erpaa	V	–inngilaa
saarlu¦ppoq	V	–nngilaq
saarmi¦ppaa	V	–nngilaa
saarmi¦ppoq	V	–nngilaq
saarngu¦voq	V	–nngilaq
saa¦rnit	N, pl.	{–nerit, –rnit}
saarnu¦voq	V	–nngilaq
saarulleerajuttuu¦voq	V	–nngilaq
saarulleerniarta¦rpoq	V	–nngilaq
saarull¦eerpoq	V	–iinngilaq
saarulleqassu¦seq	N	–tsip, –tsit
saarullerna¦q	N	–p, –t
saarullernartassat	N, pl.	-
saarullialuinnannguit	N, pl.	-
saarulligaa¦raq	N	–qqap, –qqat
saarulli¦gaq	N	–kkap, –kkat
saarulliisa¦ppoq	V	–nngilaq
saarulli¦k	N	–up, –it
saarullinnia¦q	N	–p, –t
saarullinniarne¦q	N	–rup, –rit
saarullinnia¦rpoq	V	–nngilaq
saarullissu¦aq	N	–up, –it
saarullittassiissutit	N, pl.	-
saarulliusaa¦q	N	–p, –t
saarulliusa¦q	N	–p, –t
saarulliuteqa¦rpoq	V	–nngilaq
saasaa¦rpaa	V	–nngilaa
saasaa¦voq	V	–nngilaq
saasa¦q	N	–p, –t
saasa¦rpaa	V	–nngilaa
saassa¦q	N	–p, –t
saa¦ssaq	N	{–ssap, –tap}, {–ssat, –tat}
saass¦erpoq	V	–inngilaq
saassimaleriikatappoq	V	(no generation)
saassima¦voq	V	–nngilaq
saassinaqaaq	V	(no generation)
saassi¦voq	V	–nngilaq
saassorput	N, pl.	-
saassukkiartortarpaa	V	(no generation)
saassu¦ppaa	V	–tinngilaa
saassu¦seq	N	–tsip, –tsit
saassu¦seriarsinnaanngitsoq	N	{–seriarsinnaanngitsup, –tileriarsinnaanngitsup}, {–seriarsinnaanngitsut, –tileriarsinnaanngitsut}
saassussaa¦voq	V	–nngilaq
saassussine¦q	N	–rup, –rit
saassussiumat¦ooq	N	–uup, –uut
saassussi¦voq	V	–nngilaq
Saatan¦eerpaa	V	–iinngilaa
saatan¦eerpaa	V	–iinngilaa
Saatani	Prop	–p
saa¦taq	N	{–ssap, –tap}, {–ssat, –tat}
saatassaaru¦ppoq	V	–tinngilaq
saa¦tassaaruppoq	V	{–tassaarutinngilaq, –ssassaarutinngilaq}
saaternia¦rpaa	V	–nngilaa
saat¦erpaa	V	–inngilaa
saat¦erpoq	V	–inngilaq
saati¦ppaa	V	–nngilaa
saat¦ippaa	V	{–inngilaa, –sinngilaa, –itinngilaa}
saats¦erpaa	V	–inngilaa
saat¦serpaa	V	–itinngilaa
saats¦erpoq	V	–inngilaq
saat¦serpoq	V	–itinngilaq
saatsersuarpoq	V	(no generation)
saatsertuarpoq	V	(no generation)
saat¦sippaa	V	{–inngilaa, –sinngilaa, –itinngilaa}
saatt¦oq	N	–up, –ut
saattoralaanngu¦aq	N	–up, –it
saattoralaa¦q	N	–p, –t
saattoralaarsi¦voq	V	–nngilaq
saattormiu	N	–p, –t
saattorsi¦orpoq	V	–unngilaq
saattuaasa¦q	N	–p, –t
saattua¦q	N	–p, –t
saattuaqqat	N, pl.	-
saattuarniarne¦q	N	–rup, –rit
saattuarsu¦k	N	–up, –it
saattuarsussu¦aq	N	–up, –it
saattuartassat	N, pl.	-
saattuartassiissut	N	–ip, –it
saattukuj¦ooq	N	–uup, –uut
saattukujoorsu¦aq	N	–up, –it
saattukujuugalu¦aq	N	–up, –it
saattukujuu¦innaq	N	{–ginnaap, –innaap}, {–ginnaat, –innaat}
saattukujuu¦innaq	N	{–ginnap, –innap, –innaap}, {–ginnat, –innat, –innaat}
saattukujuunngu¦aq	N	–up, –it
saattuli¦orpoq	V	–unngilaq
Saattut	N, pl.	-
Saattut	Prop, pl.	-
saa¦vaa	V	–nngilaa
saavanii¦ppoq	V	–nngilaq
saava¦tigoorpoq	V	{–tiguunngilaq, –guunngilaq}
saavi¦ppaa	V	–nngilaa
saa¦vippaa	V	{–tivinngilaa, –vinngilaa}
saavi¦ppoq	V	–nngilaq
saavitaa¦voq	V	–nngilaq
saavitt¦oq	N	–up, –ut
saavi¦ttoq	N	{–ssup, –ttup}, {–ssut, –ttut}
saa¦vittoq	N	{–vissup, –vittup, –tivissup, –tivittup}, {–vissut, –vittut, –tivissut, –tivittut}
saa¦voq	V	–nngilaq
saffasi¦ppoq	V	–nngilaq
saffiaa¦voq	V	–nngilaq
saffia¦q	N	–p, –t
saffia¦rpaa	V	–nngilaa
saffi¦ooq	N	–uup, –uut
saffiorfi¦k	N	–up, –it
saffi¦orpaa	V	–unngilaa
saffi¦orpoq	V	–unngilaq
saffiort¦oq	N	–up, –ut
saffiugaa¦voq	V	–nngilaq
saffiu¦gaq	N	–kkap, –kkat
saffiugassa¦q	N	–p, –t
saffiugassat	N, pl.	-
saffiugassia¦q	N	–p, –t
saffiugassiassa¦q	N	–p, –t
saggaas¦oq	N	–up, –ut
saggaatsia¦q	N	–p, –t
saggaa¦voq	V	–nngilaq
sagga¦q	N	–ap, –at
saggar¦orpoq	V	–unngilaq
saggarorsa¦rpaa	V	–nngilaa
sagga¦rpaa	V	–nngilaa
sagg¦erpoq	V	–inngilaq
saggussaa¦rpaa	V	–nngilaa
saggussaa¦rpoq	V	–nngilaq
saggut	N	–ip, –it
saggutaanna¦q	N	–ap, –at
saggut¦aannaq	N	{–aannaap, –iinnaap}, {–aannaat, –iinnaat}
sagguttart¦oq	N	–up, –ut
sajaalluinnarpoq	V	(no generation)
sajaannersaa¦voq	V	–nngilaq
sajaa¦ppoq	V	–nngilaq
sajaats¦oq	N	–up, –ut
sajaatsuune¦q	N	–rup, –rit
sajaatsuunngilaq	V	(no generation)
sajaqaaq	V	(no generation)
sajasorsu¦uvoq	V	{–aanngilaq, –unngilaq}
saja¦voq	V	–nngilaq
sajukulaarne¦q	N	–rup, –rit
sajukulaarpallaaqaaq	V	(no generation)
sajukulaa¦rpoq	V	–nngilaq
sajukulaartitsine¦q	N	–rup, –rit
sajukulaartitsi¦voq	V	–nngilaq
sajukulaarunnaa¦rpoq	V	–nngilaq
sajunne¦q	N	–rup, –rit
sajuppilla¦ppoq	V	–nngilaq
sajuppillattoorne¦q	N	–rup, –rit
sajuppilu¦ppoq	V	–nngilaq
saju¦ppoq	V	–nngilaq
sajussiis¦oq	N	–up, –ut
sajussiisut	N, pl.	-
sajussiivi¦k	N	–up, –it
sajutsi¦ppaa	V	–nngilaa
sajutt¦oq	N	–up, –ut
sajuttuinnaa¦voq	V	–nngilaq
sakaluuallaaqaaq	V	(no generation)
sakaluu¦voq	V	–nngilaq
sakama¦ppaa	V	–nngilaa
sakamattal¦ik	N	{–iup, –lip, –lup}, –lit
sakamatta¦q	N	–p, –t
saka¦ppaa	V	–nngilaa
sakataa¦voq	V	–nngilaq
sakata¦q	N	–p, –t
sakatsi¦voq	V	–nngilaq
sakattaa¦voq	V	–nngilaq
saka¦voq	V	–nngilaq
sak¦eerpaa	V	–iinngilaa
saki	N	–p, –t
sakiaaja¦rpoq	V	–nngilaq
sakiagi¦ppoq	V	–nngilaq
sakiagissaat	N	–ip, –it
sakiagi¦ssaat	N	{–ssaatip, –ttaatip}, {–ssaatit, –ttaatit}
saki¦ak	N	–ssap, –ssat
sakiallunne¦q	N	–rup, –rit
sakiallu¦ppoq	V	–nngilaq
sakialluut	N	–ip, –it
sakialluuteqaleriataarpoq	V	(no generation)
sakiamine¦q	N	–rup, –rit
sakiam¦ineq	N	–ernup, –ernit
sakiammi¦ppoq	V	–nngilaq
sakiammissari¦aq	N	–ssap, –ssat
sakianna¦ppoq	V	–nngilaq
sakiaqut	N	–ip, –it
sakiatsia¦q	N	–ap, –at
sakiatsiariissu¦seq	N	–tsip, –tsit
sakig¦aa	V	–inngilaa
sakimmer¦aa	V	–inngilaa
sakimm¦erpoq	V	–inngilaq
sakimmilers¦orpoq	V	–unngilaq
sakimmina¦q	N	–p, –t
sakimminaqaaq	V	(no generation)
sakimmina¦rpoq	V	–nngilaq
sakissa¦ppoq	V	–nngilaq
sakissat	N, pl.	-
sakisserisaanna¦rpoq	V	–nngilaq
sakisseri¦voq	V	–nngilaq
sakiss¦erpoq	V	–inngilaq
sakissersimaarpoq	V	(no generation)
sakiu¦voq	V	–nngilaq
saki¦voq	V	–nngilaq
sakka¦ppoq	V	–nngilaq
sakkattorsu¦uvoq	V	{–aanngilaq, –unngilaq}
sakkoq	N	(no generation)
sakkoqanngilaq	V	(no generation)
sakkoqqort¦ooq	N	–uup, –uut
sakkort¦ooq	N	–uup, –uut
sakkortoorsu¦aq	N	–up, –it
sakkortuallaanngivi¦ppoq	V	–nngilaq
sakk¦ortuallaanngivippoq	V	{–ortuallaanngivinngilaq, –utuallaanngivinngilaq}
sakkortuallaaqaaq	V	(no generation)
sakk¦ortunerpaaffik	N	{–ortunerpaaffiup, –ortunerpaajuffiup, –utunerpaaffiup, –utunerpaajuffiup}, {–ortunerpaaffiit, –ortunerpaajuffiit, –utunerpaaffiit, –utunerpaajuffiit}
sakk¦ortunerpaaq	N	{–ortunerpaap, –utunerpaap}, {–ortunerpaat, –utunerpaat}
sakk¦ortunersaq	N	{–ortunersap, –utunersap}, {–ortunersat, –utunersat}
sakkortusaane¦q	N	–rup, –rit
sakkortusaat	N	–ip, –it
sakk¦ortusaat	N	{–ortusaatip, –utusaatip}, {–ortusaatit, –utusaatit}
sakkortusaavi¦k	N	–up, –it
sakkortusaa¦vik	N	{–ffiup, –viup}, {–ffiit, –viit}
sakkortusigaluttuinnalerpoq	V	(no generation)
sakkortusigaluttuinnarpoq	V	(no generation)
sakkortusis¦oq	N	–up, –ut
sakkortusi¦vaa	V	–nngilaa
sakkortusivoq	V	(no generation)
sakkortussu¦seq	N	–tsip, –tsit
sakk¦ortussuseq	N	{–ortussutsip, –utussutsip}, {–ortussutsit, –utussutsit}
sakk¦ortuvoq	V	{–ortunngilaq, –utunngilaq}
sakku	N	–p, –t
sakku	Pron, pl.	–a
sakku¦a	Pron, pl.	–a
sakkuaaqatig¦aa	V	–inngilaa
sakkuaa¦voq	V	–nngilaq
sakkua¦rpaa	V	–nngilaa
sakkua¦rpoq	V	–nngilaq
sakkugi¦ppoq	V	–nngilaq
sakkugissaa¦rpoq	V	–nngilaq
sakkuia¦rpaa	V	–nngilaa
sakku¦iarpaa	V	{–ajanngilaa, –ianngilaa}
sakkuissu¦aq	N	–up, –it
sakkukilliart¦orpoq	V	–unngilaq
sakkukillisaat	N	–ip, –it
sakkukillisi¦ppaa	V	–nngilaa
sakkukilli¦sippaa	V	{–sinngilaa, –tinngilaa}
sakkukilli¦voq	V	–nngilaq
sakkukinaa¦rpaa	V	–nngilaa
sakkuki¦ppoq	V	–nngilaq
sakkukits¦oq	N	–up, –ut
sakkul¦erpaa	V	–inngilaa
sakkul¦erpoq	V	–inngilaq
sakkulersorajuppoq	V	(no generation)
sakkulersorfiunngits¦oq	N	–up, –ut
sakkulersorne¦q	N	–rup, –rit
sakkulers¦orpaa	V	–unngilaa
sakkulers¦orpoq	V	–unngilaq
sakkulersort¦oq	N	–up, –ut
sakkulersorunnaarne¦q	N	–rup, –rit
sakkuliat	N, pl.	-
sakkul¦ik	N	{–iup, –lip, –lup}, –lit
sakkulisa¦rpoq	V	–nngilaq
sakkulisartaannarpoq	V	(no generation)
sakkulissu¦aq	N	–up, –it
sakkul¦issuaq	N	{–ersuup, –issuup}, {–ersuit, –issuit}
sakkulli¦orpoq	V	–unngilaq
sakkulliuinna¦rpoq	V	–nngilaq
sakkuneqqaa¦q	N	–p, –t
sakkunerlaa¦q	N	–p, –t
sakkuni¦ppoq	V	–nngilaq
sakkunittussaa¦voq	V	–nngilaq
sakkunnera¦rpoq	V	–nngilaq
sakkunnerine¦q	N	–rup, –rit
sakkunneri¦voq	V	–nngilaq
sakkus¦erpoq	V	–inngilaq
sakkussaallua¦rpoq	V	–nngilaq
sakkussamaasivi¦k	N	–up, –it
sakkussamaat	N	–ip, –it
sakkussa¦q	N	–p, –t
sakkuss¦iorpoq	V	{–aliunngilaq, –iunngilaq}
sakkutaa¦rpoq	V	–nngilaq
sakkut¦ooq	N	–uup, –uut
sakkutooqarfeqarne¦q	N	–rup, –rit
sakkutooqarfi¦k	N	–up, –it
sakkutooqarfiusimas¦oq	N	–up, –ut
sakkutooqarne¦q	N	–rup, –rit
sakkutooqatigiit	N, pl.	-
sakku¦tooqatigiit	N, pl.	{–atooqatigiit, –natooqatigiit, –tooqatigiit}
sakkutooqqinne¦q	N	–rup, –rit
sakku¦tooqqinneq	N	{–atooqqinnerup, –natooqqinnerup, –tooqqinnerup}, {–atooqqinnerit, –natooqqinnerit, –tooqqinnerit}
sakkutooqqinninngorti¦ppaa	V	–nngilaa
sakku¦tooqqinninngortippaa	V	{–atooqqinninngortinngilaa, –natooqqinninngortinngilaa, –tooqqinninngortinngilaa}
sakkutooqqinninngortitaane¦q	N	–rup, –rit
sakku¦tooqqinninngortitaaneq	N	{–atooqqinninngortitaanerup, –natooqqinninngortitaanerup, –tooqqinninngortitaanerup}, {–atooqqinninngortitaanerit, –natooqqinninngortitaanerit, –tooqqinninngortitaanerit}
sakkutuu¦iaaneq	N	{–ajaanerup, –iaanerup}, {–ajaanerit, –iaanerit}
sakkutuuiarne¦q	N	–rup, –rit
sakkutuu¦iarneq	N	{–ajarnerup, –iarnerup}, {–ajarnerit, –iarnerit}
sakkutuujunissa¦q	N	–p, –t
sakkutuujunngits¦oq	N	–up, –ut
sakkutuujusaa¦rpoq	V	–nngilaq
sakkutuujusaas¦oq	N	–up, –ut
sakkutuujusussaane¦q	N	–rup, –rit
sakkutuujusussaassu¦seq	N	–tsip, –tsit
sakkutuul¦erpaa	V	–inngilaa
sakkutuuligaane¦q	N	–rup, –rit
sakkutuuliine¦q	N	–rup, –rit
sakkutuunngoqqussut	N	–ip, –it
sakkutuunng¦orpoq	V	–unngilaq
sakkutuunngorsinnaa¦voq	V	–nngilaq
sakkutuunngorti¦ppaa	V	–nngilaa
sakkutuunngortussarsiort¦oq	N	–up, –ut
sakkutuussarsiorne¦q	N	–rup, –rit
sakkutuussut	N	–ip, –it
sakkutuussutit	N, pl.	-
sakkutuut	N, pl.	-
sakkuu¦sersorpoq	V	{–sersunngilaq, –tilersunngilaq}
sakkuut	N	–ip, –it
sakkuutaaru¦ppoq	V	–tinngilaq
sakramentilia¦rpoq	V	–nngilaq
salaasuana¦rpoq	V	–nngilaq
salaasua¦voq	V	–nngilaq
salaatit	N	(no generation)
salajuataa¦rpoq	V	–nngilaq
salanaveersaarpoq	V	(no generation)
salatolia	N	–p, –t
salavallaaqaaq	V	(no generation)
sala¦voq	V	–nngilaq
saligaa¦ppoq	V	–nngilaq
saligaarsaa¦rpoq	V	–nngilaq
saligaats¦oq	N	–up, –ut
saliga¦rpaa	V	–nngilaa
saligartaat	N	–ip, –it
sali¦gartaat	N, pl.	{–gartaat, –tartaat}
saligart¦orpaa	V	–unngilaa
saligut	N	–ip, –it
saligutit	N, pl.	-
saliigajuppoq	V	(no generation)
saliine¦q	N	–rup, –rit
saliisuu¦voq	V	–nngilaq
salii¦voq	V	–nngilaq
salikkuminaakkaluaqaaq	V	(no generation)
salikkuminaakkalua¦rpoq	V	–nngilaq
salikkuminaakkuna¦rpoq	V	–nngilaq
salikkuminaa¦ppoq	V	–nngilaq
salikkumina¦rpoq	V	–nngilaq
salillua¦rpaa	V	–nngilaa
sali¦ppaa	V	–nngilaa
sali¦ppoq	V	–nngilaq
salisaa¦voq	V	–nngilaq
salisa¦q	N	–p, –t
salissima¦voq	V	–nngilaq
salitaa¦voq	V	–nngilaq
sali¦taavoq	V	{–gaanngilaq, –taanngilaq}
sali¦taq	N	{–kkap, –tap}, {–kkat, –tat}
sali¦tassaq	N	{–gassap, –tassap}, {–gassat, –tassat}
salittariaqa¦rpoq	V	–nngilaq
sallaallisimas¦oq	N	–up, –ut
sallaalli¦voq	V	–nngilaq
sallaannerul¦erpoq	V	–inngilaq
sallaa¦ppoq	V	–nngilaq
sallaaqaaq	V	(no generation)
sallaaqis¦oq	N	–up, –ut
sallang¦erpoq	V	–inngilaq
sallangersimas¦oq	N	–up, –ut
sallangersi¦ppaa	V	–nngilaa
sallangers¦oorpoq	V	–uunngilaq
sallas¦erpoq	V	–inngilaq
salla¦serpoq	V	{–sinngilaq, –tilinngilaq}
sallasissa¦q	N	–p, –t
sallat	N	–ip, –it
salla¦voq	V	–nngilaq
Sall¦eq	N	–iup, –iit
sall¦eq	N	–iup, –iit
salleqi¦ppaa	V	–nngilaa
salleqi¦ppoq	V	–nngilaq
salleqisi¦ppaa	V	–nngilaa
salle¦raq	N	–qqap, –qqat
sallerpaa¦q	N	–p, –t
sallersaat	N	–ip, –it
sallersaa¦voq	V	–nngilaq
sallia¦q	N	–p, –t
salliarna¦q	N	–p, –t
salliarnarta¦q	N	–p, –t
salliarta¦q	N	–p, –t
salliaru¦seq	N	–tsip, –tsit
sallil¦erpaa	V	–inngilaa
sallili¦gaq	N	–kkap, –kkat
salliligarsi¦voq	V	–nngilaq
salliligarsu¦aq	N	–up, –it
sallilikkia¦q	N	–p, –t
sallilikkiassa¦q	N	–p, –t
sallilikkiorfi¦k	N	–up, –it
sallilikki¦orpoq	V	–unngilaq
salliunia¦rpoq	V	–nngilaq
salliussu¦seq	N	–tsip, –tsit
salliutinneqarsinnaane¦q	N	–rup, –rit
salliut¦inneqarsinnaaneq	N	{–inneqarsinnaanerup, –itinneqarsinnaanerup, –sinneqarsinnaanerup}, {–inneqarsinnaanerit, –itinneqarsinnaanerit, –sinneqarsinnaanerit}
salliuti¦ppaa	V	–nngilaa
salliut¦ippaa	V	{–itinngilaa, –sinngilaa}
salliutitassaassu¦seq	N	–tsip, –tsit
salliutitsine¦q	N	–rup, –rit
salliutittua¦rpaa	V	–nngilaa
salliu¦voq	V	–nngilaq
salli¦vaa	V	–nngilaa
salli¦voq	V	–nngilaq
sall¦oq	N	–up, –ut
salloqaatit	N, pl.	-
salloqittaane¦q	N	–rup, –rit
salloqittaasia¦q	N	–p, –t
salloqittaa¦siaq	N	{–siap, –tiliap}, {–siat, –tiliat}
salloqittaa¦siorneq	N	{–siornerup, –tiliornerup}, {–siornerit, –tiliornerit}
salloqittaa¦siorpoq	V	{–siunngilaq, –tiliunngilaq}
salloqittaat	N	–ip, –it
salloqittaavi¦k	N	–up, –it
salloqittaa¦vik	N	{–ffiup, –viup}, {–ffiit, –viit}
salloqittaa¦voq	V	–nngilaq
salloqitta¦gaq	N	–kkap, –kkat
salloqitta¦rpaa	V	–nngilaa
salloqittarsaar¦aa	V	–inngilaa
sallor¦orpoq	V	–unngilaq
sallu	N	–p, –t
sallugaju¦ppoq	V	–nngilaq
salluiornaqaaq	V	(no generation)
sallui¦orpaa	V	–unngilaa
Salluit	Prop, pl.	-
sallukuj¦ooq	N	–uup, –uut
sallukuju¦k	N	–up, –it
sallukujussu¦aq	N	–up, –it
sallukujuu¦voq	V	–nngilaq
salluli¦orpoq	V	–unngilaq
salluliuutig¦aa	V	–inngilaa
sallunaveeqqu¦serpaa	V	{–sinngilaa, –tilinngilaa}
sallunaveeqqut	N	–ip, –it
sallusaannarpoq	V	(no generation)
sallusui¦ppoq	V	–nngilaq
sallu¦suippoq	V	{–suinngilaq, –tuinngilaq}
sallusuissu¦seq	N	–tsip, –tsit
sallu¦suissuseq	N	{–suissutsip, –tuissutsip}, {–suissutsit, –tuissutsit}
sallusuissut	N	–ip, –it
sallu¦suissut	N, pl.	{–suissut, –suittut, –tuissut, –tuittut}
sallusuissutaa¦voq	V	–nngilaq
sallusuits¦oq	N	–up, –ut
sallutig¦aa	V	–inngilaa
sallutiginngisaanna¦rpaa	V	–nngilaa
sallutiginnikkajutt¦oq	N	–up, –ut
salluti¦ppaa	V	–nngilaa
sallut¦ooq	N	–uup, –uut
sallutoorsu¦aq	N	–up, –it
sallutoorsu¦uvoq	V	{–aanngilaq, –unngilaq}
sallutoorujussu¦uvoq	V	{–aanngilaq, –unngilaq}
sallutt¦orpoq	V	–unngilaq
sallutu¦voq	V	–nngilaq
salluus¦oq	N	–up, –ut
salluu¦voq	V	–nngilaq
sallu¦voq	V	–nngilaq
salmiakki	N	(no generation)
saloqqusi¦orpoq	V	–unngilaq
saloqqu¦siorpoq	V	{–siunngilaq, –tiliunngilaq}
saloqqusi¦voq	V	–nngilaq
saloqqut	N	–ip, –it
saloqqutaaru¦ppoq	V	–tinngilaq
saloqqutaa¦voq	V	–nngilaq
saloqqutit	N, pl.	-
saloqqutitaa¦rpoq	V	–nngilaq
salua¦rpaa	V	–nngilaa
salua¦rpoq	V	–nngilaq
saluarsa¦rpaa	V	–nngilaa
saluars¦erpaa	V	–inngilaa
salukkunnaa¦rpoq	V	–nngilaq
saluma¦voq	V	–nngilaq
salummaat	N	–ip, –it
salummaataa¦voq	V	–nngilaq
salumma¦rpaa	V	–nngilaa
salummarpoq	V	(no generation)
salummarsa¦rpaa	V	–nngilaa
salummarterpaa	V	(no generation)
saluni	N	–p, –t
salunikkunnaa¦rpoq	V	–nngilaq
salunippallaaqaaq	V	(no generation)
saluni¦ppoq	V	–nngilaq
salu¦ppoq	V	–nngilaq
salussi¦voq	V	–nngilaq
salutt¦oq	N	–up, –ut
samanersu¦aq	N	–up, –it
samanii¦ppoq	V	–nngilaq
samaniissima¦voq	V	–nngilaq
samaniittuarpoq	V	(no generation)
samanissaatsiarsu¦aq	N	–up, –it
samannga¦q	N	–p, –t
samannga¦rpoq	V	–nngilaq
samanngarsarn¦erpoq	V	–inngilaq
samma	Interj	(no generation)
sammarujussu¦aq	N	–up, –it
sammeqat	N	–ip, –it
sammeqataa¦voq	V	–nngilaq
sammeqqaannaa¦voq	V	–nngilaq
sammeqqaa¦voq	V	–nngilaq
sammeqqa¦q	N	–p, –t
sammeqqune¦q	N	–rup, –rit
sammersorne¦q	N	–rup, –rit
sammers¦orpaa	V	–unngilaa
sammerusuta¦q	N	–p, –t
sammillua¦rpoq	V	–nngilaq
samminanngilaq	V	(no generation)
sammineqa¦rpoq	V	–nngilaq
sammineqart¦oq	N	–up, –ut
sammisa¦q	N	–p, –t
sammisaqaqat	N	–ip, –it
sammisaqarfi¦k	N	–up, –it
sammisaqarne¦q	N	–rup, –rit
sammisar¦aa	V	–inngilaa
sammisarsima¦vaa	V	–nngilaa
sammisassaqartitsine¦q	N	–rup, –rit
sammisassaqartitsis¦oq	N	–up, –ut
sammi¦sippaa	V	{–sinngilaa, –tinngilaa}
sammis¦oq	N	–up, –ut
sammi¦vaa	V	–nngilaa
sammiveqarfi¦k	N	–up, –it
sammiveqataas¦oq	N	–up, –ut
sammivig¦aa	V	–inngilaa
sammivi¦k	N	–up, –it
sammiviliiffi¦k	N	–up, –it
sammiviliine¦q	N	–rup, –rit
sammiviliisinnaas¦oq	N	–up, –ut
sammi¦voq	V	–nngilaq
sammuka¦rpoq	V	–nngilaq
samungaanna¦rpoq	V	–nngilaq
samungaannarsima¦voq	V	–nngilaq
samungarsu¦aq	N	–up, –it
samungarujussu¦aq	N	–up, –it
samunnaakkuma¦vaa	V	–nngilaa
samunnaa¦ppaa	V	–tinngilaa
samunnaassi¦voq	V	–nngilaq
samunna¦rpoq	V	–nngilaq
samunnartaannarpoq	V	(no generation)
samuunangaatsia¦q	N	–p, –t
samuunaqqu¦ppoq	V	–tinngilaq
samuunarujussu¦aq	N	–up, –it
sanaakkumanngilaa	V	(no generation)
sanaalukkat	N, pl.	-
sanaalu¦ppoq	V	–nngilaq
sanaannaa¦q	N	–p, –t
sanaannaar¦aa	V	–inngilaa
sanaa¦ppaa	V	–tinngilaa
sanaa¦q	N	–p, –t
sanaar¦aa	V	–inngilaa
sanaarigunanngilaa	V	(no generation)
sanaarisima¦vaa	V	–nngilaa
sanaarsu¦ppoq	V	–nngilaq
sanaartoqaaq	V	(no generation)
sanaartorfigissaane¦q	N	–rup, –rit
sanaar¦torfigissaaneq	N	{–sorfigissaanerup, –torfigissaanerup}, {–sorfigissaanerit, –torfigissaanerit}
sanaartorfigiuminarsaane¦q	N	–rup, –rit
sanaar¦torfigiuminarsaaneq	N	{–sorfigiuminarsaanerup, –torfigiuminarsaanerup}, {–sorfigiuminarsaanerit, –torfigiuminarsaanerit}
sanaartorfigiuminarsa¦gaq	N	–kkap, –kkat
sanaar¦torfigiuminarsagaq	N	{–sorfigiuminarsakkap, –torfigiuminarsakkap}, {–sorfigiuminarsakkat, –torfigiuminarsakkat}
sanaartorfigiuminarsa¦rpaa	V	–nngilaa
sanaar¦torfigiuminarsarpaa	V	{–sorfigiuminarsanngilaa, –torfigiuminarsanngilaa}
sanaartorfi¦k	N	–up, –it
sanaar¦torfik	N	{–sorfiup, –torfiup}, {–sorfiit, –torfiit}
sanaartorfissa¦q	N	–p, –t
sanaar¦torfissaq	N	{–sorfissap, –torfissap}, {–sorfissat, –torfissat}
sanaartorfiunngitsut	N, pl.	-
sanaar¦torfiunngitsut	N, pl.	{–sorfiunngitsut, –torfiunngitsut}
sanaartorne¦q	N	–rup, –rit
sanaar¦torneq	N	{–sornerup, –tornerup}, {–sornerit, –tornerit}
sanaart¦orpaa	V	–unngilaa
sanaart¦orpoq	V	–unngilaq
sanaar¦torpoq	V	{–sunngilaq, –tunngilaq}
sanaartugassat	N, pl.	-
sanaar¦tugassat	N, pl.	{–sugassat, –tugassat}
sanaartugassiat	N, pl.	-
sanaar¦tugassiat	N, pl.	{–sugassiat, –tugassiat}
sanaassa¦q	N	–p, –t
sanaassaqanngilaq	V	(no generation)
sanaassi¦voq	V	–nngilaq
sanaffi¦k	N	–up, –it
sanajortorpoq	V	(no generation)
sanallua¦rpaa	V	–nngilaa
sanalu¦gaq	N	–kkap, –kkat
sanalukkat	N, pl.	-
sanalunne¦q	N	–rup, –rit
sanalu¦ppoq	V	–nngilaq
sanane¦q	N	–rup, –rit
sananeqaat	N	–ip, –it
sananerlu¦ppaa	V	–nngilaa
sanaqqi¦ppaa	V	–nngilaa
sanarfine¦q	N	–rup, –rit
sanarfisa¦q	N	–p, –t
sanarfisigisa¦rpaa	V	–nngilaa
sanarfi¦t	N	–sip, –sit
sanarfi¦vaa	V	–nngilaa
sanarfi¦voq	V	–nngilaq
sanarii¦gaq	N	–kkap, –kkat
sanarlaa¦q	N	–p, –t
sanar¦oorpoq	V	–uunngilaq
sanarroorti¦ppaa	V	–nngilaa
sanarroortitsi¦voq	V	–nngilaq
sanars¦orpaa	V	–unngilaa
sanarsorpoq	V	(no generation)
sanarsuia¦rpaa	V	–nngilaa
sanarsuia¦rpoq	V	–nngilaq
sanarujoorne¦q	N	–rup, –rit
sanaruj¦oorpoq	V	–uunngilaq
sanasinnaalluarpoq	V	(no generation)
sanas¦oq	N	–up, –ut
sanasuiu¦voq	V	–nngilaq
sanasunngornia¦q	N	–p, –t
sanasunngorniarne¦q	N	–rup, –rit
sanatitsiniart¦oq	N	–up, –ut
sanatitsis¦oq	N	–up, –ut
sanatitsi¦voq	V	–nngilaq
sana¦vaa	V	–nngilaa
sana¦voq	V	–nngilaq
saneqqiarfissaqqi¦ppoq	V	–nngilaq
saneqqiarna¦rpoq	V	–nngilaq
saneqqia¦rpoq	V	–nngilaq
saneqqiartaat	N	–ip, –it
saneqquffissa¦q	N	–p, –t
saneqqu¦ppaa	V	–tinngilaa
saneqqu¦ppoq	V	–tinngilaq
saneqqusunga¦rpaa	V	–nngilaa
saneqqu¦tsineq	N	{–ssinerup, –tsinerup}, {–ssinerit, –tsinerit}
saneqqu¦tsivoq	V	{–ssinngilaq, –tsinngilaq}
saneqqutt¦oq	N	–up, –ut
sane¦raq	N	{–qqap, –rap}, {–qqat, –rat}
sanerarlu¦ppoq	V	–nngilaq
sanerarmi¦oq	N	–up, –ut
sanerarmior¦aa	V	–inngilaa
sanerarmi¦ppaa	V	–nngilaa
sanerarmi¦ppoq	V	–nngilaq
sanerarmiu	N	–p, –t
sanerarut	N	–ip, –it
sanerfalla¦ppoq	V	–nngilaq
sanerfi¦k	N	–up, –it
san¦erpaa	V	–inngilaa
san¦erpoq	V	–inngilaq
sanersi¦ppaa	V	–nngilaa
sanersu¦k	N	–up, –it
sanersul¦ik	N	{–iup, –lip, –lup}, –lit
saner¦sulik	N	{–suliup, –sullip, –sullup, –tuliup, –tullip, –tullup}, {–sullit, –tullit}
sanersutt¦ooq	N	–uup, –uut
sangataa¦voq	V	–nngilaq
sangata¦k	N	–ap, –at
sangianne¦q	N	–rup, –rit
sangia¦ppoq	V	–nngilaq
sangiatt¦oq	N	–up, –ut
sangi¦ppaa	V	–nngilaa
sangi¦ppoq	V	–nngilaq
sangissart¦ooq	N	–uup, –uut
sangiu¦ppaa	V	–tinngilaa
sangiussine¦q	N	–rup, –rit
sangiussi¦voq	V	–nngilaq
sang¦oorpoq	V	–uunngilaq
sangorsu¦k	N	–up, –it
sangorsuttu¦voq	V	–nngilaq
sangujaa¦q	N	–p, –t
sangujaa¦rpoq	V	–nngilaq
sangujaarsu¦k	N	–up, –it
sangujartuaarpoq	V	(no generation)
sangujoqilaa¦rpoq	V	–nngilaq
sangujoqisaa¦rpoq	V	–nngilaq
sangujoraa¦rpoq	V	–nngilaq
sangune¦q	N	–rup, –rit
sangunerliorne¦q	N	–rup, –rit
sangunga¦voq	V	–nngilaq
sangusaapiloorfi¦k	N	–up, –it
sangusaapiloorne¦q	N	–rup, –rit
sangusaarfi¦k	N	–up, –it
sangusaarne¦q	N	–rup, –rit
sangusaa¦rpoq	V	–nngilaq
sangusaartart¦oq	N	–up, –ut
sangusa¦rpoq	V	–nngilaq
sangus¦oorpoq	V	–uunngilaq
sangussarilluinnarpoq	V	(no generation)
sangussari¦ppoq	V	–nngilaq
sangussarissi¦voq	V	–nngilaq
sangusussaane¦q	N	–rup, –rit
sangusussaa¦voq	V	–nngilaq
sanguti¦ppaa	V	–nngilaa
sangu¦voq	V	–nngilaq
sani	N	–p, –t
sanianii¦ppoq	V	–nngilaq
saniffalla¦ppoq	V	–nngilaq
sanigoriartorne¦q	N	–rup, –rit
sanigoriart¦orpoq	V	–unngilaq
sanigoriartuinna¦rpoq	V	–nngilaq
sanigorluinnarsimas¦oq	N	–up, –ut
sanigorne¦q	N	–rup, –rit
sanig¦orpoq	V	–unngilaq
sanigorsarne¦q	N	–rup, –rit
sanigorsarpoq	V	(no generation)
sanigors¦erpaa	V	–inngilaa
sanigorsimas¦oq	N	–up, –ut
sanigorsima¦voq	V	–nngilaq
sanigutit	N, pl.	-
saniguu¦ppaa	V	–tinngilaa
saniguutivi¦ppaa	V	–nngilaa
saniia¦rpaa	V	–nngilaa
sani¦iarpaa	V	{–ajanngilaa, –ianngilaa}
saniit	N	–ip, –it
saniit	N, pl.	-
sani¦k	N	–up, –it
sanikoorfi¦k	N	–up, –it
sanikoorfissi¦voq	V	–nngilaq
sanikoorfittaa¦rpoq	V	–nngilaq
sanikut	N, pl.	-
sanil¦eq	N	–ip, –it
sanileqa¦rpoq	V	–nngilaq
sanilequt	N	–ip, –it
sanilequt¦aq	N	{–ap, –tap}, {–at, –tat}
saniler¦aa	V	–inngilaa
sanilerigaju¦ppaa	V	–nngilaa
sanileriiaat	N, pl.	-
sanileriit	N, pl.	-
sanilerisaanna¦rpaa	V	–nngilaa
sanilia¦q	N	–p, –t
sanill¦erpaa	V	–inngilaa
sanillersima¦vaa	V	–nngilaa
sanilliunneqarsinnaas¦oq	N	–up, –ut
sanilliu¦ppaa	V	–tinngilaa
sanilliussine¦q	N	–rup, –rit
sanim¦oorpoq	V	–uunngilaq
sanimoortari¦aq	N	{–ssap, –ap}, {–ssat, –at}
sanimoortari¦aq	N	–ssap, –ssat
sanimorsorfig¦aa	V	–inngilaa
sanimors¦orpoq	V	–unngilaq
sanimukaaju¦voq	V	–nngilaq
sanimukaanneqa¦rpoq	V	–nngilaq
sanimukaa¦ppaa	V	–tinngilaa
sanimukaa¦q	N	–p, –t
sanimukaa¦rpoq	V	–nngilaq
sanimukaart¦oq	N	–up, –ut
sanimukaassi¦voq	V	–nngilaq
sanimuka¦rpoq	V	–nngilaq
sanimukartaannarpoq	V	(no generation)
sanimukart¦oq	N	–up, –ut
sanimukartua¦rpoq	V	–nngilaq
saning¦erpaa	V	–inngilaa
saningersima¦vaa	V	–nngilaa
saningers¦orpaa	V	–unngilaa
sanioqqu¦ppaa	V	{–nngilaa, –tinngilaa}
sanioqqu¦ppoq	V	–tinngilaq
sanioqqusunga¦rpaa	V	–nngilaa
sanioqqu¦tsisinnaannginneq	N	{–ssisinnaannginnerup, –tsisinnaannginnerup}, {–ssisinnaannginnerit, –tsisinnaannginnerit}
sanioqqu¦tsivoq	V	{–ssinngilaq, –tsinngilaq}
sanipi¦ppoq	V	–nngilaq
saniporta¦rpoq	V	–nngilaq
sanisa¦rpoq	V	–nngilaq
sanittoorsuu¦voq	V	–nngilaq
sanittoorsu¦uvoq	V	{–aanngilaq, –unngilaq}
sanittu¦voq	V	–nngilaq
saniutisi¦voq	V	–nngilaq
saniutitaa¦rpoq	V	–nngilaq
sa¦nna	Pron	–ssuma, {–kku, –kkua}
sannaats¦oq	N	–up, –ut
sannakkuma¦vaa	V	–nngilaa
sannakor¦aa	V	–inngilaa
sannaku	N	–p, –t
sannakuaqqat	N, pl.	-
sannakut	N, pl.	-
sanna¦ppaa	V	–tinngilaa
sanna¦ppoq	V	–tinngilaq
sanna¦q	N	–p, –t
sannari¦ppoq	V	–nngilaq
sannarissaa¦rpoq	V	–nngilaq
sannarissi¦voq	V	–nngilaq
sannasi¦orpoq	V	–unngilaq
sanna¦siorpoq	V	{–siunngilaq, –tiliunngilaq}
sannasiorsinnaa¦voq	V	–nngilaq
sanna¦siorsinnaavoq	V	{–siorsinnaanngilaq, –tiliorsinnaanngilaq}
sannasiortaannarpoq	V	(no generation)
sannassaajuarpoq	V	(no generation)
sannassaa¦voq	V	–nngilaq
sannassinnaa¦vaa	V	–nngilaa
sannassi¦voq	V	–nngilaq
sannat	N	–ip, –it
sannat	N, pl.	-
sannataars¦erpoq	V	–inngilaq
sannataarsertuarpoq	V	(no generation)
sannataa¦voq	V	–nngilaq
sannavi¦k	N	–up, –it
sannavittaa¦q	N	–p, –t
sanneriaaja¦rpoq	V	–nngilaq
sannerial¦erpaa	V	–inngilaa
sanneri¦aq	N	–ssap, –ssat
sann¦erpaa	V	–inngilaa
sann¦erpoq	V	–inngilaq
sannersart¦oq	N	–up, –ut
sannersima¦voq	V	–nngilaq
sannersi¦ppaa	V	–nngilaa
sanneru¦serpaa	V	{–sinngilaa, –tilinngilaa}
sannerut	N	–ip, –it
sannerutaaja¦rpoq	V	–nngilaq
sannerutil¦ik	N	{–iup, –lip, –lup}, –lit
sannerut¦serpaa	V	{–italinngilaa, –sinngilaa}
sanngiaat	N	–ip, –it
sanngia¦rpaa	V	–nngilaa
sanngiarti¦ppaa	V	–nngilaa
sanngiiffi¦k	N	–up, –it
sanngiikkajuppoq	V	(no generation)
sanngiilline¦q	N	–rup, –rit
sanngiillisimas¦oq	N	–up, –ut
sanngiillisima¦voq	V	–nngilaq
sanngiillisi¦ppaa	V	–nngilaa
sanngiilli¦voq	V	–nngilaq
sanngiinneru¦voq	V	–nngilaq
sanngii¦ppoq	V	–nngilaq
sanngiissu¦seq	N	–tsip, –tsit
sanngiissut	N	–ip, –it
sanngiissutig¦aa	V	–inngilaa
sanngiits¦oq	N	–up, –ut
sanngingas¦oq	N	–up, –ut
sanngi¦ppoq	V	–nngilaq
sanngi¦sooq	N	{–suup, –tuup}, {–suut, –tuut}
sanngi¦soorsuaq	N	{–soorsuup, –toorsuup}, {–soorsuit, –toorsuit}
sanngit	N	–ip, –it
sanngivallaaqaaq	V	(no generation)
sanngi¦voq	V	–nngilaq
sanngori¦ppoq	V	–nngilaq
sanngorli¦orpoq	V	–unngilaq
sannguig¦aa	V	–inngilaa
sannguigiti¦ppoq	V	–nngilaq
sanngui¦k	N	–up, –it
sannguissaaru¦ppoq	V	–tinngilaq
sannia¦rpaa	V	–nngilaa
sannikaa¦ppaa	V	–tinngilaa
sannikaatt¦oorpoq	V	–uunngilaq
sannika¦rpoq	V	–nngilaq
sannikarti¦ppaa	V	–nngilaa
sannikaru¦ppoq	V	–tinngilaq
sanningakannerpoq	V	(no generation)
sanningangajappoq	V	(no generation)
sanningas¦oq	N	–up, –ut
sanningasortal¦ik	N	{–iup, –lip, –lup}, –lit
sanningasorta¦q	N	–p, –t
sanningasul¦ik	N	{–iup, –lip, –lup}, –lit
sanninga¦voq	V	–nngilaq
sanninngaa¦rpaa	V	–nngilaa
sanninngaa¦rpoq	V	–nngilaq
sanninngaarti¦ppaa	V	–nngilaa
sanninngavig¦aa	V	–inngilaa
sanninngavigillua¦rpaa	V	–nngilaa
sanninngavigiuarpaa	V	(no generation)
sanni¦ppoq	V	–nngilaq
sannisa¦rpoq	V	–nngilaq
sapaassu¦aq	N	–up, –it
sapaat	N	–ip, –it
sapaataanngilaq	V	(no generation)
sapaataaru¦ppoq	V	–tinngilaq
sapaataarutinngilaq	V	(no generation)
sapaataa¦voq	V	–nngilaq
sapaatikkut	N, pl.	-
sapaatisiorlua¦rpoq	V	–nngilaq
sapaatisi¦orpoq	V	–unngilaq
sapaatisiortaannarpoq	V	(no generation)
sapaatisiut	N	–ip, –it
sapaatisiutit	N, pl.	-
sapaatiu¦voq	V	–nngilaq
sapangaa¦raq	N	–qqap, –qqat
sapangaasa¦q	N	–p, –t
sapangaasat	N, pl.	-
sapangaasia¦q	N	–p, –t
sapangaa¦siaq	N	{–siap, –tiliap}, {–siat, –tiliat}
sapan¦gaq	N	–ngap, –ngat
sapangarsu¦aq	N	–up, –it
sapangartaa¦rpoq	V	–nngilaq
sapangi¦aq	N	–ssap, –ssat
sapangi¦ppaa	V	–nngilaa
sapangisi¦ppaa	V	–nngilaa
sapangita¦q	N	–p, –t
sapangitaqanngilaq	V	(no generation)
sapangitt¦oorpaa	V	–uunngilaa
sapanngariss¦oq	N	–up, –ut
sapanngarissorsiort¦oq	N	–up, –ut
sapanngarissuu¦voq	V	–nngilaq
sapassi¦ppaa	V	–nngilaa
sapassisa¦q	N	–p, –t
sapassisi¦ppaa	V	–nngilaa
sapassi¦sippaa	V	{–sinngilaa, –tinngilaa}
sapassi¦vaa	V	–nngilaa
saperasug¦aa	V	–inngilaa
saperfeeru¦ppoq	V	–tinngilaq
saperiag¦aa	V	–inngilaa
saperiagivi¦ppaa	V	–nngilaa
saperiatsaa¦ppaa	V	–tinngilaa
saperlu¦innarpaa	V	{–aannanngilaa, –innanngilaa}
sapernaallak	Interj	(no generation)
sapernaqaaq	V	(no generation)
saperna¦rpoq	V	–nngilaq
sapernart¦oq	N	–up, –ut
sapernera¦rpaa	V	–nngilaa
saperngui¦k	N	–up, –it
saperngusa¦rpoq	V	–nngilaq
saperngu¦voq	V	–nngilaq
saperni¦voq	V	–nngilaq
sapernuffi¦k	N	–up, –it
sapernui¦k	N	–up, –it
sapernusa¦rpoq	V	–nngilaq
sapernus¦oq	N	–up, –ut
sapernussutig¦aa	V	–inngilaa
sapernu¦voq	V	–nngilaq
sap¦erpaa	V	–inngilaa
saperparaa¦rpoq	V	–nngilaq
saperparaartaanna¦rpoq	V	–nngilaq
sap¦erpoq	V	–inngilaq
saper¦saatigaa	V	{–saatiginngilaa, –taatiginngilaa}
sapersa¦rpoq	V	–nngilaq
sapersinne¦q	N	–rup, –rit
sapersi¦ppaa	V	–nngilaa
sapersi¦ppoq	V	–nngilaq
sapersitsaa¦rpaa	V	–nngilaa
sapersitsaa¦rpoq	V	–nngilaq
sapertuaanna¦rpoq	V	–nngilaq
saperunnaa¦rpaa	V	–nngilaa
saperuttaalli¦orpoq	V	–unngilaq
saperuttaa¦ppoq	V	–nngilaq
saperuttaats¦oq	N	–up, –ut
saperutta¦rpoq	V	–nngilaq
saperuttartuu¦voq	V	–nngilaq
sapigaa¦voq	V	–nngilaq
sapigal¦ik	N	{–iup, –lip, –lup}, –lit
sapi¦gaq	N	–kkap, –kkat
sapigaqanngilaq	V	(no generation)
sapigaqarne¦q	N	–rup, –rit
sapigaqart¦oq	N	–up, –ut
sapigassi¦ppaa	V	–nngilaa
sapiillisaa¦rpoq	V	–nngilaq
sapiillisa¦rpoq	V	–nngilaq
sapiilli¦voq	V	–nngilaq
sapiinnersaa¦voq	V	–nngilaq
sapiinneru¦voq	V	–nngilaq
sapiippallaanngilaq	V	(no generation)
sapiippalu¦ppoq	V	–nngilaq
sapii¦ppoq	V	–nngilaq
sapiiserajuppoq	V	(no generation)
sapiiserne¦q	N	–rup, –rit
sapiiserpallaa¦rpoq	V	–nngilaq
sapiiserpallaart¦oq	N	–up, –ut
sapiis¦erpoq	V	–inngilaq
sapiisersaanna¦rpoq	V	–nngilaq
sapiiseruma¦voq	V	–nngilaq
sapiisinngilaq	V	(no generation)
sapiissu¦seq	N	–tsip, –tsit
sapiissuseqarne¦q	N	–rup, –rit
sapiits¦oq	N	–up, –ut
sapiitsuli¦orpoq	V	–unngilaq
sapiitsuliort¦oq	N	–up, –ut
sapileqqajaalluinnarpoq	V	(no generation)
sapileqqajaane¦q	N	–rup, –rit
sapileqqajaavoq	V	(no generation)
sapileraluttuinnarpaa	V	(no generation)
sapilerne¦q	N	–rup, –rit
sapil¦erpaa	V	–inngilaa
sapil¦erpoq	V	–inngilaq
sapilersima¦voq	V	–nngilaq
sapiler¦soq	N	{–sup, –tup}, {–sut, –tut}
sapilingajatta¦rpoq	V	–nngilaq
sapilingajattooraluarpoq	V	(no generation)
sapinngilaa	V	(no generation)
sapinngilaq	V	(no generation)
sapinngisa¦q	N	–p, –t
sapinngisaqarne¦q	N	–rup, –rit
sapinngits¦oq	N	–up, –ut
sapisi¦voq	V	–nngilaq
sapissangati¦ppaa	V	–nngilaa
sapissanga¦vaa	V	–nngilaa
sapissanga¦voq	V	–nngilaq
sapiuffig¦aa	V	–inngilaa
sapiuilluinnarpoq	V	(no generation)
sapiuinnersaa¦voq	V	–nngilaq
sapiui¦ppoq	V	–nngilaq
sapiukkajuppoq	V	(no generation)
sapiu¦ppaa	V	–tinngilaa
sapiu¦ppoq	V	–tinngilaq
sapiu¦tilerneq	N	{–tilernerup, –tsilernerup, –sernerup}, {–tilernerit, –tsilernerit, –sernerit}
sapiut¦inngisaannarpoq	V	{–inngisaannanngilaq, –sinngisaannanngilaq}
sapiuttaannarpoq	V	(no generation)
sapi¦vaa	V	–nngilaa
sapu¦aa	V	–nngilaa
sapu¦ppaa	V	–nngilaa
sapu¦serpaa	V	{–sinngilaa, –tilinngilaa}
sapu¦sersorpaa	V	{–sersunngilaa, –tilersunngilaa}
sapusia¦q	N	–p, –t
sapu¦siaq	N	{–siap, –tiliap}, {–siat, –tiliat}
sapu¦siineq	N	{–siinerup, –tiliinerup}, {–siinerit, –tiliinerit}
sapusi¦orpaa	V	–unngilaa
sapusi¦orpoq	V	–unngilaq
sapu¦siorpoq	V	{–siunngilaq, –tiliunngilaq}
sapussualia¦q	N	–p, –t
saput	N	–ip, –it
saputaa¦rpaa	V	–nngilaa
saputit	N, pl.	-
saputta¦rpaa	V	–nngilaa
saqiallanne¦q	N	–rup, –rit
saqialla¦ppoq	V	–nngilaq
saqiallatta¦rpoq	V	–nngilaq
saqigiikkut	N, pl.	-
saqillua¦rpoq	V	–nngilaq
saqinne¦q	N	–rup, –rit
saqioqilaarpallaaqaaq	V	(no generation)
saqioqilaa¦rpoq	V	–nngilaq
saqi¦ppaa	V	–nngilaa
saqi¦ppoq	V	–nngilaq
saqisaa¦ppaa	V	–tinngilaa
saqisaa¦q	N	–p, –t
saqisaa¦rpoq	V	–nngilaq
saqisaartaannarpoq	V	(no generation)
saqisaaru¦ppaa	V	–tinngilaa
saqisart¦oq	N	–up, –ut
saqis¦erpoq	V	–inngilaq
saqisi	N	–p, –t
saqi¦sippaa	V	{–sinngilaa, –tinngilaa}
saqis¦oq	N	–up, –ut
saqissaane¦q	N	–rup, –rit
saqissaanngilaq	V	(no generation)
saqissu¦ppaa	V	–nngilaa
saqissu¦ppaa	V	–tinngilaa
saqisua¦raq	N	–qqap, –qqat
saqisuu¦voq	V	–nngilaq
saqit¦erpoq	V	–inngilaq
saqitsaane¦q	N	–rup, –rit
saqitsaanne¦q	N	–rup, –rit
saqitsaa¦ppaa	V	–tinngilaa
saqitsaassi¦voq	V	–nngilaq
saqitsaassu¦seq	N	–tsip, –tsit
saqitsaassut	N	–ip, –it
saqitsaat	N	–ip, –it
saqitsa¦rpaa	V	–nngilaa
saqi¦tseriarpoq	V	{–sserianngilaq, –tserianngilaq}
saqitserii¦ppoq	V	–nngilaq
saqitseriissu¦seq	N	–tsip, –tsit
saqi¦tseriissuseq	N	{–sseriissutsip, –tseriissutsip}, {–sseriissutsit, –tseriissutsit}
saqitserii¦tsoq	N	–tsup, {–ssut, –tsut, –ttut}
saqitseriivi¦ppoq	V	–nngilaq
saqi¦tsippaa	V	{–ssinngilaa, –tsinngilaa}
saqitt¦oorpoq	V	–uunngilaq
saqi¦vaa	V	–nngilaa
saqi¦voq	V	–nngilaq
saqqaaja¦rpaa	V	–nngilaa
saqqaaja¦rpoq	V	–nngilaq
saqqaa¦rpaa	V	–nngilaa
saqqaa¦voq	V	–nngilaq
saqqang¦erpaa	V	–inngilaa
saqqangers¦orpaa	V	–unngilaa
saqqangiu¦ppaa	V	–tinngilaa
saqqangiu¦ppoq	V	–tinngilaq
saqqangiussaa¦voq	V	–nngilaq
saqqanni¦ppoq	V	–nngilaq
saqqa¦ppoq	V	–nngilaq
Saqqa¦q	N	–ap, –at
Saqqa¦q	Prop	–p
saqqa¦q	N	–ap, –at
saqqarfigisa¦q	N	–p, –t
saqqari¦ppoq	V	–nngilaq
saqqarlua¦rpaa	V	–nngilaa
saqqarlu¦innarpaa	V	{–aannanngilaa, –innanngilaa}
saqqarmi¦oq	N	–up, –ut
saqqarmioqa¦rpoq	V	–nngilaq
saqqarmiortaa¦rpoq	V	–nngilaq
saqqarmiu	N	–p, –t
saqqarmiulers¦orpaa	V	–unngilaa
saqqarmiuligaa¦voq	V	–nngilaq
saqqarmiulisaa¦rpoq	V	–nngilaq
saqqarmiuusa¦q	N	–p, –t
saqqa¦rpaa	V	–nngilaa
saqqarpasi¦k	N	–up, –it
saqqarpasi¦ppoq	V	–nngilaq
saqqa¦rpoq	V	–nngilaq
saqqarsarne¦q	N	–rup, –rit
saqqarsarn¦erpoq	V	–inngilaq
saqqarsarnileqaaq	V	(no generation)
saqqarsima¦vaa	V	–nngilaa
saqqassima¦voq	V	–nngilaq
saqq¦erpaa	V	–inngilaa
saqqillua¦rpaa	V	–nngilaa
saqqi¦ppaa	V	–nngilaa
saqqisaa¦rpoq	V	–nngilaq
saqqisaarti¦ppaa	V	–nngilaa
saqqissa¦q	N	–p, –t
saqqissi¦voq	V	–nngilaq
saqqumilaarne¦q	N	–rup, –rit
saqqumilaa¦rpoq	V	–nngilaq
saqqumilaartitsine¦q	N	–rup, –rit
saqquminerpaa¦voq	V	{–junngilaq, –nngilaq}
saqquminngits¦oq	N	–up, –ut
saqqumis¦oq	N	–up, –ut
saqqumitiinna¦rpaa	V	–nngilaa
saqqumiti¦ppaa	V	–nngilaa
saqqumi¦voq	V	–nngilaq
saqqummeeqqaa¦rpoq	V	–nngilaq
saqqummeeriaa¦seq	N	–tsip, –tsit
saqqummeqqi¦ppoq	V	–nngilaq
saqqummerfig¦aa	V	–inngilaa
saqqummerne¦q	N	–rup, –rit
saqqumm¦erpaa	V	–inngilaa
saqqumm¦erpoq	V	–inngilaq
saqqummer¦sinneqartoq	N	{–sinneqartup, –tinneqartup}, {–sinneqartut, –tinneqartut}
saqqummer¦sippaa	V	{–sinngilaa, –tinngilaa}
saqqummer¦sitaq	N	{–sitap, –titap}, {–sitat, –titat}
Saqqummer¦sitat	N, pl.	{–sitat, –titat}
saqqummer¦sitseqatigiinneq	N	{–sitseqatigiinnerup, –siteqatigiinnerup, –titseqatigiinnerup}, {–sitseqatigiinnerit, –siteqatigiinnerit, –titseqatigiinnerit}
saqqummer¦sitsineq	N	{–sitsinerup, –titsinerup}, {–sitsinerit, –titsinerit}
saqqummer¦sitsinerit	N, pl.	{–sitsinerit, –titsinerit}
saqqummer¦sitsinersuaq	N	{–sitsinersuup, –titsinersuup}, {–sitsinersuit, –titsinersuit}
saqqummer¦sitsisarfik	N	{–sitsisarfiup, –titsisarfiup}, {–sitsisarfiit, –titsisarfiit}
saqqummer¦sitsisarneq	N	{–sitsisarnerup, –titsisarnerup}, {–sitsisarnerit, –titsisarnerit}
saqqummer¦sitsisartoq	N	{–sitsisartup, –titsisartup}, {–sitsisartut, –titsisartut}
saqqummer¦sitsisoq	N	{–sitsisup, –titsisup}, {–sitsisut, –titsisut}
saqqummersitsi¦vik	N	{–ffiup, –viup}, {–ffiit, –viit}
saqqummer¦sitsivoq	V	{–sitsinngilaq, –titsinngilaq}
saqqummigaa¦voq	V	–nngilaq
saqqummi¦gaq	N	–kkap, –kkat
saqqummigassaa¦voq	V	–nngilaq
saqqummigassa¦q	N	–p, –t
saqqummiine¦q	N	–rup, –rit
saqqummiisaqa¦rpoq	V	–nngilaq
saqqummii¦voq	V	–nngilaq
saqqummilaanngilaq	V	(no generation)
saqqummilerne¦q	N	–rup, –rit
saqqummiler¦soq	N	{–sup, –tup}, {–sut, –tut}
saqqummiunneqart¦oq	N	–up, –ut
saqqummiu¦ppaa	V	–tinngilaa
saqqummiuppoq	V	(no generation)
saqqummiussaa¦voq	V	–nngilaq
saqqummiussa¦q	N	–p, –t
saqqummiussine¦q	N	–rup, –rit
saqqummiussisinnaane¦q	N	–rup, –rit
saqqummiussis¦oq	N	–up, –ut
Saqqummiussissut	N	–ip, –it
saqqummiussi¦vissaq	N	{–ffissap, –vissap}, {–ffissat, –vissat}
saqqummiussi¦voq	V	–nngilaq
saraja¦ppoq	V	–nngilaq
sarajatsi¦ppoq	V	–nngilaq
sarajattuinnaa¦voq	V	–nngilaq
sara¦ppoq	V	–nngilaq
sarass¦erpoq	V	–inngilaq
sarassersima¦voq	V	–nngilaq
sarassi¦vaa	V	–nngilaa
sarfaalaa¦rpoq	V	–nngilaq
sarfaa¦ppaa	V	–tinngilaa
sarfaa¦ppoq	V	–tinngilaq
sarfaa¦rpoq	V	–nngilaq
sarfaarukkiart¦orpoq	V	–unngilaq
sarfaarunne¦q	N	–rup, –rit
sarfaaru¦ppoq	V	–tinngilaq
sarfaarutivi¦ppoq	V	–nngilaq
sarfaassaane¦q	N	–rup, –rit
sarfaassaa¦voq	V	–nngilaq
sarfaassinnaa¦vaa	V	–nngilaa
sarfakuju¦k	N	–up, –it
sarfakujussu¦aq	N	–up, –it
sarfalerfi¦k	N	–up, –it
sarfaleris¦oq	N	–up, –ut
sarfaler¦suut	N	{–suutip, –tuutip}, {–suutit, –tuutit}
Sarfannguit	N, pl.	-
Sarfannguit	Prop, pl.	-
sarfa¦q	N	{–p, –rup}, {–t, –rit}
sarfaqarfi¦k	N	–up, –it
sarfarinne¦q	N	–rup, –rit
sarfari¦ppoq	V	–nngilaq
sarfarissiart¦orpoq	V	–unngilaq
sarfarissi¦voq	V	–nngilaq
sarfarlerne¦q	N	–rup, –rit
sarfarl¦erpoq	V	–inngilaq
sarfarne¦q	N	–rup, –rit
sarfa¦rpoq	V	–nngilaq
sarfars¦erpoq	V	–inngilaq
sarfarsiataa¦rpoq	V	–nngilaq
sarfarsi¦orpoq	V	–unngilaq
sarfarsu¦aq	N	–up, –it
sarfartorsu¦uvoq	V	{–aanngilaq, –unngilaq}
sarlanikut	N, pl.	-
sarliaa¦voq	V	–nngilaq
sarliagaa¦voq	V	–nngilaq
sarlia¦q	N	–p, –t
sarliar¦aa	V	–inngilaa
sarlia¦rpaa	V	–nngilaa
sarlia¦rpoq	V	–nngilaq
sarliarti¦ppoq	V	–nngilaq
sarliart¦oq	N	–up, –ut
sarliarumatuvoq	V	(no generation)
sarliss¦erpaa	V	–inngilaa
sarliss¦erpoq	V	–inngilaq
sarlissiu¦ppaa	V	–tinngilaa
sarmi¦ppaa	V	–nngilaa
sarmissaa¦voq	V	–nngilaq
sarmissa¦rpaa	V	–nngilaa
sarpigaanngitsoorpoq	V	(no generation)
sarpigaa¦rpoq	V	–nngilaq
sarpi¦k	N	–up, –it
sarpilee¦raq	N	–qqap, –qqat
sarpil¦eeraq	N	{–eeqqap, –iaqqap}, {–eeqqat, –iaqqat}
sarpil¦ik	N	{–iup, –lip, –lup}, –lit
sarpimmi¦ppaa	V	–nngilaa
sarpingas¦oorpoq	V	–uunngilaq
sarpinga¦voq	V	–nngilaq
sarpinnaa¦q	N	–p, –t
sarpinnaaqa¦rpoq	V	–nngilaq
sarpinna¦ppoq	V	–nngilaq
sarpinnassima¦voq	V	–nngilaq
sarpiss¦orpoq	V	–unngilaq
sarpitsug¦aa	V	–inngilaa
sarpitsu¦ppoq	V	–nngilaq
sarpitt¦orpoq	V	–unngilaq
sarpiusaaju¦voq	V	–nngilaq
sarpiusaa¦q	N	–p, –t
sarpiusa¦q	N	–p, –t
sarrikkiart¦orpoq	V	–unngilaq
sarri¦ppoq	V	–nngilaq
sarrisi¦ppaa	V	–nngilaa
sarris¦oorpoq	V	–uunngilaq
sarri¦voq	V	–nngilaq
sarsaa¦voq	V	–nngilaq
sarsakataa¦voq	V	–nngilaq
sarsakattaa¦rpoq	V	–nngilaq
sarsakattaa¦voq	V	–nngilaq
sarsakatta¦k	N	–ap, –at
sarsa¦q	N	–p, –t
sarsa¦rpoq	V	–nngilaq
sarsuane¦q	N	–rup, –rit
sarsuatitsine¦q	N	–rup, –rit
sarsuatitsi¦voq	V	–nngilaq
sarsuatseeria¦rpoq	V	–nngilaq
sarsuatsii¦voq	V	–nngilaq
sarsua¦voq	V	–nngilaq
sarsukkiart¦orpaa	V	–unngilaa
sarsukkiart¦orpoq	V	–unngilaq
sarsu¦ppaa	V	–nngilaa
sarsu¦ppoq	V	–nngilaq
sarsutissaa¦rpoq	V	–nngilaq
sarsuttaannarpoq	V	(no generation)
sassaaffig¦aa	V	–inngilaa
sassaakkuma¦vaa	V	–nngilaa
sassaallerfig¦aa	V	–inngilaa
sassaallerfi¦k	N	–up, –it
sassaall¦erpoq	V	–inngilaq
sassaalliuteqarne¦q	N	–rup, –rit
sassaalliutig¦aa	V	–inngilaa
sassaa¦ppaa	V	–tinngilaa
sassaassi¦voq	V	–nngilaq
sassaa¦voq	V	–nngilaq
sassagaa¦voq	V	–nngilaq
sassa¦gaq	N	–kkap, –kkat
sassagassa¦q	N	–p, –t
sassa¦q	N	–p, –t
sassarfig¦aa	V	–inngilaa
sassa¦rpaa	V	–nngilaa
sassa¦rpoq	V	–nngilaq
sassartaa¦q	N	–p, –t
sassart¦erpoq	V	–inngilaq
sassartitaane¦q	N	–rup, –rit
sassartita¦q	N	–p, –t
sassasi¦ppoq	V	–nngilaq
sassasissorsu¦uvoq	V	{–aanngilaq, –unngilaq}
sassasi¦ssorsuuvoq	V	{–ssorsuaanngilaq, –ssorsuunngilaq, –ttorsuaanngilaq, –ttorsuunngilaq}
sassasissumii¦ppoq	V	–nngilaq
sassasi¦ssumiippoq	V	{–ssumiinngilaq, –ttumiinngilaq}
sassat	N, pl.	-
sassiaa¦voq	V	–nngilaq
sassia¦q	N	–p, –t
sassia¦rpoq	V	–nngilaq
sassiartaannarpoq	V	(no generation)
sassine¦q	N	–rup, –rit
sassi¦voq	V	–nngilaq
sassuagus¦erpoq	V	–inngilaq
sassuagu¦serpoq	V	{–sinngilaq, –tilinngilaq}
sassuagut	N	–ip, –it
sassuagut	N, pl.	-
satsaa¦voq	V	–nngilaq
satsa¦q	N	–p, –t
satsavig¦aa	V	–inngilaa
satsavigisaa¦voq	V	–nngilaq
sats¦erpoq	V	–inngilaq
satsia¦rpoq	V	–nngilaq
satsiartumii¦ppoq	V	–nngilaq
satsinne¦q	N	–rup, –rit
satsi¦ppaa	V	–nngilaa
satsi¦ppoq	V	–nngilaq
satsissaanngilaq	V	(no generation)
satsissaa¦voq	V	–nngilaq
satsissunii¦ppoq	V	–nngilaq
satsittuarpoq	V	(no generation)
satsiut	N	–ip, –it
satsiut	N, pl.	-
satsiuteqa¦rpoq	V	–nngilaq
satsiutil¦ik	N	{–iup, –lip, –lup}, –lit
satsivi¦k	N	–up, –it
sattaa¦rpaa	V	–nngilaa
sattaartuannguarpaa	V	(no generation)
sattaas¦erpaa	V	–inngilaa
sattaa¦serpaa	V	{–sinngilaa, –tilinngilaa}
sattaas¦erpoq	V	–inngilaq
sattaa¦serpoq	V	{–sinngilaq, –tilinngilaq}
sattaat	N	–ip, –it
sattakkunnaa¦rpoq	V	–nngilaq
satta¦ppoq	V	–nngilaq
sattatsi¦ppaa	V	–nngilaa
sattatsitsi¦voq	V	–nngilaq
sattatt¦oq	N	–up, –ut
satuumm¦erpoq	V	–inngilaq
Saudi-Arabiam¦eersoq	N	{–eersup, –eertup, –inngaanneersup, –inngaanneertup}, {–eersut, –eertut, –inngaanneersut, –inngaanneertut}
Saudi-Arabiamioq	N	(no generation)
Saudi-Arabiamiu	N	–p, –t
sava	N	–p, –t
savaanna¦q	N	–ap, –at
savaa¦raq	N	–qqap, –qqat
savaararsi¦voq	V	–nngilaq
savaarnia¦rpoq	V	–nngilaq
savaarniut	N	–ip, –it
savaa¦rpoq	V	–nngilaq
savaasaaraa¦voq	V	–nngilaq
savaasaa¦raq	N	–qqap, –qqat
savaasaasaa¦rpoq	V	–nngilaq
savaasaasivi¦k	N	–up, –it
savaasa¦q	N	–p, –t
savaasarna¦q	N	–p, –t
savaasarsu¦aq	N	–up, –it
savaat	N	–ip, –it
savaateqarfi¦k	N	–up, –it
savaateqarne¦q	N	–rup, –rit
savaatil¦ik	N	{–iup, –lip, –lup}, –lit
savaatilissu¦aq	N	–up, –it
savaatil¦issuaq	N	{–ersuup, –issuup}, {–ersuit, –issuit}
savaatit	N, pl.	-
savaleris¦oq	N	–up, –ut
Savalimmiormioq	N	(no generation)
Savalimmi¦ormiu	N	{–ormiup, –umiup}, {–ormiut, –umiut}
Savalimmiut	Prop, pl.	-
savali¦orpoq	V	–unngilaq
savarne¦q	N	–rup, –rit
savarnia¦rpoq	V	–nngilaq
savarpalaa¦rpoq	V	–nngilaq
sava¦rpoq	V	–nngilaq
savarsi¦orpoq	V	–unngilaq
savarsi¦voq	V	–nngilaq
savee¦raq	N	–qqap, –qqat
sav¦eeraq	N	{–eeqqap, –iaqqap}, {–eeqqat, –iaqqat}
saveerarsi¦voq	V	–nngilaq
sav¦eerarsivoq	V	{–eerarsinngilaq, –iararsinngilaq}
saveerartaa¦rpoq	V	–nngilaq
sav¦eerartaarpoq	V	{–eerartaanngilaq, –iarartaanngilaq}
saveers¦erpoq	V	–inngilaq
savequseri¦voq	V	–nngilaq
savequ¦serivoq	V	{–serinngilaq, –tilerinngilaq}
savequsi¦orpoq	V	–unngilaq
savequ¦siorpoq	V	{–siunngilaq, –tiliunngilaq}
savequt	N	–ip, –it
savequ¦tilerineq	N	{–serinerup, –tilerinerup}, {–serinerit, –tilerinerit}
savequtit	N, pl.	-
saver¦orpaa	V	–unngilaa
saver¦orpoq	V	–unngilaq
saverortitsi¦voq	V	–nngilaq
saveru¦gaq	N	–kkap, –kkat
saveruut	N	–ip, –it
saviarpalu¦ppoq	V	–nngilaq
saviatsi	N	–p, –t
saviffi¦k	N	–up, –it
savigaat	N	–ip, –it
savi¦k	N	–up, –it
savikkaarpalu¦ppoq	V	–nngilaq
savilers¦orpoq	V	–unngilaq
savili¦orpoq	V	–unngilaq
saviliort¦oq	N	–up, –ut
saviminaaqi¦voq	V	–nngilaq
savim¦ineq	N	–ernup, –ernit
saviminerpalu¦ppoq	V	–nngilaq
saviminer¦taq	N	{–sap, –tap}, {–sat, –tat}
saviminilerine¦q	N	–rup, –rit
Saviminilerinermik Ilinniarfi¦k	Prop	–up, –it
saviminissa¦q	N	–p, –t
saviminissaqarfi¦k	N	–up, –it
saviminissarsiorfi¦k	N	–up, –it
saviminiu¦voq	V	–nngilaq
savinnaa¦q	N	–p, –t
savinng¦orpoq	V	–unngilaq
savi¦ppaa	V	–nngilaa
savi¦ppoq	V	–nngilaq
savissa¦q	N	–p, –t
savissaqqi¦ppoq	V	–nngilaq
savissima¦voq	V	–nngilaq
Savissivi¦k	N	–up, –it
Savissivi¦k	Prop	–up, –it
savit¦ooq	N	–uup, –uut
savitoorfig¦aa	V	–inngilaa
savit¦oorpoq	V	–uunngilaq
savitoorsu¦aq	N	–up, –it
savitoortaannarpoq	V	(no generation)
savitsia¦q	N	–ap, –at
savitsi¦voq	V	–nngilaq
savittaa¦rpoq	V	–nngilaq
savittart¦oq	N	–up, –ut
savi¦ttartoq	N	{–ssartup, –ttartup}, {–ssartut, –ttartut}
savitt¦orpoq	V	–unngilaq
savittoruttorne¦q	N	–rup, –rit
savituallaaqaaq	V	(no generation)
savitui¦ppoq	V	–nngilaq
savituj¦oorpoq	V	–uunngilaq
savitunersaa¦voq	V	–nngilaq
savitu¦voq	V	–nngilaq
saviusart¦orpoq	V	–unngilaq
saviusar¦torpoq	V	{–sunngilaq, –tunngilaq}
Schweizim¦eersoq	N	{–eersup, –eertup, –inngaanneersup, –inngaanneertup}, {–eersut, –eertut, –inngaanneersut, –inngaanneertut}
Schweiz¦imiu	N	{–ermiup, –imiup}, {–ermiut, –imiut}
s¦eeq	N	–iip, –iit
seeqqerngi¦voq	V	–nngilaq
seeqq¦ernit	N, pl.	{–ernit, –inerit}
seeqqerni¦voq	V	–nngilaq
seeqq¦ineq	N	{–ernup, –inerup}, {–ernit, –inerit}
seeqqinissaaru¦ppoq	V	–tinngilaq
seeqqinissa¦q	N	–p, –t
seeqqinissarsi¦voq	V	–nngilaq
seeqqinni¦voq	V	–nngilaq
seeqq¦oq	N	–up, –ut
seeqqormi¦ppaa	V	–nngilaa
seeqq¦orpaa	V	–unngilaa
seeqqor¦sorneq	N	{–sornerup, –tornerup}, {–sornerit, –tornerit}
seeqqortarfi¦k	N	–up, –it
seeqquakits¦oq	N	–up, –ut
seeqqual¦ik	N	{–iup, –lip, –lup}, –lit
seeqqua¦q	N	–p, –t
seeqqua¦rpoq	V	–nngilaq
seeqquarsima¦voq	V	–nngilaq
seeqquart¦ooq	N	–uup, –uut
seeqqulul¦erpoq	V	–inngilaq
seeqqulu¦ppoq	V	–nngilaq
seeqqulutt¦oq	N	–up, –ut
seeqqumiarfig¦aa	V	–inngilaa
seeqqumiarfi¦k	N	–up, –it
seeqqumia¦rpoq	V	–nngilaq
seeqqumiart¦orpoq	V	–unngilaq
seeqqummerfig¦aa	V	–inngilaa
seeqqummerfi¦k	N	–up, –it
seeqqumm¦erpoq	V	–inngilaq
seeqqummersimaannarpoq	V	(no generation)
seerasaa¦rpaa	V	–nngilaa
seerig¦aa	V	–inngilaa
seerine¦q	N	–rup, –rit
seerisoorne¦q	N	–rup, –rit
seeris¦oorpoq	V	–uunngilaq
seeriuarpoq	V	(no generation)
seeri¦voq	V	–nngilaq
seerlaa¦voq	V	–nngilaq
seerla¦k	N	–ap, –at
seernaa¦raq	N	–qqap, –qqat
seernaasa¦q	N	–p, –t
seernaasat	N, pl.	-
seernaat	N	–ip, –it
seernal¦erpaa	V	–inngilaa
seernal¦erpoq	V	–inngilaq
seerna¦q	N	–p, –t
seernaqarne¦q	N	–rup, –rit
seernarpallaaqaaq	V	(no generation)
seerna¦rpoq	V	–nngilaq
seernarsaa¦serpaa	V	{–sinngilaa, –tilinngilaa}
seernarsaat	N	–ip, –it
seernarsaatissa¦q	N	–p, –t
seernarsis¦oorpoq	V	–uunngilaq
seernarsi¦voq	V	–nngilaq
seernart¦oq	N	–up, –ut
seernartoqassu¦seq	N	–tsip, –tsit
seernartuinnaa¦voq	V	–nngilaq
seernar¦tuinnaavoq	V	{–tuinnaanngilaq, –suinnaanngilaq}
seernartuli¦gaq	N	–kkap, –kkat
seernartulii¦voq	V	–nngilaq
seernartussa¦q	N	–p, –t
seernassu¦seq	N	–tsip, –tsit
seerne¦q	N	–rup, –rit
s¦eerpoq	V	–iinngilaq
seersaarne¦q	N	–rup, –rit
seer¦saarneq	N	{–saarnerup, –taarnerup}, {–saarnerit, –taarnerit}
seersaa¦rpoq	V	–nngilaq
seersart¦oq	N	–up, –ut
seersinne¦q	N	–rup, –rit
seersi¦ppaa	V	–nngilaa
seersi¦ppoq	V	–nngilaq
seersitsi¦voq	V	–nngilaq
seersorne¦q	N	–rup, –rit
seer¦sorneq	N	{–sornerup, –tornerup}, {–sornerit, –tornerit}
seersulia¦q	N	–p, –t
seer¦suliaq	N	{–suliap, –tuliap}, {–suliat, –tuliat}
seertaannarpoq	V	(no generation)
seert¦orpaa	V	–unngilaa
seert¦orpoq	V	–unngilaq
seer¦torpoq	V	{–sunngilaq, –tunngilaq}
seminaariamiippoq	V	(no generation)
seminaria	N	–p, –t
seminariat	N, pl.	-
septembari	N	–p, –t
seqaju¦k	N	–up, –it
seqajuu¦voq	V	–nngilaq
seq¦erpaa	V	–inngilaa
seq¦erpallanneq	N	{–erpallannerup, –ipallannerup}, {–erpallannerit, –ipallannerit}
seq¦erpoq	V	–inngilaq
seqersart¦oq	N	–up, –ut
seqersimaarpoq	V	(no generation)
seqersima¦vaa	V	–nngilaa
seqersitsine¦q	N	–rup, –rit
seqiaa¦voq	V	–nngilaq
seqia¦k	N	–ap, –at
seqiassu¦aq	N	–up, –it
seqig¦aa	V	–inngilaa
seqinaarsi¦orpoq	V	–unngilaq
seqineeru¦ppoq	V	–tinngilaq
seqineerutivikkaluarpoq	V	(no generation)
seq¦ineq	N	–ernup, –ernit
seqineqarfi¦k	N	–up, –it
seqinerfigitittarfi¦k	N	–up, –it
seqineri¦ppoq	V	–nngilaq
seqiner¦oorpoq	V	–uunngilaq
seqin¦erpaa	V	–inngilaa
seqin¦erpoq	V	–inngilaq
seqinersiorfi¦k	N	–up, –it
seqinersi¦orpoq	V	–unngilaq
seqinersiut	N	–ip, –it
seqinersiut	N, pl.	-
seqinersiutit	N, pl.	-
seqinersu¦aq	N	–up, –it
seqinertar¦aa	V	–inngilaa
seqiner¦taraa	V	{–sarinngilaa, –tarinngilaa}
seqinertariti¦ppoq	V	–nngilaq
seqiner¦taritippoq	V	{–saritinngilaq, –taritinngilaq}
seqinerua¦rpoq	V	–nngilaq
seqini¦gaq	N	–kkap, –kkat
seqinigart¦orpoq	V	–unngilaq
seqinigar¦torpoq	V	{–sunngilaq, –tunngilaq}
seqiniusaa¦q	N	–p, –t
seqiniusa¦q	N	–p, –t
seqinnari¦k	N	–up, –it
seqinnarilluinnarpoq	V	(no generation)
seqinnari¦ppoq	V	–nngilaq
seqinnarissi¦voq	V	–nngilaq
seqinnarissu¦aq	N	–up, –it
seqinnarl¦erpoq	V	–inngilaq
seqinnarlersima¦voq	V	–nngilaq
seqinnarlu¦ppoq	V	–nngilaq
seqinnerfigineqa¦rpoq	V	–nngilaq
seqinnerpaa	V	(no generation)
seqinnerpianngilaq	V	(no generation)
seqinn¦erpoq	V	–inngilaq
seqinnersorsu¦uvoq	V	{–aanngilaq, –unngilaq}
seqinner¦sorsuuvoq	V	{–sorsuaanngilaq, –sorsuunngilaq, –torsuaanngilaq, –torsuunngilaq}
seqinnia¦rpoq	V	–nngilaq
seqinnisaa¦rpoq	V	–nngilaq
seqi¦ppaa	V	–nngilaa
seqita¦ppaa	V	–nngilaa
seqita¦ppoq	V	–nngilaq
seqqagiu¦ppaa	V	–tinngilaa
seqqagiussaa¦voq	V	–nngilaq
seqqa¦ppaa	V	–nngilaa
seqqa¦rpaa	V	–nngilaa
seqqartaat	N	–ip, –it
seqqattaa¦voq	V	–nngilaq
seqqatta¦rpaa	V	–nngilaa
seqqi¦ppaa	V	–nngilaa
seqqitsa¦rpaa	V	–nngilaa
seqq¦oq	N	–up, –ut
seqqorne¦q	N	–rup, –rit
seqqorpalla¦ppoq	V	–nngilaq
seqq¦orpallappoq	V	{–orpallanngilaq, –upallanngilaq}
seqq¦orpoq	V	–unngilaq
seqqortaas¦erpaa	V	–inngilaa
seqqortaa¦serpaa	V	{–sinngilaa, –tilinngilaa}
seqqortaat	N	–ip, –it
seqqortaat	N, pl.	-
seqqortart¦oq	N	–up, –ut
seqqort¦ooq	N	–uup, –uut
seqquinna¦rpoq	V	–nngilaq
seqqul¦ik	N	{–iup, –lip, –lup}, –lit
seqqulu¦ppoq	V	–nngilaq
seqqulutsitsi¦voq	V	–nngilaq
seqquluttaat	N	–ip, –it
seqqulutt¦oq	N	–up, –ut
seqquluttut	N, pl.	-
seqquut	N	–ip, –it
seqquutissaaru¦ppoq	V	–tinngilaq
sequmeqqavoq	V	(no generation)
sequmii¦voq	V	–nngilaq
sequmi¦ppaa	V	–nngilaa
sequmi¦ppoq	V	–nngilaq
sequmi¦sippaa	V	{–sinngilaa, –tinngilaa, –tsinngilaa}
sequmissimas¦oq	N	–up, –ut
sequmita¦q	N	–p, –t
sequmivi¦ppoq	V	–nngilaq
seqummak¦oq	N	–up, –ut
seqummakut	N, pl.	-
seqummalaallappoq	V	(no generation)
seqummalasuinnaa¦voq	V	–nngilaq
seqummala¦voq	V	–nngilaq
sequnne¦q	N	–rup, –rit
sequnnerit	N, pl.	-
sequnngeqattaa¦rpoq	V	–nngilaq
sequnngeqattaarti¦ppaa	V	–nngilaa
sequnng¦erpoq	V	–inngilaq
sequnngersart¦oq	N	–up, –ut
sequnngersi¦ppaa	V	–nngilaa
sequ¦ppaa	V	–nngilaa
sequ¦ppoq	V	–tinngilaq
sequtseqqissaa¦rpaa	V	–nngilaa
sequtsereqqissaarne¦q	N	–rup, –rit
sequtserivi¦k	N	–up, –it
sequts¦erpaa	V	–inngilaa
sequtserut	N	–ip, –it
Serbiam¦eersoq	N	{–eersup, –eertup, –inngaanneersup, –inngaanneertup}, {–eersut, –eertut, –inngaanneersut, –inngaanneertut}
Serbiamioq	N	(no generation)
Serbiamiu	N	–p, –t
serfaa¦q	N	–p, –t
serfaarta¦rpoq	V	–nngilaq
serfaaru¦ppoq	V	–tinngilaq
serfa¦q	N	–p, –t
serfarnia¦rpoq	V	–nngilaq
serig¦aa	V	–inngilaa
serisaa¦rpaa	V	–nngilaa
seri¦voq	V	–nngilaq
serler¦aa	V	–inngilaa
serlerna¦rpoq	V	–nngilaq
serlernarsivoq	V	(no generation)
serlernart¦oq	N	–up, –ut
serlernavi¦ppoq	V	–nngilaq
serl¦erpoq	V	–inngilaq
serlersaarajuppoq	V	(no generation)
serlersaa¦rpoq	V	–nngilaq
serlersaartoqaanna¦rpoq	V	–nngilaq
serler¦saartoqaannarpoq	V	{–saartoqaannanngilaq, –taartoqaannanngilaq}
serlua¦q	N	–p, –t
sermeersiut	N	–ip, –it
sermeersuut	N	–ip, –it
serm¦eq	N	–ip, –it
sermernaqaaq	V	(no generation)
sermerna¦rpoq	V	–nngilaq
serm¦erpaa	V	–inngilaa
serm¦erpoq	V	–inngilaq
sermersi¦ooq	N	–uup, –uut
sermersiorne¦q	N	–rup, –rit
sermersi¦orpoq	V	–unngilaq
sermers¦ooq	N	–uup, –uut
Sermersu¦aq	N	–up, –it
sermersu¦aq	N	–up, –it
Sermersuut	N	–ip, –it
Sermersuut	N, pl.	-
Sermer¦suut	N	{–suutip, –tuutip}, {–suutit, –tuutit}
sermerta¦q	N	–p, –t
sermiarsu¦k	N	–up, –it
sermiarsummii¦ppoq	V	–nngilaq
sermiiaa¦siorpoq	V	{–siunngilaq, –tiliunngilaq}
sermiiaat	N	–ip, –it
sermi¦iarpaa	V	{–ajanngilaa, –ianngilaa}
sermiia¦rpoq	V	–nngilaq
sermiiarti¦ppaa	V	–nngilaa
sermi¦iartippaa	V	{–ajartinngilaa, –iartinngilaa}
sermiisorfi¦k	N	–up, –it
sermiis¦orpoq	V	–unngilaq
sermiisorti¦ppaa	V	–nngilaa
Sermiligaa¦q	N	–p, –t
Sermiligaa¦q	Prop	–p
sermiligaarsu¦k	N	–up, –it
Sermil¦ik	N	{–iup, –lip, –lup}, –lit
sermilimmii¦ppoq	V	–nngilaq
sermilimmiu	N	–p, –t
Sermilinngu¦aq	N	–up, –it
sermit	N, pl.	-
Sermitsia¦q	N	–ap, –at
Sermitsia¦q	N	–p, –t
Sermitsia¦q	Prop	–p, –t
sermukkiart¦orpoq	V	–unngilaq
sermu¦ppaa	V	–nngilaa
sermu¦ppoq	V	–nngilaq
sermutivi¦ppoq	V	–nngilaq
serngunnert¦ooq	N	–uup, –uut
serngu¦ppoq	V	–tinngilaq
serngutivi¦ppoq	V	–nngilaq
sernig¦aa	V	–inngilaa
sernigisaa¦voq	V	–nngilaq
sernissaa¦voq	V	–nngilaq
serniss¦orpaa	V	–unngilaa
sernissorti	N	–p, –t
sernissortig¦aa	V	–inngilaa
sernissuine¦q	N	–rup, –rit
sernissuis¦oq	N	–up, –ut
serpaliga¦rpoq	V	–nngilaq
serpalinne¦q	N	–rup, –rit
serpali¦ppoq	V	–nngilaq
serpalittuinnaa¦voq	V	–nngilaq
serpali¦ttuinnaavoq	V	{–ssuinnaanngilaq, –ttuinnaanngilaq}
serparne¦q	N	–rup, –rit
serpa¦rpaa	V	–nngilaa
serpa¦rpoq	V	–nngilaq
serpartaasiu¦ppaa	V	–tinngilaa
serpartaa¦siuppaa	V	{–siutinngilaa, –tiliutinngilaa}
serpartaat	N	–ip, –it
serpartarne¦q	N	–rup, –rit
serparta¦rpaa	V	–nngilaa
serpart¦erpaa	V	–inngilaa
serpeqa¦rpoq	V	–nngilaq
serpig¦aa	V	–inngilaa
serpi¦k	N	–up, –it
serpil¦ik	N	{–iup, –lip, –lup}, –lit
serpili¦orpoq	V	–unngilaq
serpiluu¦voq	V	–nngilaq
serpissu¦aq	N	–up, –it
serpiu¦voq	V	–nngilaq
serrane¦q	N	–rup, –rit
serrasa¦q	N	–p, –t
serrasa¦rpoq	V	–nngilaq
serrasinnaa¦voq	V	–nngilaq
serrat	N	–ip, –it
serra¦vaa	V	–nngilaa
serra¦voq	V	–nngilaq
serutsi	N	–p, –t
siaa¦neq	N	{–nerup, –rnup}, {–nerit, –rnit}
siaangasut	N, pl.	-
siaangavoq	V	(no generation)
siaanilers¦orpaa	V	–unngilaa
siaarne¦q	N	–rup, –rit
siaa¦rpaa	V	–nngilaa
siaa¦rpoq	V	–nngilaq
siaarsine¦q	N	–rup, –rit
siaartart¦oq	N	–up, –ut
siaartartut	N, pl.	-
siaarti¦ppaa	V	–nngilaa
siaartiteri¦voq	V	–nngilaq
siakataa¦voq	V	–nngilaq
siakata¦ppoq	V	–nngilaq
sialia¦q	N	–p, –t
sialiarsunni¦ppoq	V	–nngilaq
sialisart¦oq	N	–up, –ut
siali¦voq	V	–nngilaq
sialleqis¦oq	N	–up, –ut
sialleqqajaalerpoq	V	(no generation)
siallerajuppoq	V	(no generation)
sialleraluttuinnarpoq	V	(no generation)
siallerfig¦aa	V	–inngilaa
siallerpallaaqaaq	V	(no generation)
siall¦erpoq	V	–inngilaq
siallersorsu¦uvoq	V	{–aanngilaq, –unngilaq}
sialler¦sorsuuvoq	V	{–sorsuaanngilaq, –sorsuunngilaq, –torsuaanngilaq, –torsuunngilaq}
siallersuarpoq	V	(no generation)
siallertuarpoq	V	(no generation)
sialliliu¦ppaa	V	–tinngilaa
sialliliussaa¦voq	V	–nngilaq
siallinngikkallarpoq	V	(no generation)
sialualaa¦q	N	–p, –t
sialualaa¦rpoq	V	–nngilaq
sialu¦gaq	N	–kkap, –kkat
sialuit	N, pl.	-
sialu¦k	N	–up, –it
sialukkaa¦q	N	–p, –t
sialu¦ppaa	V	–nngilaa
sialuppalu¦ppoq	V	–nngilaq
sialuss¦iorpoq	V	{–iunngilaq, –aliunngilaq}
sialussiu¦serpoq	V	{–sinngilaq, –tilinngilaq}
sialussiut	N	–ip, –it
sialussu¦aq	N	–up, –it
sialussua¦rpoq	V	–nngilaq
siamasissut	N	–ip, –it
siamasumii¦ppoq	V	–nngilaq
siammaane¦q	N	–rup, –rit
siammaa¦ppoq	V	–tinngilaq
siammarne¦q	N	–rup, –rit
siamma¦rpaa	V	–nngilaa
siammarsimane¦q	N	–rup, –rit
siammarsimassu¦seq	N	–tsip, –tsit
siammarterine¦q	N	–rup, –rit
siammarter¦ipallanneq	N	{–erpallannerup, –ipallannerup}, {–erpallannerit, –ipallannerit}
siammarterut	N	–ip, –it
siammartitsine¦q	N	–rup, –rit
siammasi¦ppoq	V	–nngilaq
siammasiss¦oq	N	–up, –ut
siammasi¦ssoq	N	{–ssup, –ttup}, {–ssut, –ttut}
sianaalajuarpoq	V	(no generation)
sianaala¦voq	V	–nngilaq
sianaalla¦ppoq	V	–nngilaq
sianaallari¦ppoq	V	–nngilaq
sianaallariss¦oq	N	–up, –ut
sianaallari¦ssoq	N	{–ssup, –ttup}, {–ssut, –ttut}
sianaallattuinnaa¦voq	V	–nngilaq
sianaalu¦ppoq	V	–nngilaq
sianaaluttuinnaa¦voq	V	–nngilaq
sianaa¦q	N	–p, –t
sianaarpaluk	N	–up, –it
sianaarpalu¦k	N	–up, –it
sianaarpalu¦ppoq	V	–nngilaq
sianaa¦rpoq	V	–nngilaq
sianee¦raq	N	–qqap, –qqat
sian¦eeraq	N	{–eeqqap, –iaqqap}, {–eeqqat, –iaqqat}
sia¦neq	N	{–nerup, –rnup}, {–nerit, –rnit}
sianeralu¦aq	N	–up, –it
sianerfig¦aa	V	–inngilaa
sianerfigeqqaarpaa	V	(no generation)
sianerpalu¦ppoq	V	–nngilaq
sian¦erpoq	V	–inngilaq
sianersinnaalluarpoq	V	(no generation)
sianersua¦q	N	–ap, –at
sianersu¦aq	N	–up, –it
sianertaa¦siaq	N	{–siap, –tiliap}, {–siat, –tiliat}
sianertart¦oq	N	–up, –ut
sianertuu¦voq	V	–nngilaq
sianig¦aa	V	–inngilaa
sianiginia¦rpaa	V	–nngilaa
sianiginninne¦q	N	–rup, –rit
sianiginni¦ppoq	V	–nngilaq
sianiginnitt¦oq	N	–up, –ut
sianiilikaa¦rpoq	V	–nngilaq
sianiilikaart¦oq	N	–up, –ut
sianiilli¦orpoq	V	–unngilaq
sianiilliuut	N	–ip, –it
sianiippalutt¦oq	N	–up, –ut
sianii¦ppoq	V	–nngilaq
sianiits¦oq	N	–up, –ut
sianilluanngilaq	V	(no generation)
sianilluanngissu¦seq	N	–tsip, –tsit
sianilluanngits¦oq	N	–up, –ut
sianilluarunnaarne¦q	N	–rup, –rit
sianing¦erpoq	V	–inngilaq
sianingersima¦voq	V	–nngilaq
sianingersi¦ppaa	V	–nngilaa
sianingiisa¦rpoq	V	–nngilaq
sianinngilaq	V	(no generation)
sianisaa¦rpoq	V	–nngilaq
sianis¦ooq	N	–uup, –uut
siani¦sooq	N	{–suup, –tuup}, {–suut, –tuut}
sianissu¦seq	N	–tsip, –tsit
sianissuseqa¦rpoq	V	–nngilaq
sianissut	N	–ip, –it
sianisuu¦voq	V	–nngilaq
sianiusa¦q	N	–p, –t
sianiut	N	–ip, –it
sianiutigi¦ppoq	V	–nngilaq
sianiutigi¦ssaatit	N, pl.	{–ssaatit, –ttaatit}
sianiutilunne¦q	N	–rup, –rit
sianiutilu¦ppoq	V	–nngilaq
sianiutit	N, pl.	-
siani¦voq	V	–nngilaq
siannari¦ppoq	V	–nngilaq
siannarivi¦ppoq	V	–nngilaq
siannas¦erpoq	V	–inngilaq
siann¦erpoq	V	–inngilaq
siannik¦oq	N	–up, –ut
siannikut	N, pl.	-
sia¦ppaa	V	–nngilaa
sia¦ppoq	V	–nngilaq
siaqqinne¦q	N	–rup, –rit
siaqqisaa¦voq	V	–nngilaq
siaqqi¦saavoq	V	{–saanngilaq, –taanngilaq}
siaqqisa¦q	N	–p, –t
siaqqi¦saq	N	{–sap, –tap}, {–sat, –tat}
siaqqisimane¦q	N	–rup, –rit
siaqqiss¦oq	N	–up, –ut
siaqqi¦ssoq	N	{–ssup, –ttup}, {–ssut, –ttut}
siaqqi¦vaa	V	–nngilaa
siarngu¦ppaa	V	–tinngilaa
siarngussi¦voq	V	–nngilaq
siarnu¦ppaa	V	–tinngilaa
siarnussi¦voq	V	–nngilaq
siarpaalu¦k	N	–up, –it
siarpalaa¦rpoq	V	–nngilaq
siarpalu¦ppoq	V	–nngilaq
siaruaakkiartorunnaarpoq	V	(no generation)
siaruaa¦ppoq	V	–tinngilaq
siaruaassimaqis¦oq	N	–up, –ut
siaruaa¦voq	V	–nngilaq
siaruariartoqaaq	V	(no generation)
siaruarnaveersaartitsine¦q	N	–rup, –rit
siaruarne¦q	N	–rup, –rit
siarua¦rpaa	V	–nngilaa
siarua¦rpoq	V	–nngilaq
siaruarter¦ipallattoq	N	{–erpallattup, –ipallattup}, {–erpallattut, –ipallattut}
siaruarteris¦oq	N	–up, –ut
siaruarteri¦voq	V	–nngilaq
siaruatsaaliuine¦q	N	–rup, –rit
siataa¦voq	V	–nngilaq
siata¦q	N	–p, –t
siatarsunni	N	–p, –t
siatassa¦q	N	–p, –t
siatsine¦q	N	–rup, –rit
siatsi¦ppaa	V	–nngilaa
siatsivi¦k	N	–up, –it
siatsi¦vik	N	{–ffiup, –viup}, {–ffiit, –viit}
siatsi¦voq	V	–nngilaq
Siattut	N, pl.	-
Sibiria	Prop	–p
Sib¦iria	Prop	{–eriap, –iriap}
siffeersaalaa¦rpoq	V	–nngilaq
siffeersaa¦rpoq	V	–nngilaq
siffiaki¦ppoq	V	–nngilaq
siffiakkaa¦q	N	–p, –t
siffiakkaat	N, pl.	-
siffi¦aq	N	–ssap, –ssat
siffiar¦sorneq	N	{–sornerup, –tornerup}, {–sornerit, –tornerit}
siffiart¦ooq	N	–uup, –uut
siffii¦ppoq	V	–nngilaq
siffiitsuiu¦voq	V	–nngilaq
siffoqqissaa¦rpaa	V	–nngilaa
siff¦orpaa	V	–unngilaa
siga¦rpoq	V	–nngilaq
sigga¦rpoq	V	–nngilaq
siggartaa¦siorpoq	V	{–siunngilaq, –tiliunngilaq}
siggartaassu¦aq	N	–up, –it
siggartaat	N	–ip, –it
siggartaatig¦aa	V	–inngilaa
siggartaqattaa¦rpoq	V	–nngilaq
siggartarfig¦aa	V	–inngilaa
siggarta¦rpoq	V	–nngilaq
siggartartitsi¦voq	V	–nngilaq
siggia¦voq	V	–nngilaq
siggilas¦oq	N	–up, –ut
siggila¦voq	V	–nngilaq
siggillarpoq	V	(no generation)
sigginne¦q	N	–rup, –rit
siggi¦ppoq	V	–nngilaq
siggisi¦ppaa	V	–nngilaa
siggisita¦q	N	–p, –t
siggis¦simasoq	N	{–imasup, –simasup}, {–imasut, –simasut}
siggitt¦oorpoq	V	–uunngilaq
siggoqqissaa¦rpaa	V	–nngilaa
siggoqut	N	–ip, –it
sigg¦orpaa	V	–unngilaa
siggort¦orpaa	V	–unngilaa
sigguillaqqi¦ppoq	V	–nngilaq
sigguine¦q	N	–rup, –rit
sigguissut	N	–ip, –it
sigguissut	N, pl.	-
siggui¦ssut	N	{–ssutip, –ssut, –ttut}, –ssutit
sigguit	N, pl.	-
siggui¦vaa	V	–nngilaa
siggui¦voq	V	–nngilaq
Siggu¦k	N	–up, –it
siggu¦k	N	–up, –it
siggukits¦oq	N	–up, –ut
siggukkaa¦q	N	–p, –t
siggukkaarsu¦aq	N	–up, –it
siggulee¦raq	N	–qqap, –qqat
Siggutt¦ooq	N	–uup, –uut
siggutt¦ooq	N	–uup, –uut
siggutt¦oorpoq	V	–uunngilaq
sigguttu¦voq	V	–nngilaq
sigguut	N	–ip, –it
sigtiliassat	N, pl.	-
sii	N	–p, –t
siiffissarlu¦ppoq	V	–nngilaq
siiguikkus¦erpaa	V	–inngilaa
siiguikku¦serpaa	V	{–sinngilaa, –tilinngilaa}
siiguikkut	N	–ip, –it
siiguikkutaaru¦ppoq	V	–tinngilaq
siikajaa¦rpoq	V	–nngilaq
siika¦rpoq	V	–nngilaq
siikataa¦voq	V	–nngilaq
siikkaaginna¦rpoq	V	–nngilaq
siikkaajuarpoq	V	(no generation)
siikkaa¦ppoq	V	–tinngilaq
siikkaass¦orpoq	V	–unngilaq
siikkaa¦voq	V	–nngilaq
siikka¦rpoq	V	–nngilaq
siikkartaannarpoq	V	(no generation)
siikkartuinnaa¦voq	V	–nngilaq
siik¦orpaa	V	–unngilaa
siiliki	N	–p, –t
siilikiinnaa¦voq	V	–nngilaq
siilikiliort¦oq	N	–up, –ut
siilikilisaa¦rpoq	V	–nngilaq
siilipi	N	–p, –t
siilupi	N	–p, –t
siilvi	N	–p, –t
siilviu¦voq	V	–nngilaq
siimi¦ppaa	V	–nngilaa
siimi¦ppoq	V	–nngilaq
siimissa¦rpaa	V	–nngilaa
siimitta¦rpaa	V	–nngilaa
siinne¦q	N	–rup, –rit
siinnersu¦aq	N	–up, –it
siinuppi	N	–p, –t
sii¦ppaa	V	–nngilaa
sii¦ppoq	V	–nngilaq
siissa¦rpoq	V	–nngilaq
sii¦ssarpoq	V	–ttanngilaq
siissart¦oq	N	–up, –ut
sii¦ssartoq	N	{–ssartup, –ttartup}, {–ssartut, –ttartut}
siisserne¦q	N	–rup, –rit
siiss¦erpaa	V	–inngilaa
siissiinna¦rpoq	V	–nngilaq
sii¦ssiinnarpoq	V	{–ssiinnanngilaq, –tsiinnanngilaq}
siissis¦oq	N	–up, –ut
siissi¦voq	V	–nngilaq
siit	N, pl.	-
siittart¦oq	N	–up, –ut
sii¦ttartoq	N	{–ssartup, –ttartup}, {–ssartut, –ttartut}
siittartoqa¦rpoq	V	–nngilaq
sii¦ttartoqarpoq	V	{–ssartoqanngilaq, –ttartoqanngilaq}
siittartorsi¦voq	V	–nngilaq
sii¦ttartorsivoq	V	{–ssartorsinngilaq, –ttartorsinngilaq}
siitt¦oorpoq	V	–uunngilaq
SIK	Prop	–ip
sikaak¦oq	N	–up, –ut
sikaalaanna¦rpoq	V	–nngilaq
sikaalajunnaa¦rpoq	V	–nngilaq
sikaalivi¦k	N	–up, –it
sikaannaa¦voq	V	–nngilaq
sikaannarsuu¦voq	V	–nngilaq
sikaannarsu¦uvoq	V	{–aanngilaq, –unngilaq}
sikaa¦q	N	–p, –t
sikaasi¦voq	V	–nngilaq
sikaatorfi¦k	N	–up, –it
sikaat¦orpoq	V	–unngilaq
sikaava¦raq	N	–qqap, –qqat
sikaavi¦k	N	–up, –it
sikaavilatsi¦voq	V	–nngilaq
sikagukkiart¦orpoq	V	–unngilaq
sikagu¦ppoq	V	–nngilaq
sikagusima¦voq	V	–nngilaq
sikalaa¦rpaa	V	–nngilaa
sikannert¦ooq	N	–uup, –uut
sika¦ppoq	V	–nngilaq
sikar¦aa	V	–inngilaa
sikaratsi	N	(no generation)
sikaritsi	N	(no generation)
sikaritsik¦oq	N	–up, –ut
sikaritsinng¦erpoq	V	–inngilaq
sikaritsisi¦voq	V	–nngilaq
sikarpalu¦ppoq	V	–nngilaq
sikassaat	N	–ip, –it
sikassa¦rpaa	V	–nngilaa
sikass¦erpoq	V	–inngilaq
sikataa¦voq	V	–nngilaq
sikata¦q	N	–p, –t
sikatarsunni	N	–p, –t
sikatat	N, pl.	-
sikatsi¦ppaa	V	–nngilaa
sikatsi¦ppoq	V	–nngilaq
sikatsitsit	N	–ip, –it
sikatsitsivi¦k	N	–up, –it
sikatsitsi¦vik	N	{–ffiup, –viup}, {–ffiit, –viit}
sikatsitsi¦voq	V	–nngilaq
sikattuinnaa¦voq	V	–nngilaq
sikiffig¦aa	V	–inngilaa
sikikkiart¦orpoq	V	–unngilaq
sikilingi	N	–p, –t
sikimmallappoq	V	(no generation)
sikingaartitsi¦voq	V	–nngilaq
sikingas¦oq	N	–up, –ut
sikingatitsi¦voq	V	–nngilaq
sikingavallaa¦rpoq	V	–nngilaq
sikinga¦voq	V	–nngilaq
siki¦ppoq	V	–nngilaq
sikisaarfig¦aa	V	–inngilaa
siki¦saarfigaa	V	{–saarfiginngilaa, –taarfiginngilaa}
sikisaa¦rpoq	V	–nngilaq
sikisa¦rpoq	V	–nngilaq
sikis¦oorpoq	V	–uunngilaq
siki¦tsippaa	V	{–ssinngilaa, –tsinngilaa}
sikitt¦oorpoq	V	–uunngilaq
siki¦voq	V	–nngilaq
sikka¦rpaa	V	–nngilaa
sikkerlua¦rpoq	V	–nngilaq
sikkerne¦q	N	–rup, –rit
sikk¦erpoq	V	–inngilaq
sikker¦soq	N	{–sup, –tup}, {–sut, –tut}
sikker¦sunippoq	V	{–suninngilaq, –tuninngilaq}
sikker¦sussanippoq	V	{–sussaninngilaq, –tussaninngilaq}
sikker¦sussaq	N	{–sussap, –tussap}, {–sussat, –tussat}
sikkerua¦rpoq	V	–nngilaq
sikkerula¦voq	V	–nngilaq
sikkia¦rpoq	V	–nngilaq
sikkigilluinnarpoq	V	(no generation)
sikkigi¦ppoq	V	–nngilaq
sikkigissa¦rpaa	V	–nngilaa
sikkilerne¦q	N	–rup, –rit
sikkil¦erpoq	V	–inngilaq
sikkilert¦oq	N	–up, –ut
sikkiler¦toq	N	{–sup, –tup}, {–sut, –tut}
sikkili	N	–p, –t
sikkillu¦ppoq	V	–nngilaq
sikkisaanngilaq	V	(no generation)
sikkisaanngits¦oq	N	–up, –ut
sikkisaa¦rpoq	V	–nngilaq
sikkisaarunnaa¦rpoq	V	–nngilaq
sikkivig¦aa	V	–inngilaa
sikkivigisaa¦voq	V	–nngilaq
sikkivigisa¦q	N	–p, –t
sikkori¦ppoq	V	–nngilaq
sikkorissaa¦rpoq	V	–nngilaq
sikkorlukkunnaa¦rpoq	V	–nngilaq
sikkorlu¦ppoq	V	–nngilaq
sikkorluttua¦rpoq	V	–nngilaq
sikkukkiart¦orpaa	V	–unngilaa
sikku¦ppaa	V	–tinngilaa
sikku¦ppoq	V	–nngilaq
sikkussaa¦voq	V	–nngilaq
sikkussa¦q	N	–p, –t
sikkuta¦k	N	–ap, –at
sikkuta¦ppoq	V	–nngilaq
sikkutivi¦ppaa	V	–nngilaa
sikoqannginnersa¦q	N	–p, –t
sikoqanngits¦oq	N	–up, –ut
sikorasaa¦q	N	–p, –t
sikorlaa¦q	N	–p, –t
sikorneqattaa¦rpoq	V	–nngilaq
sikorn¦erpoq	V	–inngilaq
sikornersart¦oq	N	–up, –ut
sikornersi¦ppaa	V	–nngilaa
sikorpalaa¦rpaa	V	–nngilaa
sikorpalaa¦rpoq	V	–nngilaq
sikorsu¦aq	N	–up, –it
sikorsuarsi¦orpoq	V	–unngilaq
sikorsuatsia¦q	N	–ap, –at
sikorsuatsia¦q	N	–p, –t
sikorsuit	N, pl.	-
siku	N	–p, –t
sikualuit	N, pl.	-
sikuani¦ppoq	V	–nngilaq
sikua¦q	N	–p, –t
sikuarlaa¦q	N	–p, –t
sikua¦rpaa	V	–nngilaa
sikua¦rpoq	V	–nngilaq
sikuarsi¦orpoq	V	–unngilaq
siku¦erpaa	V	–inngilaa
siku¦erpoq	V	–inngilaq
sikuersa¦rpaa	V	–nngilaa
sikuersima¦voq	V	–nngilaq
sikuers¦oorpoq	V	–uunngilaq
sikuerukkiart¦orpoq	V	–unngilaq
sikueru¦ppoq	V	–tinngilaq
sikuerussi¦vaa	V	–nngilaa
sikugaju¦ppoq	V	–nngilaq
sikugasaa¦q	N	–p, –t
sikugasaarsi¦orpoq	V	–unngilaq
siku¦iaaneq	N	{–ajaanerup, –iaanerup}, {–ajaanerit, –iaanerit}
sikuiui¦ppoq	V	–nngilaq
Sikuiuits¦oq	N	–up, –ut
Sikuiuits¦oq	Prop	–up
sikuiuits¦oq	N	–up, –ut
sikuiuitsoqarfi¦k	N	–up, –it
sikuiuitsormi¦oq	N	–up, –ut
sikuiuitsumii¦ppoq	V	–nngilaq
sikujaa¦rpoq	V	–nngilaq
sikujui¦ppoq	V	–nngilaq
sikujuits¦oq	N	–up, –ut
sikukk¦oorpoq	V	–uunngilaq
sikulaa¦q	N	–p, –t
sikulers¦orpaa	V	–unngilaa
sikuliamii¦ppoq	V	–nngilaq
sikulia¦q	N	–p, –t
sikulia¦rpoq	V	–nngilaq
sikuli¦orpoq	V	–unngilaq
sikull¦erpoq	V	–inngilaq
sikulliu¦ppaa	V	–tinngilaa
sikum¦ineq	N	–ernup, –ernit
sikuna¦rpoq	V	–nngilaq
sikunnaa¦q	N	–p, –t
sikusa¦rpoq	V	–nngilaq
sikusia¦q	N	–p, –t
sikusimas¦oq	N	–up, –ut
sikusiorajuppoq	V	(no generation)
sikusiorne¦q	N	–rup, –rit
sikusi¦orpoq	V	–unngilaq
sikusiortaannarpoq	V	(no generation)
sikuss¦erpoq	V	–inngilaq
sikussersorsu¦uvoq	V	{–aanngilaq, –unngilaq}
sikusser¦sorsuuvoq	V	{–sorsuaanngilaq, –sorsuunngilaq, –torsuaanngilaq, –torsuunngilaq}
sikusui¦ppoq	V	–nngilaq
siku¦suippoq	V	{–suinngilaq, –tuinngilaq}
sikut¦aq	N	{–ap, –tap}, {–at, –tat}
sikuts¦erpoq	V	–inngilaq
sikuusartuunngits¦oq	N	–up, –ut
sikuu¦voq	V	–nngilaq
siku¦voq	V	–nngilaq
sila	N	–p
silaalooqaaq	V	(no generation)
silaalukassa¦k	N	–ap, –at
silaalunngu¦aq	N	–up, –it
silaaluu¦voq	V	–nngilaq
silaannaa¦rpoq	V	–nngilaq
silaannaaru¦ppoq	V	–tinngilaq
silaannaarutt¦oorpoq	V	–uunngilaq
silaannaa¦voq	V	–nngilaq
silaannakkoorne¦q	N	–rup, –rit
silaannaliorne¦q	N	–rup, –rit
silaannalunne¦q	N	–rup, –rit
silaannalu¦ppoq	V	–nngilaq
silaannalutt¦oq	N	–up, –ut
silaanna¦q	N	–ap, –at
silaannaqanngits¦oq	N	–up, –ut
silaannari¦ppoq	V	–nngilaq
silaannarissaane¦q	N	–rup, –rit
silaannarissaat	N	–ip, –it
silaannari¦ssaat	N	{–ssaatip, –ttaatip}, {–ssaatit, –ttaatit}
silaannarissaa¦voq	V	–nngilaq
silaannarissagaanngits¦oq	N	–up, –ut
silaannarissa¦gaq	N	–kkap
silaannarissa¦gaq	N	–kkap, –kkat
silaannarissa¦rpoq	V	–nngilaq
silaannari¦ssarpoq	V	–ttanngilaq
silaannarmii¦ppoq	V	–nngilaq
silaannarsualiartaat	N	–ip, –it
silaannarsualiartart¦oq	N	–up, –ut
silaannarsua¦q	N	–ap, –at
silaannarsu¦aq	N	–up, –it
silaannarta¦q	N	–p, –t
silaappallaaqaaq	V	(no generation)
silaa¦ppoq	V	–nngilaq
silaa¦raq	N	–qqap
silaarsaat	N	–ip, –it
silaarsorajuppoq	V	(no generation)
silaars¦orpoq	V	–unngilaq
silaarunnart¦oq	N	–up, –ut
silaarunne¦q	N	–rup, –rit
silaaru¦ppoq	V	–tinngilaq
silaarusima¦voq	V	–nngilaq
silaarutaasarne¦q	N	–rup, –rit
silaarutaasa¦rpoq	V	–nngilaq
silaarutt¦oq	N	–up, –ut
silaaseriffig¦aa	V	–inngilaa
silaa¦seriffigaa	V	{–seriffiginngilaa, –tileriffiginngilaa}
silaaserillaqqi¦ppoq	V	–nngilaq
silaa¦serillaqqippoq	V	{–serillaqqinngilaq, –tilerillaqqinngilaq}
silaaserine¦q	N	–rup, –rit
silaa¦serineq	N	{–serinerup, –tilerinerup}, {–serinerit, –tilerinerit}
silaaserinert¦ooq	N	–uup, –uut
silaa¦serinertooq	N	{–serinertuup, –tilerinertuup}, {–serinertuut, –tilerinertuut}
silaaseriumat¦ooq	N	–uup, –uut
silaa¦seriumatooq	N	{–seriumatuup, –tileriumatuup}
silaaserivallaaqaaq	V	(no generation)
silaaseri¦voq	V	–nngilaq
silaa¦serivoq	V	{–serinngilaq, –tilerinngilaq}
silaats¦oq	N	–up, –ut
silag¦aa	V	–inngilaa
silagillarpoq	V	(no generation)
silagillua¦rpaa	V	–nngilaa
silaginia¦rpaa	V	–nngilaa
silaginngua¦rpoq	V	–nngilaq
silagi¦ppoq	V	–nngilaq
silagissi¦orpoq	V	–unngilaq
silagissi¦voq	V	–nngilaq
silakasi¦k	N	–up, –it
silakilli¦orpoq	V	–unngilaq
silaki¦ppoq	V	–nngilaq
silakisaa¦rpoq	V	–nngilaq
silakullerajuppoq	V	(no generation)
silakull¦erpoq	V	–inngilaq
silakulu¦k	N	–up, –it
silal¦ik	N	{–iup, –lip, –lup}, –lit
silalisima¦voq	V	–nngilaq
silalivi¦ppoq	V	–nngilaq
silali¦voq	V	–nngilaq
silalu¦ppoq	V	–nngilaq
silamii¦ppoq	V	–nngilaq
silamiorpalunngits¦oq	N	–up, –ut
silamiu	N	–p
silamiu	N	–p, –t
silamiut	N, pl.	-
sila¦mmoorpoq	V	{–mmuunngilaq, –timuunngilaq}
silammoortaannarpoq	V	(no generation)
sila¦mmukaappaa	V	{–mmukaatinngilaa, –timukaatinngilaa}
sila¦mmukaassivoq	V	{–mmukaassinngilaq, –timukaassinngilaq}
sila¦mmukarpoq	V	{–mmukanngilaq, –timukanngilaq}
silanimma	Interj	(no generation)
silanngaa¦rpoq	V	–nngilaq
silanngajaarne¦q	N	–rup, –rit
silanngajaa¦rpoq	V	–nngilaq
silanngajaart¦oq	N	–up, –ut
silanngajaartuu¦voq	V	–nngilaq
silanng¦orpoq	V	–unngilaq
silannisaanngilaq	V	(no generation)
silapalaa¦q	N	–p
silapalaa¦q	N	–p, –t
silapill¦erpoq	V	–inngilaq
silapilu¦k	N	–up, –it
silapilu¦ppoq	V	–nngilaq
silappaari¦ppoq	V	–nngilaq
silappari¦ppoq	V	–nngilaq
silapparissaa¦rpoq	V	–nngilaq
silapp¦eerpoq	V	–iinngilaq
silappeerunnaa¦rpoq	V	–nngilaq
silappi¦ppoq	V	–nngilaq
silaqanngilaq	V	(no generation)
silaqanngits¦oq	N	–up, –ut
silaqanngitsorpalla¦ppoq	V	–nngilaq
silaqarluanngilaq	V	(no generation)
silaqarluanngits¦oq	N	–up, –ut
silaqarlua¦rpoq	V	–nngilaq
silaqarluassu¦seq	N	–tsip, –tsit
silaqa¦rpoq	V	–nngilaq
silaqassaanngilaq	V	(no generation)
silaqassaanngits¦oq	N	–up, –ut
silaqassu¦seq	N	–tsip, –tsit
silaqinaqaaq	V	(no generation)
silaqi¦voq	V	–nngilaq
silaqqi¦ppoq	V	–nngilaq
silaqqukkiart¦orpoq	V	–unngilaq
silaqqu¦ppaa	V	{–nngilaa, –tinngilaa}
silaqqu¦ppoq	V	–tinngilaq
silaqqu¦tsivoq	V	{–ssinngilaq, –tsinngilaq}
silarl¦eq	N	–iup, –iit
silarlerajuppoq	V	(no generation)
silarlerpaa¦q	N	–p, –t
silarl¦erpoq	V	–inngilaq
silarlersaanna¦rpoq	V	–nngilaq
silarlu¦k	N	–up, –it
silarlu¦ppoq	V	–nngilaq
silarlussi¦orpoq	V	–unngilaq
silarluss¦iorpoq	V	{–iunngilaq, –aliunngilaq}
silarsu¦aq	N	–up, –it
silarsuaqaraluanngilaq	V	(no generation)
silarsuarmiu	N	–p
silarsuarmiu	N	–p, –t
silarsuarmiunngorsaane¦q	N	–rup, –rit
silarsuarmiut	N, pl.	-
silasiorfeqarfi¦k	N	–up, –it
silasiorfi¦k	N	–up, –it
silasiorfik¦oq	N	–up, –ut
silasiorne¦q	N	–rup, –rit
silasiort¦oq	N	–up, –ut
silasiut	N	–ip, –it
silasi¦vaa	V	–nngilaa
silassa¦q	N	–p
silassari¦ppoq	V	–nngilaq
silasseri¦voq	V	–nngilaq
silassori¦ppoq	V	–nngilaq
silassorissaa¦rpoq	V	–nngilaq
silassoriss¦oq	N	–up, –ut
silassori¦ssoq	N	{–ssup, –ttup}, {–ssut, –ttut}
silassorissu¦seq	N	–tsip, –tsit
silassorlu¦ppoq	V	–nngilaq
silassorlutt¦oq	N	–up, –ut
silasunni¦ppoq	V	–nngilaq
silat	Interj	(no generation)
silataan¦eersoq	N	{–eersup, –eertup, –inngaanneersup, –inngaanneertup}, {–eersut, –eertut, –inngaanneersut, –inngaanneertut}
silataanii¦ppoq	V	–nngilaq
silatang¦erpaa	V	–inngilaa
silatangers¦orpaa	V	–unngilaa
silatangiaane¦q	N	–rup, –rit
silatangiaasa¦rpoq	V	–nngilaq
silatangiaasi¦orpoq	V	–unngilaq
silatangiaa¦siorpoq	V	{–siunngilaq, –tiliunngilaq}
silatangiaat	N	–ip, –it
silatangiaa¦voq	V	–nngilaq
silatangiu¦ppoq	V	–tinngilaq
silatangiuttaannarpoq	V	(no generation)
silatanngueru¦ppoq	V	–tinngilaq
silat¦ooq	N	–uup
silat¦ooq	N	–uup, –uut
silatoorsu¦aq	N	–up, –it
silats¦erpoq	V	–inngilaq
silatsiala¦k	N	–ap, –at
silattangiarnaqaaq	V	(no generation)
silattangia¦rpoq	V	–nngilaq
silatt¦orpoq	V	–unngilaq
silattorsaat	N	–ip, –it
silattorsaatig¦aa	V	–inngilaa
silattorsa¦rpaa	V	–nngilaa
silattorsarpoq	V	(no generation)
silattors¦erpaa	V	–inngilaa
silattorti¦ppaa	V	–nngilaa
silattuaqi¦voq	V	–nngilaq
silattuleriallarpoq	V	(no generation)
silattuu¦ppaa	V	–tinngilaa
silattuussi¦voq	V	–nngilaq
silatusaarne¦q	N	–rup, –rit
silatusaa¦rpoq	V	–nngilaq
silatusaart¦oq	N	–up, –ut
sila¦tussuseq	N	{–tussutsip, –sussutsip}, {–tussutsit, –sussutsit}
silatu¦voq	V	–nngilaq
silavaa¦ppaa	V	–tinngilaa
silava¦rpoq	V	–nngilaq
silavarterpoq	V	(no generation)
silera¦ppaa	V	–nngilaa
silera¦ppoq	V	–nngilaq
sileratsi¦ppaa	V	–nngilaa
silerattaat	N	–ip, –it
sileratta¦rpaa	V	–nngilaa
sileratta¦rpoq	V	–nngilaq
silerikkiart¦orpoq	V	–unngilaq
silerillua¦rpoq	V	–nngilaq
sileri¦ppoq	V	–nngilaq
silia¦voq	V	–nngilaq
silig¦aa	V	–inngilaa
silinaagaa¦voq	V	–nngilaq
silinaaqqu¦ppaa	V	–tinngilaa
silinaaqqussi¦voq	V	–nngilaq
silinaa¦rpaa	V	–nngilaa
silippallaanngikkunarpoq	V	(no generation)
sili¦ppoq	V	–nngilaq
silisaa¦voq	V	–nngilaq
silisa¦q	N	–p, –t
silisi¦voq	V	–nngilaq
silissiartorunnaarpoq	V	(no generation)
silissine¦q	N	–rup, –rit
silissi¦sippaa	V	{–sinngilaa, –tinngilaa}
silissi¦voq	V	–nngilaq
silissu¦seq	N	–tsip, –tsit
silitt¦oq	N	–up, –ut
silittorsu¦uvoq	V	{–aanngilaq, –unngilaq}
silittukulla¦k	N	–ap, –at
sili¦vaa	V	–nngilaa
sili¦voq	V	–nngilaq
sillajaa¦q	N	–p, –t
sillajaarsu¦aq	N	–up, –it
sillakulla¦k	N	–ap, –at
sillakullassu¦aq	N	–up, –it
silla¦q	N	–p, –t
silla¦rpaa	V	–nngilaa
sillarsu¦aq	N	–up, –it
sillartaa¦voq	V	–nngilaq
sillarta¦q	N	–p, –t
sill¦eq	N	–ip, –it
sill¦erpaa	V	–inngilaa
sillersui¦voq	V	–nngilaq
sillimallua¦rpoq	V	–nngilaq
sillimaniarne¦q	N	–rup, –rit
sillimar¦eerpoq	V	–iinngilaq
sillimasaannarpoq	V	(no generation)
sillimas¦oq	N	–up, –ut
sillima¦voq	V	–nngilaq
sillimmarlua¦rpoq	V	–nngilaq
sillimma¦rpoq	V	–nngilaq
sillimmarsarpoq	V	(no generation)
sillimmarterpoq	V	(no generation)
sillimma¦seeqatigiinneq	N	{–seeqatigiinnerup, –tileeqatigiinnerup}, {–seeqatigiinnerit, –tileeqatigiinnerit}
sillimma¦serpaa	V	{–sinngilaa, –tilinngilaa}
sillimma¦serpoq	V	{–sinngilaq, –tilinngilaq}
sillimma¦sersorpoq	V	{–sersunngilaq, –tilersunngilaq}
sillimma¦sersugavik	N	{–sersugaviup, –tilersugaviup}, {–sersugaviit, –tilersugaviit}
sillimmasersuilerumane¦q	N	–rup, –rit
sillimma¦sersuilerumaneq	N	{–sersuilerumanerup, –sertuilerumanerup, –tilersuilerumanerup, –tilertuilerumanerup}, {–sersuilerumanerit, –sertuilerumanerit, –tilersuilerumanerit, –tilertuilerumanerit}
sillimma¦sersuiniartoq	N	{–sersuiniartup, –tilersuiniartup}, {–sersuiniartut, –tilersuiniartut}
sillimma¦sertoq	N	{–sersup, –sertup, –tilersup, –tilertup}, {–sersut, –sertut, –tilersut, –tilertut}
sillimma¦siineq	N	{–siinerup, –tiliinerup}, {–siinerit, –tiliinerit}
sillimma¦siiniartoq	N	{–siiniartup, –tiliiniartup}, {–siiniartut, –tiliiniartut}
sillimma¦siinngitsoorneq	N	{–siinngitsoornerup, –tiliinngitsoornerup}, {–siinngitsoornerit, –tiliinngitsoornerit}
sillimma¦siisarfik	N	{–siisarfiup, –tiliisarfiup}, {–siisarfiit, –tiliisarfiit}
sillimma¦siisarneq	N	{–siisarnerup, –tiliisarnerup}, {–siisarnerit, –tiliisarnerit}
sillimma¦siisinnaatitaasoq	N	{–siisinnaatitaasup, –tiliisinnaatitaasup}, {–siisinnaatitaasut, –tiliisinnaatitaasut}
sillimmasiisitsisart¦oq	N	–up, –ut
sillimma¦siisitsisartoq	N	{–siisitsisartup, –tiliisitsisartup}, {–siisitsisartut, –tiliisitsisartut}
sillimma¦siisoq	N	{–siisup, –tiliisup}, {–siisut, –tiliisut}
sillimmasiissut	N	–ip, –it
sillimma¦siissut	N	{–siissutip, –tiliissutip}, {–siissutit, –tiliissutit}
sillimma¦siisussaaneq	N	{–siisussaanerup, –tiliisussaanerup}, {–siisussaanerit, –tiliisussaanerit}
sillimma¦siisussaatitaaneq	N	{–siisussaatitaanerup, –tiliisussaatitaanerup}, {–siisussaatitaanerit, –tiliisussaatitaanerit}
sillimma¦siisussaatitaasoq	N	{–siisussaatitaasup, –tiliisussaatitaasup}, {–siisussaatitaasut, –tiliisussaatitaasut}
sillimmasiut	N	–ip, –it
sillimmat	N	–ip, –it
sillimmataa¦voq	V	–nngilaq
sillimmatig¦aa	V	–inngilaa
sillimmatissa¦q	N	–p, –t
sillimmatit	N, pl.	-
sill¦ineq	N	–ernup, –ernit
sillineqa¦rpoq	V	–nngilaq
silling¦erpaa	V	–inngilaa
sillingia¦rpaa	V	–nngilaa
silliniia¦rpaa	V	–nngilaa
sillini¦ppoq	V	–nngilaq
sillisaasa¦rpoq	V	–nngilaq
sillisaa¦voq	V	–nngilaq
sillisissa¦q	N	–p, –t
sillisissia¦q	N	–p, –t
sillisissiaqa¦rpoq	V	–nngilaq
sillit	N, pl.	-
silli¦t	N	–sip, –sit
silliusa¦q	N	–p, –t
siloqarajuppoq	V	(no generation)
silorsu¦aq	N	–up, –it
silu	N	–p, –t
silugu¦ppaa	V	–tinngilaa
silugusima¦vaa	V	–nngilaa
silugussi¦voq	V	–nngilaq
silulia¦q	N	–p, –t
siluli¦aq	N	–ssap, –ssat
siluliar¦aa	V	–inngilaa
siluligajuppoq	V	(no generation)
siluli¦voq	V	–nngilaq
silullaqqi¦ppoq	V	–nngilaq
silu¦ppoq	V	–nngilaq
silussima¦voq	V	–nngilaq
siluts¦erpoq	V	–inngilaq
silutsi¦ppaa	V	–nngilaa
siluttaat	N	–ip, –it
silutt¦orpaa	V	–unngilaa
silutt¦orpoq	V	–unngilaq
siluttuut	N	–ip, –it
silutuuma¦soq	N	{–sup, –tup}, {–sut, –tut}
siluusaannarpoq	V	(no generation)
siluusa¦rpoq	V	–nngilaq
siluu¦voq	V	–nngilaq
simaart¦oq	N	–up, –ut
simaartuararpaalussuit	N, pl.	-
simaartuararpassuit	N, pl.	-
sim¦eerpaa	V	–iinngilaa
sim¦eerpoq	V	–iinngilaq
simeersit	N, pl.	-
simeers¦oorpoq	V	–uunngilaq
simernaveeqqut	N	–ip, –it
simerneeru¦ppoq	V	–tinngilaq
simerne¦q	N	–rup, –rit
simern¦erinnaavoq	V	{–erinnaanngilaq, –iinnaanngilaq}
simernil¦ik	N	{–iup, –lip, –lup}, –lit
sim¦erpaa	V	–inngilaa
sim¦erpoq	V	–inngilaq
simerseria¦rpoq	V	–nngilaq
simerserii¦ppoq	V	–nngilaq
simers¦erpaa	V	–inngilaa
simersia¦q	N	–p, –t
simersiat	N, pl.	-
simersima¦voq	V	–nngilaq
simerti¦ppaa	V	–nngilaa
simertita¦q	N	–p, –t
simert¦oq	N	–up, –ut
simer¦toq	N	{–sup, –tup}, {–sut, –tut}
simerukkiart¦orpoq	V	–unngilaq
simerumaarnertu¦voq	V	–nngilaq
simeru¦ppoq	V	–tinngilaq
simiali¦orpoq	V	–unngilaq
simia¦q	N	–p, –t
simia¦rpaa	V	–nngilaa
simia¦voq	V	–nngilaq
simi¦gaq	N	–kkap, –kkat
simiiaat	N	–ip, –it
simiiaataa¦voq	V	–nngilaq
simi¦k	N	–up, –it
siminti	N	(no generation)
simintili¦orpoq	V	–unngilaq
simi¦ppaa	V	–nngilaa
simissia¦q	N	–p, –t
simissi¦voq	V	–nngilaq
simiss¦orpaa	V	–unngilaa
simissu¦aq	N	–up, –it
Simiut¦aq	N	{–ap, –tap}, {–at, –tat}
simiut¦aq	N	{–ap, –tap}, {–at, –tat}
simiutarsu¦aq	N	–up, –it
simiut¦taniippoq	V	{–aniinngilaq, –taniinngilaq}
simmarippianngilaq	V	(no generation)
simmari¦ppoq	V	–nngilaq
simm¦erpaa	V	–inngilaa
simmi¦orpoq	V	–unngilaq
simmiu¦ppoq	V	–tinngilaq
simmiussima¦voq	V	–nngilaq
sinaagi¦ppoq	V	–nngilaq
sinaagissi¦voq	V	–nngilaq
sinaagissuu¦voq	V	–nngilaq
sinaagi¦ssuuvoq	V	{–ssuunngilaq, –ttuunngilaq}
sinaakkus¦erpaa	V	–inngilaa
sinaakku¦serpaa	V	{–sinngilaa, –tilinngilaa}
sinaakku¦siussaq	N	{–siussap, –tiliussap}, {–siussat, –tiliussat}
sinaakkut	N	–ip, –it
sinaakkut	N, pl.	-
sinaakkutaa¦voq	V	–nngilaq
sinaalia¦rpoq	V	–nngilaq
sinaali¦ppoq	V	–nngilaq
sinaanii¦ppoq	V	–nngilaq
sinaani¦ppoq	V	–nngilaq
sinaa¦ppaa	V	–tinngilaa
sinaa¦q	N	–p, –t
sinaarpaluk	N	–up, –it
sinaarpalu¦k	N	–up, –it
sinaarpalunne¦q	N	–rup, –rit
sinaarpalu¦ppoq	V	–nngilaq
sinaa¦rpoq	V	–nngilaq
sinaarsa¦rpaa	V	–nngilaa
sinaarsu¦ppoq	V	–nngilaq
sinaasa¦q	N	–p, –t
sinaasi¦orpaa	V	–unngilaa
sinaasi¦orpoq	V	–unngilaq
sinaassi¦voq	V	–nngilaq
sinarsueru¦ppoq	V	–tinngilaq
sinarsugi¦ppoq	V	–nngilaq
sinarsugiss¦oq	N	–up, –ut
sinarsugi¦ssoq	N	{–ssup, –ttup}, {–ssut, –ttut}
sinarsuia¦rpaa	V	–nngilaa
sinarsu¦k	N	–up, –it
sinarsul¦ik	N	{–iup, –lip, –lup}, –lit
sinarsullu¦ppoq	V	–nngilaq
sinarsullutt¦oq	N	–up, –ut
sinass¦erpoq	V	–inngilaq
sinassers¦orpoq	V	–unngilaq
sineerulluinna¦rpoq	V	–nngilaq
sineerullu¦innarpoq	V	{–innanngilaq, –aannanngilaq}
sineeru¦ppoq	V	–tinngilaq
sineerussu¦ppaa	V	–tinngilaa
sineqanngilaq	V	(no generation)
sineqa¦rpoq	V	–nngilaq
sineqat	N	–ip, –it
sineqataa¦voq	V	–nngilaq
sineqateqa¦rpoq	V	–nngilaq
sineqqaarpoq	V	(no generation)
sineqqajaalerpoq	V	(no generation)
sineqqi¦ppoq	V	–nngilaq
sineqqunngilaa	V	(no generation)
sinequs¦erpoq	V	–inngilaq
siner¦eerpoq	V	–iinngilaq
sineriaa¦voq	V	–nngilaq
sineri¦ak	N	{–ssap, –aap}, {–ssat, –aat}
sineriammiu	N	–p, –t
sineriassu¦aq	N	–up, –it
sin¦erpaa	V	–inngilaa
sinerpart¦erpoq	V	–inngilaq
sinerparteru¦ppaa	V	–tinngilaa
sin¦erpoq	V	–inngilaq
sinersi¦voq	V	–nngilaq
siners¦ooq	N	–uup, –uut
siners¦oorpoq	V	–uunngilaq
sinersori¦aq	N	–ssap, –ssat
siners¦orpaa	V	–unngilaa
siners¦orpoq	V	–unngilaq
sinersortaannarpoq	V	(no generation)
sinersortaat	N	–ip, –it
siner¦sortaat	N	{–sortaat, –tortaat, –sortaatip}, –sortaatit
sinersu¦k	N	–up, –it
sinersuut	N	–ip, –it
sinersuut	N, pl.	-
siner¦suut	N	{–suutip, –tuutip}, {–suutit, –tuutit}
sinersuutaa¦voq	V	–nngilaq
siner¦suutaavoq	V	{–suutaanngilaq, –tuutaanngilaq}
sinertuarpaa	V	(no generation)
sinerulu¦ppoq	V	–nngilaq
sinerulutsi¦ppaa	V	–nngilaa
singaallag¦aa	V	–inngilaa
singaallagiinna¦rpaa	V	–nngilaa
singaa¦ppaa	V	–tinngilaa
singangaa¦rpoq	V	–nngilaq
singangalaa¦rpoq	V	–nngilaq
singangavallaa¦rpoq	V	–nngilaq
singanga¦voq	V	–nngilaq
singarna¦q	N	–p, –t
singarne¦q	N	–rup, –rit
singarneqa¦rpoq	V	–nngilaq
singa¦rpaa	V	–nngilaa
singa¦rpoq	V	–nngilaq
singarti¦ppaa	V	–nngilaa
singarti¦ppoq	V	–nngilaq
singartiterpaa	V	(no generation)
singartiterpoq	V	(no generation)
singartitersimas¦oq	N	–up, –ut
singartit¦igaq	N	{–ikkap, –sikkap}, {–ikkat, –sikkat}
sing¦eerpaa	V	–iinngilaa
sing¦eerpoq	V	–iinngilaq
singeersima¦voq	V	–nngilaq
singeeru¦ppoq	V	–tinngilaq
singeerutt¦oorpoq	V	–uunngilaq
sing¦eq	N	–ip, –it
singerfi¦k	N	–up, –it
singerlua¦rpoq	V	–nngilaq
singerne¦q	N	–rup, –rit
singernequt	N	–ip, –it
singernerlu¦ppoq	V	–nngilaq
singerniia¦rpoq	V	–nngilaq
singerniki¦ppoq	V	–nngilaq
singernilu¦ppoq	V	–nngilaq
sing¦erpaa	V	–inngilaa
sing¦erpoq	V	–inngilaq
singers¦orpoq	V	–unngilaq
singer¦sorpoq	V	{–sunngilaq, –tunngilaq}
singersortakkat	N, pl.	-
singi¦ppaa	V	–nngilaa
singi¦ppoq	V	–nngilaq
singissa¦rpaa	V	–nngilaa
singissart¦oq	N	–up, –ut
singi¦ssartoq	N	{–ssartup, –ttartup}, {–ssartut, –ttartut}
singi¦ssivoq	V	{–ssinngilaq, –tsinngilaq}
singiss¦orpaa	V	–unngilaa
singissui¦voq	V	–nngilaq
singi¦tsivoq	V	{–ssinngilaq, –tsinngilaq}
singiu¦ppaa	V	–tinngilaa
sing¦oorpoq	V	–uunngilaq
singull¦orpoq	V	–unngilaq
singullorti¦ppaa	V	–nngilaa
singunnerlua¦rpoq	V	–nngilaq
singunn¦erpoq	V	–inngilaq
singunnersimaanna¦rpoq	V	–nngilaq
singunniu¦ppaa	V	–tinngilaa
singu¦voq	V	–nngilaq
sini	N	–p, –t
siniffi¦k	N	–up, –it
siniffili¦orpoq	V	–unngilaq
siniffissa¦q	N	–p, –t
siniinnalerne¦q	N	–rup, –rit
sin¦ik	N	{–iup, –ngup}, –iit
sinikasippoq	V	(no generation)
sinikataa¦rpoq	V	–nngilaq
sinikataartuarpoq	V	(no generation)
sinikataarutig¦aa	V	–inngilaa
sinikkajuppoq	V	(no generation)
sinikkallassaaq	V	(no generation)
sinikkalu¦aq	N	–up, –it
sinikkiartoqqaarallarpoq	V	(no generation)
sinikkiartorsimagaluarpoq	V	(no generation)
sinikkumanngivippoq	V	(no generation)
sinikkumareerpoq	V	(no generation)
sinikkumassanngilaq	V	(no generation)
sinikkunnaassa¦aq	V	–nngilaq
sinikkusukkunnaarpoq	V	(no generation)
sinikkusuleraluarpoq	V	(no generation)
sinikkusunnarpoq	V	(no generation)
sinikkusunnarta¦rpoq	V	–nngilaq
sinikkusunnguatsiarpoq	V	(no generation)
sinikkusuttuarpoq	V	(no generation)
sinikuj¦oorpoq	V	–uunngilaq
sinikulaarpallaarpoq	V	(no generation)
sinilaa¦rpoq	V	–nngilaq
sinileraluarsima¦voq	V	–nngilaq
sinil¦erpoq	V	–inngilaq
sinilersimagalua¦rpoq	V	–nngilaq
sinilersimasaraaq	V	(no generation)
sinilersinnaanngilaq	V	(no generation)
sinilerumaa¦rpoq	V	–nngilaq
sinileruma¦voq	V	–nngilaq
sinilianngilaq	V	(no generation)
siniliinna¦rpoq	V	–nngilaq
siniliinnarta¦rpoq	V	–nngilaq
siniliinnartarsimavoq	V	(no generation)
sinillattaaginnarpoq	V	(no generation)
sinillattaarpoq	V	(no generation)
sinillug¦aa	V	–inngilaa
sinimisaarne¦q	N	–rup, –rit
sinimisaarpoq	V	(no generation)
siningaa¦rpoq	V	–nngilaq
siningajaarne¦q	N	–rup, –rit
siningajaa¦rpoq	V	–nngilaq
sininnart¦oq	N	–up, –ut
sininnaveerne¦q	N	–rup, –rit
sininngilaq	V	(no generation)
sininngilerpoq	V	(no generation)
sininnguanngilaq	V	(no generation)
sininnguatsiaraluarpoq	V	(no generation)
sininnguatsiarpoq	V	(no generation)
sininnia¦q	N	–p, –t
siniora¦ppoq	V	–nngilaq
sinippaa¦rpoq	V	–nngilaq
sinippaart¦oq	N	–up, –ut
sinippallaanngikkaluarpoq	V	(no generation)
sinippallaannguatsiarpoq	V	(no generation)
sinippallaaraluarpoq	V	(no generation)
sinippallaa¦rpoq	V	–nngilaq
sinippallaarujussua¦rpoq	V	–nngilaq
sinippallaarunanngilaq	V	(no generation)
sini¦ppoq	V	–nngilaq
sinissaaleqi¦voq	V	–nngilaq
sinissaa¦rpoq	V	–nngilaq
sinissaarsinnaanngilaq	V	(no generation)
sinissaarunne¦q	N	–rup, –rit
sinissaaru¦ppoq	V	–tinngilaq
sinissaaruttaannarpoq	V	(no generation)
sinissaat	N	–ip, –it
sinissa¦q	N	–p, –t
sinissaqanngilaq	V	(no generation)
sinissaqa¦rpoq	V	–nngilaq
sinissu¦aq	N	–up, –it
sinissuataarpoq	V	(no generation)
sinitsiarpoq	V	(no generation)
sinitsiarsinnaavoq	V	(no generation)
sinitsi¦ppaa	V	–nngilaa
sinitsitsine¦q	N	–rup, –rit
sinitsitsisart¦oq	N	–up, –ut
sinittarfi¦k	N	–up, –it
sinittarfimmii¦ppoq	V	–nngilaq
sinittarfiu¦voq	V	–nngilaq
sinittari¦aq	N	–ssap, –ssat
sinittariaqassagaluarpoq	V	(no generation)
sinittariaqassanngilaq	V	(no generation)
sinittaria¦rpoq	V	–nngilaq
sinitt¦oorpoq	V	–uunngilaq
sinitt¦oq	N	–up, –ut
siniu¦erpoq	V	–inngilaq
siniu¦ppaa	V	–tinngilaa
siniussi¦voq	V	–nngilaq
sinnaa¦rpaa	V	–nngilaa
sinnakilaa¦rpoq	V	–nngilaq
sinnakilli¦orpoq	V	–unngilaq
sinnakilli¦voq	V	–nngilaq
sinnaki¦ppoq	V	–nngilaq
sinnakisaa¦rpoq	V	–nngilaq
sinnari¦ppoq	V	–nngilaq
sinnarissaa¦rpoq	V	–nngilaq
sinnarissi¦voq	V	–nngilaq
sinnarivi¦ppoq	V	–nngilaq
sinnarliorne¦q	N	–rup, –rit
sinnarli¦orpoq	V	–unngilaq
sinnarliuutig¦aa	V	–inngilaa
sinnarlunne¦q	N	–rup, –rit
sinnarlu¦ppoq	V	–nngilaq
sinnart¦ooq	N	–uup, –uut
sinnart¦oorpoq	V	–uunngilaq
sinnartoorsu¦aq	N	–up, –it
sinnartuallaaqaaq	V	(no generation)
sinnartunersaa¦voq	V	–nngilaq
sinnartu¦voq	V	–nngilaq
sinnassaas¦erpaa	V	–inngilaa
sinnassaa¦serpaa	V	{–sinngilaa, –tilinngilaa}
sinnassaasia¦q	N	–p, –t
sinnassaa¦siaq	N	{–siap, –tiliap}, {–siat, –tiliat}
sinnassaasi¦orpoq	V	–unngilaq
sinnassaa¦siorpoq	V	{–siunngilaq, –tiliunngilaq}
sinnassaat	N	–ip, –it
sinnassaatissa¦q	N	–p, –t
sinnassaa¦voq	V	–nngilaq
sinnassa¦rpaa	V	–nngilaa
sinnassartuarpaa	V	(no generation)
sinnatt¦oq	N	–up, –ut
sinnattor¦aa	V	–inngilaa
sinnattorajuppoq	V	(no generation)
sinnatt¦orpoq	V	–unngilaq
sinnattortaannarpoq	V	(no generation)
sinnattua¦q	N	–p, –t
sinnattuaqa¦rpoq	V	–nngilaq
sinnattuaqine¦q	N	–rup, –rit
sinnattuaqinilersaarutit	N, pl.	-
sinnattua¦voq	V	–nngilaq
sinnattug¦aa	V	–inngilaa
sinnattu¦gaq	N	–kkap, –kkat
sinnattugaqa¦rpoq	V	–nngilaq
sinnattuleraluarsima¦voq	V	–nngilaq
sinne¦q	N	–rup, –rit
sinneqanngilaq	V	(no generation)
sinneqaqaaq	V	(no generation)
sinneqa¦rpoq	V	–nngilaq
sinneqartaannarpoq	V	(no generation)
sinneqarti¦ppaa	V	–nngilaa
sinneqartoorut	N	–ip, –it
sinnequt	N	–ip, –it
sinnequtarsi¦voq	V	–nngilaq
sinner¦aa	V	–inngilaa
sinnerinngilaa	V	(no generation)
sinnerit¦ooq	N	–uup, –uut
sinneritu¦voq	V	–nngilaq
sinneriu¦ppaa	V	–tinngilaa
sinneri¦voq	V	–nngilaq
sinn¦erpaa	V	–inngilaa
sinnerpallaa¦rpaa	V	–nngilaa
sinnersaas¦oq	N	–up, –ut
sinnersaa¦voq	V	–nngilaq
sinnersig¦aa	V	–inngilaa
sinnersigiinne¦q	N	–rup, –rit
sinnersissa¦q	N	–p, –t
sinneru¦ppaa	V	–tinngilaa
sinneru¦ppoq	V	–tinngilaq
sinnerussaa¦voq	V	–nngilaq
sinneruti¦ppaa	V	–nngilaa
sinnerut¦ippaa	V	{–inngilaa, –sinngilaa, –itinngilaa}
sinnerutt¦oq	N	–up, –ut
sinneruttuu¦voq	V	–nngilaq
sinneru¦voq	V	–nngilaq
sinngag¦aa	V	–inngilaa
sinngan¦eerpaa	V	–iinngilaa
sinngane¦q	N	–rup, –rit
sinnganersu¦aq	N	–up, –it
sinnga¦ppaa	V	–tinngilaa
sinngassaa¦voq	V	–nngilaq
sinngasu¦ppoq	V	–nngilaq
sinngat¦ooq	N	–uup, –uut
sinngatoqaaq	V	(no generation)
sinngavallaaqaaq	V	(no generation)
sinnga¦voq	V	–nngilaq
sinngorneeru¦ppoq	V	–tinngilaq
sinngorne¦q	N	–rup, –rit
sinng¦orpoq	V	–unngilaq
sinngorsaat	N	–ip, –it
sinngorsarpoq	V	(no generation)
sinngortikkiartorlualerpoq	V	(no generation)
sinngortippoq	V	(no generation)
sinngortit¦ippaa	V	–sinngilaa
sinngorull¦erpoq	V	–inngilaq
sinngorullersi¦ppaa	V	–nngilaa
sinngorulliu¦ppaa	V	–tinngilaa
sinngorulul¦erpoq	V	–inngilaq
sinngorulu¦ppoq	V	–nngilaq
sinngoruluttuinnaa¦voq	V	–nngilaq
sinngula¦voq	V	–nngilaq
sinngumaffig¦aa	V	–inngilaa
sinnguma¦voq	V	–nngilaq
sinngusaannaa¦voq	V	–nngilaq
sinngusa¦rpoq	V	–nngilaq
sinngu¦seq	N	{–sip, –tsip}, {–sit, –tsit}
sinngus¦erpaa	V	–inngilaa
sinngu¦serpaa	V	{–sinngilaa, –tilinngilaa}
sinngusertaa¦rpoq	V	–nngilaq
sinngu¦sit	N, pl.	{–sit, –tsit}
sinngut	N	–ip, –it
sinngutig¦aa	V	–inngilaa
sinngutigillua¦rpaa	V	–nngilaa
sinngu¦tsit	N, pl.	{–sit, –tsit}
sinnigaa¦voq	V	–nngilaq
sinni¦gaq	N	–kkap, –kkat
sinniisi	N	–p, –t
sinniis¦oq	N	–up, –ut
sinniisoqarfi¦k	N	–up, –it
sinniisoqarne¦q	N	–rup, –rit
sinniisussa¦q	N	–p, –t
sinniisut	N, pl.	-
sinniisuugallarne¦q	N	–rup, –rit
sinniisuugallart¦oq	N	–up, –ut
sinniisuune¦q	N	–rup, –rit
sinniisuutita¦q	N	–p, –t
sinniisuutitaqarfi¦k	N	–up, –it
sinniisuutitaqarne¦q	N	–rup, –rit
sinniisuutitat	N, pl.	-
sinniisuu¦voq	V	–nngilaq
sinnii¦voq	V	–nngilaq
sinnik¦oq	N	–up, –ut
sinnikoqa¦rpoq	V	–nngilaq
sinnikueru¦ppoq	V	–tinngilaq
sinnikutarsi¦voq	V	–nngilaq
sinnil¦ik	N	{–iup, –lip, –lup}, –lit
sinningiaa¦ppaa	V	–tinngilaa
sinningiag¦aa	V	–inngilaa
sinningianna¦rpoq	V	–nngilaq
sinningiu¦ppaa	V	–tinngilaa
sinnit	N	–ip, –it
siooqqatig¦aa	V	–inngilaa
siooqqatiginngilaa	V	(no generation)
siooqqatissaanngilaq	V	(no generation)
sioorag¦aa	V	–inngilaa
siooragilluinnaleqqavaa	V	(no generation)
siooragisa¦q	N	–p, –t
siooraler¦sitsisoq	N	{–sitsisup, –titsisup}, {–sitsisut, –titsisut}
sioorananngilaq	V	(no generation)
siooranaqaaq	V	(no generation)
sioorana¦rpoq	V	–nngilaq
siooranart¦oq	N	–up, –ut
sioorane¦q	N	–rup, –rit
sioorasaarine¦q	N	–rup, –rit
sioorasaa¦rpaa	V	–nngilaa
sioorasaartiinna¦rpoq	V	–nngilaq
sioorasaarut	N	–ip, –it
sioorasaaruteqarne¦q	N	–rup, –rit
siooras¦oq	N	–up, –ut
sioorassutig¦aa	V	–inngilaa
siooratsa¦ppoq	V	–nngilaq
sioora¦voq	V	–nngilaq
sioqqat	N, pl.	-
sioqqerfiit	N, pl.	-
sioqqerfi¦k	N	–up, –it
sioqqerfillit	N, pl.	-
sioqqeri¦voq	V	–nngilaq
sioqq¦erpaa	V	–inngilaa
sioqqersima¦voq	V	–nngilaq
sioqqia¦rpoq	V	–nngilaq
sioqqisartuu¦voq	V	–nngilaq
sioqqiullua¦rpoq	V	–nngilaq
sioqqiu¦ppoq	V	–tinngilaq
sioqqiuter¦eerpoq	V	–iinngilaq
sioqqi¦voq	V	–nngilaq
sioqqullua¦rpaa	V	–nngilaa
sioqqu¦ppaa	V	–tinngilaa
sioqqutisunga¦rpaa	V	–nngilaa
sioqqutsi¦voq	V	–nngilaq
sioqus¦erpaa	V	–inngilaa
sioqu¦serpaa	V	{–sinngilaa, –tilinngilaa}
sioqussu¦aq	N	–up, –it
sioqut	N	–ip, –it
sioqutaa¦rpaa	V	–nngilaa
sioraanii¦ppoq	V	–nngilaq
sioraaqqat	N, pl.	-
sioraaqqia¦rpoq	V	–nngilaq
sioraasaaru¦ppoq	V	–tinngilaq
sioraasarsi¦voq	V	–nngilaq
sioraasat	N, pl.	-
sioraasi¦orpoq	V	–unngilaq
sioraa¦siorpoq	V	{–siunngilaq, –tiliunngilaq}
sioraataaru¦ppoq	V	–tinngilaq
sioraatsiaat	N, pl.	-
sioraatsut	N, pl.	-
sioraki	N	–p, –t
sioraki¦ppoq	V	–nngilaq
siorakisaa¦rpoq	V	–nngilaq
siorakits¦oq	N	–up, –ut
siorakitsuu¦voq	V	–nngilaq
siorang¦erpaa	V	–inngilaa
siorangersima¦vaa	V	–nngilaa
siorangers¦orpaa	V	–unngilaa
siorangersui¦voq	V	–nngilaq
siorangiukkiart¦orpoq	V	–unngilaq
siorangiu¦ppoq	V	–tinngilaq
siorannginne¦q	N	–rup, –rit
Siorapalu¦k	N	–up, –it
Siorapalu¦k	Prop	–up, –it
Siora¦q	Prop	–p
Sio¦raq	N	–qqap, –qqat
sio¦raq	N	–qqap, –qqat
sioraqarfi¦k	N	–up, –it
siorarl¦eq	N	–iup, –iit
siora¦rpaa	V	–nngilaa
siorarsi¦ooq	N	–uup, –uut
siorarsiorfi¦k	N	–up, –it
siorartaat	N	–ip, –it
siorartaat	N, pl.	-
siorarta¦rpoq	V	–nngilaq
siorarterpaa	V	(no generation)
siorarti¦gaq	N	–kkap, –kkat
siorart¦ooq	N	–uup, –uut
siorartu¦voq	V	–nngilaq
siorasaarine¦q	N	–rup, –rit
siorasaa¦rpaa	V	–nngilaa
siorasaartiinna¦rpoq	V	–nngilaq
siorasaarut	N	–ip, –it
siorasaaruteqarne¦q	N	–rup, –rit
siorassa¦q	N	–p, –t
siorl¦eq	N	–iup, –iit
siornaal¦erpoq	V	–inngilaq
siornaassu¦aq	N	–up, –it
siornalisa¦q	N	–p, –t
siornalitsi¦voq	V	–nngilaq
siornang¦erpaa	V	–inngilaa
siornanitsi¦voq	V	–nngilaq
siornarni¦saq	N	–tsap, –tsat
siorneqattaa¦rpaa	V	–nngilaa
siorn¦erpaa	V	–inngilaa
siornersima¦vaa	V	–nngilaa
siorn¦ersorpaa	V	{–ersunngilaa, –gersunngilaa}
siorneru¦ppaa	V	–tinngilaa
siorngaanng¦orpoq	V	–unngilaq
siorngaassu¦aq	N	–up, –it
siorngalisa¦q	N	–p, –t
siorngarni¦saq	N	–tsap, –tsat
siorngeqattaarpaa	V	(no generation)
siorng¦erpaa	V	–inngilaa
siorngersima¦vaa	V	–nngilaa
siorngersorpaa	V	(no generation)
siorngiisaanna¦rpoq	V	–nngilaq
siorngii¦voq	V	–nngilaq
siorniisaanna¦rpoq	V	–nngilaq
siornii¦voq	V	–nngilaq
siorpaalu¦k	N	–up, –it
siorpaalussi¦voq	V	–nngilaq
siorpalaalla¦k	N	–ap, –at
siorpalaa¦rpoq	V	–nngilaq
siorpalitt¦oq	N	–up, –ut
siorpalu¦ppoq	V	–nngilaq
siorpalutt¦oq	N	–up, –ut
siorsualaa¦rpoq	V	–nngilaq
siorsueru¦ppoq	V	–tinngilaq
siorsu¦k	N	–up, –it
siorsukkunnaa¦rpoq	V	–nngilaq
siorsula¦voq	V	–nngilaq
siorsunneeru¦ppoq	V	–tinngilaq
siorsunne¦q	N	–rup, –rit
siorsu¦ppoq	V	–nngilaq
siorsussu¦aq	N	–up, –it
siorsuttorsu¦uvoq	V	{–aanngilaq, –unngilaq}
sipaa¦gaq	N	–kkap, –kkat
sipaagaqarne¦q	N	–rup, –rit
sipaal¦erpoq	V	–inngilaq
sipaallaqqi¦ppoq	V	–nngilaq
sipaa¦q	N	–p, –t
sipaarnart¦oq	N	–up, –ut
sipaarne¦q	N	–rup, –rit
sipaarniarne¦q	N	–rup, –rit
sipaarniuteqarne¦q	N	–rup, –rit
sipaa¦rpaa	V	–nngilaa
sipaarpallaaqaaq	V	(no generation)
sipaa¦rpoq	V	–nngilaq
sipaartitsine¦q	N	–rup, –rit
siparnersu¦aq	N	–up, –it
siparni	N	–p, –t
siparnik¦oq	N	–up, –ut
sip¦eerpoq	V	–iinngilaq
sipern¦eerpaa	V	–iinngilaa
siperneeru¦ppoq	V	–tinngilaq
siperne¦q	N	–rup, –rit
sipern¦erpaa	V	–inngilaa
sipernil¦erpaa	V	–inngilaa
sipili	N	–p, –t
sipine¦q	N	–rup, –rit
sipingajappoq	V	(no generation)
sipisa¦q	N	–p, –t
sipis¦oorpoq	V	–uunngilaq
sipita¦ppaa	V	–nngilaa
sipita¦ppoq	V	–nngilaq
sipitatsi¦ppaa	V	–nngilaa
sipitavi¦ppoq	V	–nngilaq
sipit¦erpaa	V	–inngilaa
sipi¦vaa	V	–nngilaa
sipi¦voq	V	–nngilaq
sippak¦oq	N	–up, –ut
sippakuu¦voq	V	–nngilaq
sippal¦ik	N	{–iup, –lip, –lup}, –lit
sippaliu¦voq	V	–nngilaq
sippa¦q	N	–p, –t
sippaqa¦rpoq	V	–nngilaq
sippari¦ppoq	V	–nngilaq
sippartu¦voq	V	–nngilaq
sipp¦erpaa	V	{–alinngilaa, –inngilaa}
sipp¦ersorpaa	V	{–alersunngilaa, –ersunngilaa}
sipp¦orpaa	V	–unngilaa
sipport¦orpaa	V	–unngilaa
sipporu¦ppaa	V	–tinngilaa
sipporu¦ppoq	V	–tinngilaq
sipporussaa¦voq	V	–nngilaq
sipporussa¦q	N	–p, –t
sipporussi¦voq	V	–nngilaq
sippuine¦q	N	–rup, –rit
sippukkiart¦orpoq	V	–unngilaq
sippul¦ik	N	{–iup, –lip, –lup}, –lit
sippu¦ppoq	V	–nngilaq
sipputt¦oorpoq	V	–uunngilaq
sippuu¦ppoq	V	–tinngilaq
sisaane¦q	N	–rup, –rit
sisaa¦rpaa	V	–nngilaa
sisaaru¦ppoq	V	–tinngilaq
sisaarussima¦voq	V	–nngilaq
sisaarutt¦oorpoq	V	–uunngilaq
sisaas¦oq	N	–up, –ut
sisaat	N	–ip, –it
sisaa¦voq	V	–nngilaq
sisagaane¦q	N	–rup, –rit
sisagaa¦voq	V	–nngilaq
sisa¦gaq	N	–kkap, –kkat
sisagu¦ppoq	V	–nngilaq
sisa¦k	N	–ap, –at
sisamaannaat	N, pl.	-
sisamaa¦q	N	–p, –t
sisamaat	N	–ip, –it
sisamaat	N, pl.	-
sisamaliat	N, pl.	-
sisamal¦ik	N	{–iup, –lip, –lup}, –lit
sisamalissat	N, pl.	-
sisamali¦voq	V	–nngilaq
sisamanngorne¦q	N	–rup, –rit
sisamanngorneru¦voq	V	–nngilaq
sisamanngornikkut	N, pl.	-
sisamanng¦orpoq	V	–unngilaq
sisamanngort¦oq	N	–up, –ut
sisamaraajui¦ppoq	V	–nngilaq
sisamaraa¦rpoq	V	–nngilaq
sisamararterut	N	–ip, –it
sisamaria¦rpaa	V	–nngilaa
sisamaria¦rpoq	V	–nngilaq
sisamassaan¦eerpoq	V	{–iinngilaq, –inngaanniinngilaq}
sisamassaan¦eerpoq	V	–iinngilaq
sisamat	Num, pl.	-
sisamavil¦ik	N	{–iup, –lip, –lup}, –lit
sisammii¦voq	V	–nngilaq
sisammiu¦ppaa	V	–tinngilaa
sisammiussa¦q	N	–p, –t
sisa¦ppaa	V	–nngilaa
sisassia¦q	N	–p, –t
siseqa¦rpoq	V	–nngilaq
sis¦erpaa	V	–inngilaa
sisi	N	–p, –t
Sisimiormioq	N	(no generation)
Sisimiormiu	N	–p, –t
Sisimiuniinnikuunngilaq	V	(no generation)
Sisimiuniinnikuu¦voq	V	–nngilaq
Sisimiut	N, pl.	-
Sisimiut	Prop, pl.	-
sisoorfig¦aa	V	–inngilaa
sisoorne¦q	N	–rup, –rit
sisoornerit	N, pl.	-
sisoornersu¦aq	N	–up, –it
sis¦oorpoq	V	–uunngilaq
sisoorti¦ppaa	V	–nngilaa
sisooru¦ppaa	V	–tinngilaa
sisoorussaa¦voq	V	–nngilaq
sisoorussa¦q	N	–p, –t
sisoqqari¦ppoq	V	–nngilaq
sisoqqarissi¦voq	V	–nngilaq
sisoqqarivi¦ppoq	V	–nngilaq
sisoraa¦siorpoq	V	{–siunngilaq, –tiliunngilaq}
sisoraasisa¦rpoq	V	–nngilaq
sisoraat	N	–ip, –it
sisoraatersorfi¦k	N	–up, –it
sisoraatersorne¦q	N	–rup, –rit
sisoraatilisa¦rpoq	V	–nngilaq
sisoraatisi¦voq	V	–nngilaq
sisoraatit	N, pl.	-
sisorarfi¦k	N	–up, –it
sisorarfiss¦iortoq	N	{–iortup, –aliortup}, {–iortut, –aliortut}
sisoraria¦rpoq	V	–nngilaq
sisorarne¦q	N	–rup, –rit
sisora¦rpoq	V	–nngilaq
sisorartaannarpoq	V	(no generation)
sisorartarfi¦k	N	–up, –it
sisorartari¦aq	N	{–ssap, –ap}, {–ssat, –at}
sisorartari¦aq	N	–ssap, –ssat
sisorartart¦oq	N	–up, –ut
sisorart¦oq	N	–up, –ut
sissaki¦ppoq	V	–nngilaq
sissalia¦rpoq	V	–nngilaq
sissal¦ik	N	{–iup, –lip, –lup}, –lit
sissangas¦oq	N	–up, –ut
sissanga¦voq	V	–nngilaq
sissangiu¦ppoq	V	–tinngilaq
sissa¦ppoq	V	–nngilaq
sissa¦q	N	–p, –t
sissariarsu¦k	N	–up, –it
sissari¦ppoq	V	–nngilaq
sissarissormiu	N	–p, –t
sissari¦ssormiu	N	{–ssormiup, –ttormiup}, {–ssormiut, –ttormiut}
sissarissuu¦voq	V	–nngilaq
sissari¦ssuuvoq	V	{–ssuunngilaq, –ttuunngilaq}
sissarluaqi¦voq	V	–nngilaq
sissarlu¦ppoq	V	–nngilaq
sissarmiu	N	–p, –t
sissarmiuta¦q	N	–p, –t
sissarsuit	N, pl.	-
sissatsi¦ppaa	V	–nngilaa
sisserigajuppoq	V	(no generation)
sisserivallaaqaaq	V	(no generation)
sisseri¦voq	V	–nngilaq
sissia¦rpoq	V	–nngilaq
sissiffi¦k	N	–up, –it
sissiffiusart¦oq	N	–up, –ut
sissi¦k	N	–up, –it
sissingusal¦erpaa	V	–inngilaa
sissingusa¦q	N	–ap, –at
sissingusaqarne¦q	N	–rup, –rit
sissinngu¦aq	N	–up, –it
sissi¦ppoq	V	–nngilaq
sissittarfi¦k	N	–up, –it
sissi¦ttarfik	N	{–ssarfiup, –ttarfiup}, {–ssarfiit, –ttarfiit}
sissiu¦gaq	N	–kkap, –kkat
sissiugartaa¦rpoq	V	–nngilaq
sissiukki¦orpoq	V	–unngilaq
sissora¦rpaa	V	–nngilaa
sissora¦rpoq	V	–nngilaq
sissorart¦oorpoq	V	–uunngilaq
sissorneqa¦rpoq	V	–nngilaq
siss¦orpaa	V	–unngilaa
siss¦orpoq	V	–unngilaq
sissorsima¦voq	V	–nngilaq
sissuaqatsi¦voq	V	–nngilaq
sissuerne¦q	N	–rup, –rit
sissu¦erpoq	V	–inngilaq
sissuer¦suuvoq	V	{–suunngilaq, –tuunngilaq}
sissuert¦oq	N	–up, –ut
sissuer¦toq	N	{–sup, –tup}, {–sut, –tut}
sissuertuu¦voq	V	–nngilaq
sissuer¦tuuvoq	V	{–suunngilaq, –tuunngilaq}
sissuiffaari¦ppoq	V	–nngilaq
sissui¦gaq	N	–kkap, –kkat
sissuinnginne¦q	N	–rup, –rit
sissuinngits¦oq	N	–up, –ut
sissuisaanna¦rpoq	V	–nngilaq
sissui¦voq	V	–nngilaq
sissuma¦voq	V	–nngilaq
sisuarasaa¦q	N	–p, –t
sisuat	N, pl.	-
sisujuits¦oq	N	–up, –ut
sisukatta¦rpoq	V	–nngilaq
sisukka¦rpoq	V	–nngilaq
sisukkart¦oorpoq	V	–uunngilaq
sisukkartuaanna¦rpoq	V	–nngilaq
sisullu¦ppoq	V	–nngilaq
sisupiloorfi¦k	N	–up, –it
sisupiloorne¦q	N	–rup, –rit
sisusari¦aq	N	{–ap, –ssap}, {–at, –ssat}
sisusari¦aq	N	–ssap, –ssat
sisuukalaa¦rpoq	V	–nngilaq
sisuukalaarti¦ppaa	V	–nngilaa
sisuukalaartuinnaa¦voq	V	–nngilaq
sisuukalaarut	N	–ip, –it
sisu¦voq	V	–nngilaq
sitserne¦q	N	–rup, –rit
sits¦erpaa	V	–inngilaa
sits¦erpoq	V	–inngilaq
sitsersi¦ppaa	V	–nngilaa
sitsi	N	–p, –t
sitsiaallisa¦gaq	N	–kkap, –kkat
sitsiaallisa¦rpaa	V	–nngilaa
sitsiaalli¦voq	V	–nngilaq
sitsiaa¦ppoq	V	–nngilaq
sitsiliassat	N, pl.	-
sitsili¦orpoq	V	–unngilaq
sitsiu¦ppaa	V	–tinngilaa
sitsiu¦ppoq	V	–tinngilaq
sitsoqig¦aa	V	–inngilaa
sitsoqilaa¦rpoq	V	–nngilaq
sits¦orpoq	V	–unngilaq
sitsors¦orpoq	V	–unngilaq
sitsuig¦aa	V	–inngilaa
sitsui¦k	N	–up, –it
sitsuissaanngilaq	V	(no generation)
sitsungaanna¦rpoq	V	–nngilaq
sitsungalaa¦rpoq	V	–nngilaq
sitsunga¦voq	V	–nngilaq
sitsu¦ppaa	V	–nngilaa
sitsussaa¦voq	V	–nngilaq
siu	N	–p, –t
siuaakkiart¦orpaa	V	–unngilaa
siuaallappoq	V	(no generation)
siuaa¦ppaa	V	–tinngilaa
siuaa¦q	N	–p, –t
siuaasa¦q	N	–p, –t
siuaasaqaqatigii¦ssut	N, pl.	{–ssut, –ttut}
siuaasar¦aa	V	–inngilaa
siuaasat	N, pl.	-
siuaa¦vaa	V	–nngilaa
siuaavi¦ppaa	V	–nngilaa
siuaki¦ppoq	V	–nngilaq
siua¦q	N	–p, –t
siuaria¦rpoq	V	–nngilaq
siuariartorluarpoq	V	(no generation)
siuariart¦orpoq	V	–unngilaq
siuariartorsinnaavoq	V	(no generation)
siua¦rpaa	V	–nngilaa
siua¦rpoq	V	–nngilaq
siuarsarniakkat	N, pl.	-
siuarsa¦rpaa	V	–nngilaa
siuarsimasut	N, pl.	-
siuarsima¦voq	V	–nngilaq
siuarta¦rpoq	V	–nngilaq
siuarti¦ppaa	V	–nngilaa
siuiuits¦oq	N	–up, –ut
siukkaa¦voq	V	–nngilaq
siukka¦q	N	–ap, –at
siukkua¦rpaa	V	–nngilaa
siukkua¦rpoq	V	–nngilaq
siul¦eq	N	–ip, –it
siuleqqiut	N	–ip, –it
siuleqqiutit¦orpoq	V	–unngilaq
siulequt	N	–ip, –it
siulequtaa¦voq	V	–nngilaq
siulequt¦serpaa	V	{–italinngilaa, –sinngilaa}
siulequt¦siineq	N	{–italiinerup, –siinerup}, {–italiinerit, –siinerit}
siuler¦aa	V	–inngilaa
siule¦raq	N	–qqap, –qqat
siulerar¦torpoq	V	{–sunngilaq, –tunngilaq}
siulerisa¦q	N	–p, –t
siulersorneqarne¦q	N	–rup, –rit
siuler¦sorneqarneq	N	{–sorneqarnerup, –torneqarnerup}, {–sorneqarnerit, –torneqarnerit}
siulers¦orpaa	V	–unngilaa
siulers¦orpoq	V	–unngilaq
siuler¦sorpoq	V	{–sunngilaq, –tunngilaq}
siulersortaat	N	–ip, –it
siuler¦sortaat	N	{–sortaat, –tortaat, –sortaatip}, –sortaatit
siuler¦sortaat	N	{–sortaatip, –tortaatip}, {–sortaatit, –tortaatit}
siulersortaa¦voq	V	–nngilaq
siuler¦sortaavoq	V	{–sortaanngilaq, –tortaanngilaq}
siulersorti	N	–p, –t
siulersuine¦q	N	–rup, –rit
siulersuis¦oq	N	–up, –ut
siulersuisoqarne¦q	N	–rup, –rit
siulersuisut	N, pl.	-
siulersui¦voq	V	–nngilaq
siulia	N	–p, –t
siuliaqut	N	–ip, –it
siuliaqutaa¦voq	V	–nngilaq
siulii¦voq	V	–nngilaq
siulilersaarutit	N, pl.	-
siuli¦ppaa	V	–nngilaa
siulittaarpaa	V	(no generation)
siulittaas¦oq	N	–up, –ut
siulittaasoqarfi¦k	N	–up, –it
siulittaasoqatigiit	N, pl.	-
siulittaasuuffi¦k	N	–up, –it
siulittaasuune¦q	N	–rup, –rit
siuli¦ttaat	N	{–ssaatip, –ttaatip}, {–ssaatit, –ttaatit}
siulitta¦rpaa	V	–nngilaa
siulitt¦orpaa	V	–unngilaa
siulittugaa¦voq	V	–nngilaq
siulittuisart¦oq	N	–up, –ut
siulittuis¦oq	N	–up, –ut
siulittui¦voq	V	–nngilaq
siulittuut	N	–ip, –it
siuli¦ttuut	N	{–ssuutip, –ttuutip}, {–ssuutit, –ttuutit}
siulittuuteqarne¦q	N	–rup, –rit
siuli¦ttuuteqarneq	N	{–ssuuteqarnerup, –ttuuteqarnerup}, {–ssuuteqarnerit, –ttuuteqarnerit}
siulittuutig¦aa	V	–inngilaa
siuli¦ttuutigaa	V	{–ssuutiginngilaa, –ttuutiginngilaa}
siulittuutigisaa¦voq	V	–nngilaq
siuli¦ttuutigisaavoq	V	{–ssuutigisaanngilaq, –ttuutigisaanngilaq}
siuliut	N	–ip, –it
siuliuttuutig¦aa	V	–inngilaa
siull¦eeq	N	–iip, –iit
siulleers¦ooq	N	–uup, –uut
siull¦eq	N	–iup, –iit
siullerm¦eerpaa	V	–iinngilaa
siullerm¦eerpoq	V	{–iinngilaq, –inngaanniinngilaq}
siullerm¦eerpoq	V	–iinngilaq
siullerpaa¦q	N	–p, –t
siullersaa¦voq	V	–nngilaq
siulliarsuit	N, pl.	-
siulliarsu¦k	N	–up, –it
siulliiki¦ppoq	V	–nngilaq
siulliit	N, pl.	-
siulliulaa¦rpoq	V	–nngilaq
siulliunersaa¦voq	V	–nngilaq
siulliu¦ppaa	V	–tinngilaa
siulliussaa¦voq	V	–nngilaq
siulliussi¦voq	V	–nngilaq
siulliuti¦ppaa	V	–nngilaa
siulliut¦ippaa	V	{–itinngilaa, –sinngilaa}
siulliu¦voq	V	–nngilaq
siullunne¦q	N	–rup, –rit
siullu¦ppoq	V	–nngilaq
siulluut	N	–ip, –it
siumi¦oq	N	–up, –ut
siumior¦aa	V	–inngilaa
siumi¦ppaa	V	–nngilaa
siumi¦ppoq	V	–nngilaq
siummiffig¦aa	V	–inngilaa
siummioqa¦rpoq	V	–nngilaq
siummi¦ppaa	V	–nngilaa
siummi¦ppoq	V	–nngilaq
siummissa¦rpaa	V	–nngilaa
siummissa¦rpoq	V	–nngilaq
siummi¦ssarpoq	V	–ttanngilaq
siummiu	N	–p, –t
siumoorne¦q	N	–rup, –rit
sium¦oorpaa	V	–uunngilaa
sium¦oorpoq	V	–uunngilaq
siumoortari¦aq	N	{–ssap, –ap}, {–ssat, –at}
siumoortari¦aq	N	–ssap, –ssat
siumoorti¦ppaa	V	–nngilaa
siumoortitsi¦voq	V	–nngilaq
siumoorut	N	–ip, –it
siumorneqa¦rpoq	V	–nngilaq
sium¦orpaa	V	–unngilaa
siumorsima¦vaa	V	–nngilaa
siumuinna¦q	N	–ap, –at
siumui¦voq	V	–nngilaq
siumukaatissa¦q	N	–p, –t
siumukarne¦q	N	–rup, –rit
siumukarpallaanngilaq	V	(no generation)
siumuka¦rpoq	V	–nngilaq
siumukartinneqaat	N	–ip, –it
siumukarti¦ppaa	V	–nngilaa
siumukartua¦rpoq	V	–nngilaq
siumukarunnaa¦rpoq	V	–nngilaq
Siumum¦eersoq	N	{–eersup, –eertup, –inngaanneersup, –inngaanneertup, –inngaanninngaanneersup, –inngaanninngaanneertup, –meersup, –meertup, –minngaanneersup, –minngaanneertup, –minngaanninngaanneersup, –minngaanninngaanneertup}, {–eersut, –eertut, –inngaanneersut, –inngaanneertut, –inngaanninngaanneersut, –inngaanninngaanneertut, –meersut, –meertut, –minngaanneersut, –minngaanneertut, –minngaanninngaanneersut, –minngaanninngaanneertut}
Siumu¦t	Prop	{–p, –up}
siuneerulluinna¦rpoq	V	–nngilaq
siuneerullu¦innarpoq	V	{–innanngilaq, –aannanngilaq}
siuneeru¦ppoq	V	–tinngilaq
siuneerutivi¦ppoq	V	–nngilaq
si¦uneq	N	–ornup, –ornit
siuneqa¦rpoq	V	–nngilaq
siuneqarti¦ppaa	V	–nngilaa
siuneqassu¦seq	N	–tsip, –tsit
siuner¦aa	V	–inngilaa
siunersine¦q	N	–rup, –rit
siunersioqatigiinne¦q	N	–rup, –rit
siunersi¦orpaa	V	–unngilaa
siunersisa¦q	N	–p, –t
siunersissaanngilaq	V	(no generation)
siunersissaanngits¦oq	N	–up, –ut
siunersiuine¦q	N	–rup, –rit
siunersiutig¦aa	V	–inngilaa
siunersi¦vaa	V	–nngilaa
siuner¦taavoq	V	{–saanngilaq, –taanngilaq}
siunertal¦ik	N	{–iup, –lip, –lup}, –lit
siuner¦taq	N	{–sap, –tap}, {–sat, –tat}
siuner¦taqarpoq	V	{–saqanngilaq, –taqanngilaq}
siuner¦taraa	V	{–sarinngilaa, –tarinngilaa}
siuner¦tarineqartoq	N	{–sarineqartup, –tarineqartup}, {–sarineqartut, –tarineqartut}
siuner¦tarisaasoq	N	{–sarisaasup, –tarisaasup}, {–sarisaasut, –tarisaasut}
siuner¦tarisalik	N	{–sarisaliup, –sarisallip, –sarisallup, –tarisaliup, –tarisallip, –tarisallup}, {–sarisallit, –tarisallit}
siuner¦tarisaq	N	{–sarisap, –tarisap}, {–sarisat, –tarisat}
siuner¦tarisaqarneq	N	{–sarisaqarnerup, –tarisaqarnerup}, {–sarisaqarnerit, –tarisaqarnerit}
siuninnii¦ppoq	V	–nngilaq
siunissa¦q	N	–p, –t
siunna¦k	N	–ap, –at
siunnannii¦ppoq	V	–nngilaq
siunnera¦rpoq	V	–nngilaq
siunnerfeerunne¦q	N	–rup, –rit
siunnerfeqarne¦q	N	–rup, –rit
siunnerfig¦aa	V	–inngilaa
siunnerfi¦k	N	–up, –it
siunn¦erpaa	V	–inngilaa
siunnersoqqunngits¦oq	N	–up, –ut
siunners¦orpaa	V	–unngilaa
siunnersortaane¦q	N	–rup, –rit
siunnersorti	N	–p, –t
siunnersortig¦aa	V	–inngilaa
siunnersortinne¦q	N	–rup, –rit
siunnersortissaliine¦q	N	–rup, –rit
siunnersuine¦q	N	–rup, –rit
siunnersuisarfi¦k	N	–up, –it
siunnersuisart¦oq	N	–up, –ut
siunnersuisooqatigiit	N, pl.	-
siunnersuis¦oq	N	–up, –ut
Siunnersuisoqarfi¦k	N	–up, –it
siunnersuisoqarfi¦k	N	–up, –it
siunnersuisoqarne¦q	N	–rup, –rit
siunnersuisoqatigiit	N, pl.	-
siunnersui¦voq	V	–nngilaq
siunnersuut	N	–ip, –it
siunnersuutaas¦oq	N	–up, –ut
siunnersuutaa¦voq	V	–nngilaq
siunnersuuteqa¦rpoq	V	–nngilaq
siunnersuutig¦aa	V	–inngilaa
siunnersuutigineqart¦oq	N	–up, –ut
siunniu¦ppaa	V	–tinngilaa
siuserilaa¦rpoq	V	–nngilaq
siu¦serilaarpoq	V	{–serilaanngilaq, –tilerilaanngilaq}
siuserine¦q	N	–rup, –rit
siu¦serineq	N	{–serinerup, –tilerinerup}, {–serinerit, –tilerinerit}
siuserisa¦rpoq	V	–nngilaq
siu¦serisarpoq	V	{–serisanngilaq, –tilerisanngilaq}
siuseri¦voq	V	–nngilaq
siu¦serivoq	V	{–serinngilaq, –tilerinngilaq}
siusinaa¦rpaa	V	–nngilaa
siu¦sinaarpaa	V	{–sinaanngilaa, –tilinaanngilaa}
siusinaa¦rpoq	V	–nngilaq
siusinnerpaa¦q	N	–p, –t
siusinnerus¦oq	N	–up, –ut
siusinnerusukkut	N, pl.	-
siusippallaa¦rpoq	V	–nngilaq
siusi¦ppoq	V	–nngilaq
siusiss¦oorpoq	V	–uunngilaq
siusiss¦oq	N	–up, –ut
siusi¦ssoq	N	{–ssup, –ttup}, {–ssut, –ttut}
siussari¦ppoq	V	–nngilaq
siussarissi¦voq	V	–nngilaq
siussarivi¦ppoq	V	–nngilaq
siussarlunne¦q	N	–rup, –rit
siussarlu¦ppoq	V	–nngilaq
siussarlutt¦oq	N	–up, –ut
siusser¦aaq	V	–inngilaq
siut	N	–ip, –it
siut	N, pl.	-
siutaarsigajuppoq	V	(no generation)
siutaarsiunnaa¦rpoq	V	–nngilaq
siutaarsi¦voq	V	–nngilaq
siutaaru¦ppoq	V	–tinngilaq
siutaarussu¦ppaa	V	–tinngilaa
siutaasal¦ik	N	{–iup, –lip, –lup}, –lit
siutaasa¦q	N	–p, –t
siutaats¦oq	N	–up, –ut
siutaki¦ppoq	V	–nngilaq
siuta¦q	N	–p, –t
siuta¦q	N	–rup, –rit
siutari¦ppoq	V	–nngilaq
siutassia¦q	N	–p, –t
siutequtit	N, pl.	-
siute¦roq	N	–qqup, –qqut
siuterorsu¦aq	N	–up, –it
siuteruusa¦q	N	–p, –t
siutig¦aa	V	–inngilaa
siutiki¦ppoq	V	–nngilaq
siutikitsuu¦voq	V	–nngilaq
siutikkaa¦q	N	–p, –t
siutinngunaqaaq	V	(no generation)
siutinnguna¦rpoq	V	–nngilaq
siutinngu¦voq	V	–nngilaq
siutisiort¦oq	N	–up, –ut
siutit¦ooq	N	–uup, –uut
siutitoorsu¦aq	N	–up, –it
siutitt¦orpoq	V	–unngilaq
siutt¦oq	N	–up, –ut
siuttuugaju¦ppoq	V	–nngilaq
siuttuu¦voq	V	–nngilaq
siuu¦ppaa	V	–tinngilaa
siuusaki¦ppoq	V	–nngilaq
siuusa¦q	N	–p, –t
siuusaqa¦rpoq	V	–nngilaq
siuussa¦q	N	–p, –t
siuussi¦voq	V	–nngilaq
siuussui¦voq	V	–nngilaq
siuuttuu¦voq	V	–nngilaq
siveqanngilaq	V	(no generation)
siveqa¦rpoq	V	–nngilaq
siveqqerfig¦aa	V	–inngilaa
sivikig¦aa	V	–inngilaa
sivikilli¦voq	V	–nngilaq
sivikinaar¦sivoq	V	{–inngilaq, –sinngilaq}
siviki¦ppoq	V	–nngilaq
sivikissu¦seq	N	–tsip, –tsit
sivikits¦oq	N	–up, –ut
sivikitsuu¦voq	V	–nngilaq
sivingane¦q	N	–rup, –rit
sivinga¦voq	V	–nngilaq
sivinngarilluinnarpoq	V	(no generation)
sivinngari¦ppoq	V	–nngilaq
sivis¦ooq	N	–uup, –uut
sivisoorsu¦aq	N	–up, –it
sivisuallaaqaaq	V	(no generation)
sivisug¦aa	V	–inngilaa
sivisujaa¦q	N	–p, –t
sivisujaarsu¦aq	N	–up, –it
sivisunaa¦rpaa	V	–nngilaa
sivisunaarpoq	V	(no generation)
sivisunaart¦oq	N	–up, –ut
sivisunersaat	N	–ip, –it
sivisussu¦seq	N	–tsip, –tsit
sivisussusiligaanngits¦oq	N	–up, –ut
sivisu¦voq	V	–nngilaq
sivits¦orpaa	V	–unngilaa
sivitsorpallaa¦rpoq	V	–nngilaq
sivits¦orpoq	V	–unngilaq
sivitsortaa¦rpoq	V	–nngilaq
sivitsortaat	N	–ip, –it
sivitsuigallarne¦q	N	–rup, –rit
sivitsuine¦q	N	–rup, –rit
sivitsuis¦oq	N	–up, –ut
sivitsullart¦oq	N	–up, –ut
sivitsunngits¦oq	N	–up, –ut
sivitsuus¦erpaa	V	–inngilaa
sivitsuu¦serpaa	V	{–sinngilaa, –tilinngilaa}
sivitsuu¦serpaa	V	–tilinngilaa
sivitsuut	N	–ip, –it
Sjælland¦imiu	N	{–ermiup, –imiup}, {–ermiut, –imiut}
skakkerfi¦k	N	–up, –it
skakkerne¦q	N	–rup, –rit
skakkertart¦oq	N	–up, –ut
skakki	N	(no generation)
Skandina¦via	Prop	{–aviap, –viap}
skiima	N	(no generation)
sk¦ooq	N	–uup, –uut
skrivemaskiina	N	–p, –t
skuul¦erpoq	V	–inngilaq
skuulisaa¦rpoq	V	–nngilaq
skuut	N, pl.	-
skuu¦t	N	{–t, –p, –tip}, {–t, –tit}
skål¦eerpoq	V	–iinngilaq
Slovakiam¦eersoq	N	{–eersup, –eertup, –inngaanneersup, –inngaanneertup}, {–eersut, –eertut, –inngaanneersut, –inngaanneertut}
Slovakiamioq	N	(no generation)
Slovakiamiu	N	–p, –t
Sloveniam¦eersoq	N	{–eersup, –eertup, –inngaanneersup, –inngaanneertup}, {–eersut, –eertut, –inngaanneersut, –inngaanneertut}
Sloveniamioq	N	(no generation)
Sloveniamiu	N	–p, –t
smokingilisaa¦rpoq	V	–nngilaq
SMS	Prop	–ip
Somaliam¦eersoq	N	{–eersup, –eertup, –inngaanneersup, –inngaanneertup, –inngaanninngaanneersup, –inngaanninngaanneertup}, {–eersut, –eertut, –inngaanneersut, –inngaanneertut, –inngaanninngaanneersut, –inngaanninngaanneertut}
Somaliamioq	N	(no generation)
Somalia¦miu	N	{–miup, –rmiup}, {–miut, –rmiut}
soorlikiaq	Interj	(no generation)
soormi	Interj	(no generation)
sooruna	Interj	(no generation)
soorunami	Interj	(no generation)
soqaa	V	(no generation)
soqanngilaq	V	(no generation)
soqanngits¦oq	N	–up, –ut
soqa¦rpoq	V	–nngilaq
soqatigisa¦q	N	–p, –t
soqqaaja¦rpaa	V	–nngilaa
soqqaa¦rpaa	V	–nngilaa
soqqaartaat	N	–ip, –it
soqqaarut	N	–ip, –it
soqqaat	N	–ip, –it
soqqal¦ik	N	{–iup, –lip, –lup}, –lit
soqqaliunngits¦oq	N	–up, –ut
soqqa¦q	N	–ap, –at
soqqar¦serpaa	V	{–sinngilaa, –talinngilaa}
soqq¦arsersorpaa	V	{–arsersunngilaa, –artalersunngilaa, –ersunngilaa}
soqqartaaru¦ppoq	V	–tinngilaq
soqqartal¦erpaa	V	–inngilaa
soqqar¦talerpaa	V	{–sinngilaa, –talinngilaa}
soqqartalers¦orpaa	V	–unngilaa
soqq¦artalersorpaa	V	{–arsersunngilaa, –artalersunngilaa, –ersunngilaa}
soqqartal¦ik	N	{–iup, –lip, –lup}, –lit
soqqarta¦q	N	–p, –t
soqqartassa¦q	N	–p, –t
soqqi¦voq	V	–nngilaq
soqqusaalliorne¦q	N	–rup, –rit
soqqusaalli¦orpoq	V	–unngilaq
soqqusaanne¦q	N	–rup, –rit
soqqusaappallaa¦rpoq	V	–nngilaq
soqqusaa¦ppoq	V	–nngilaq
soqqusaats¦oq	N	–up, –ut
soqqusaatsuu¦voq	V	–nngilaq
soqulajart¦orpoq	V	–unngilaq
soqula¦voq	V	–nngilaq
soqulle¦q	N	–rup, –rit
soqullia¦rpoq	V	–nngilaq
soqulliart¦orpoq	V	–unngilaq
soqulliar¦torpoq	V	{–sunngilaq, –tunngilaq}
soqulli¦voq	V	–nngilaq
soqunninngilaa	V	(no generation)
soqunniutinngilaq	V	(no generation)
soqus¦erpaa	V	–inngilaa
soqu¦serpaa	V	{–sinngilaa, –tilinngilaa}
soqutaanngilaq	V	(no generation)
soqutaanngits¦oq	N	–up, –ut
soqutaa¦voq	V	–nngilaq
soqutig¦aa	V	–inngilaa
soqutigillu¦innarpaa	V	{–aannanngilaa, –innanngilaa}
soqutiginart¦oq	N	–up, –ut
soqutiginassu¦seq	N	–tsip, –tsit
soqutigineqanngilaq	V	(no generation)
soqutigineqanngits¦oq	N	–up, –ut
soqutiginngilaa	V	(no generation)
soqutiginngivippaa	V	(no generation)
soqutiginnilluartorsu¦aq	N	–up, –it
soqutiginninne¦q	N	–rup, –rit
soqutiginni¦ppoq	V	–nngilaq
soqutiginnitt¦oq	N	–up, –ut
soqutigisa¦q	N	–p, –t
soqutigisaqanngilaq	V	(no generation)
soqutigisaqanngilluinnarne¦q	N	–rup, –rit
soqutigisaqanngissu¦seq	N	–tsip, –tsit
soqutigisaqanngits¦oq	N	–up, –ut
soqutigisaqaqat	N	–ip, –it
soqutigisaqaqatigiit	N, pl.	-
soqutigisaqarfig¦aa	V	–inngilaa
soqutigisaqarfi¦k	N	–up, –it
soqutigittaa¦ppoq	V	–nngilaq
soqutigittaassu¦seq	N	–tsip, –tsit
soqutigi¦ttaassuseq	N	{–ssaassutsip, –ttaassutsip}, {–ssaassutsit, –ttaassutsit}
soqutigittaats¦oq	N	–up, –ut
soqutigi¦ttarneq	N	{–ssarnerup, –ttarnerup}, {–ssarnerit, –ttarnerit}
soqutigi¦ttartoq	N	{–ssartup, –ttartup}, {–ssartut, –ttartut}
soqutigiunnaa¦rpaa	V	–nngilaa
soraajaaqquaa	V	(no generation)
soraajaaqqugaluarpaa	V	(no generation)
soraajaaqqunavianngilaa	V	(no generation)
soraajaaqqusimagaluarpaa	V	(no generation)
soraajaaqqusimavaa	V	(no generation)
soraajaarpallaarpoq	V	(no generation)
soraajaarpallaarta¦rpoq	V	–nngilaq
soraajaarsimavoq	V	(no generation)
soraajaartariaqanngilaq	V	(no generation)
soraajaartariaqa¦rpoq	V	–nngilaq
soraajaarta¦rpoq	V	–nngilaq
soraajaassa¦aq	V	–nngilaq
soraajanngilaq	V	(no generation)
soraajanngissu¦seq	N	–tsip, –tsit
soraaja¦voq	V	–nngilaq
soraaju¦erpoq	V	–inngilaq
soraajui¦ppoq	V	–nngilaq
soraajuissu¦seq	N	–tsip, –tsit
soraajuits¦oq	N	–up, –ut
soraalerunarpoq	V	(no generation)
soraarluinnarpoq	V	(no generation)
soraarnavianngilaq	V	(no generation)
soraarne¦q	N	–rup, –rit
soraarnersiutit	N, pl.	-
soraarnerussutisial¦ik	N	{–iup, –lip, –lup}, –lit
soraarnerussutisiaqartitsine¦q	N	–rup, –rit
soraarnerussutisiassalerii¦gaq	N	–kkap, –kkat
soraarnerussutisiat	N, pl.	-
soraarnik¦oq	N	–up, –ut
soraarninng¦orpoq	V	–unngilaq
soraarninngorti¦ppaa	V	–nngilaa
soraarniut	N	–ip, –it
soraarniuteqarne¦q	N	–rup, –rit
soraarp¦oq	N	–up, –ut
soraa¦rpoq	V	–nngilaq
soraarput	N, pl.	-
soraarsima¦voq	V	–nngilaq
soraar¦sippaa	V	{–sinngilaa, –tinngilaa}
soraar¦sitaagallarneq	N	{–sitaagallarnerup, –titaagallarnerup}, {–sitaagallarnerit, –titaagallarnerit}
soraar¦sitaaneq	N	{–sitaanerup, –titaanerup}, {–sitaanerit, –titaanerit}
soraar¦sitsineq	N	{–sitsinerup, –titsinerup}, {–sitsinerit, –titsinerit}
soraar¦sitsiortorneq	N	{–sitsiortornerup, –titsiortornerup}, {–sitsiortornerit, –titsiortornerit}
soraar¦sitsisinnaaneq	N	{–sitsisinnaanerup, –titsisinnaanerup}, {–sitsisinnaanerit, –titsisinnaanerit}
soraar¦sitsisinnaatitaaneq	N	{–sitsisinnaatitaanerup, –titsisinnaatitaanerup}, {–sitsisinnaatitaanerit, –titsisinnaatitaanerit}
soraartariaqarne¦q	N	–rup, –rit
soraartussa¦q	N	–p, –t
soraarullu¦innarpaa	V	{–aannanngilaa, –innanngilaa}
soraarummeeqqinne¦q	N	–rup, –rit
soraarumm¦eeqqinneq	N	{–eeqqinnerup, –inngaanneeqqinnerup}, {–eeqqinnerit, –inngaanneeqqinnerit}
soraarummeerne¦q	N	–rup, –rit
soraarumm¦eerneq	N	{–eernerup, –inngaanneernerup}, {–eernerit, –inngaanneernerit}
soraarummeernersi¦orpoq	V	–unngilaq
soraarumm¦eernersiorpoq	V	{–eernersiunngilaq, –inngaanneernersiunngilaq}
soraarummeernia¦rpoq	V	–nngilaq
soraarumm¦eerniarpoq	V	{–eernianngilaq, –inngaanneernianngilaq}
soraarumm¦eerpoq	V	{–iinngilaq, –inngaanniinngilaq}
soraarumm¦eerpoq	V	–iinngilaq
soraarummeersi¦ppaa	V	–nngilaa
soraarumm¦eersippaa	V	{–eersinngilaa, –inngaanneersinngilaa}
soraarummeersita¦q	N	–p, –t
soraarumm¦eersitaq	N	{–eersitap, –inngaanneersitap}, {–eersitat, –inngaanneersitat}
soraarummeersitsine¦q	N	–rup, –rit
soraarumm¦eersitsineq	N	{–eersitsinerup, –inngaanneersitsinerup}, {–eersitsinerit, –inngaanneersitsinerit}
soraarummeersitsis¦oq	N	–up, –ut
soraarumm¦eersitsisoq	N	{–eersitsisup, –inngaanneersitsisup}, {–eersitsisut, –inngaanneersitsisut}
soraarummeer¦toq	N	{–sup, –tup}, {–sut, –tut}
soraarumm¦eertoq	N	{–eersup, –eertup, –inngaanneersup, –inngaanneertup}, {–eersut, –eertut, –inngaanneersut, –inngaanneertut}
soraarummeerut	N	–ip, –it
soraarummeerutissa¦q	N	–p, –t
soraarummeerutissar¦aa	V	–inngilaa
soraarummeerutit	N, pl.	-
soraaru¦ppaa	V	–tinngilaa
soraarussa¦q	N	–p, –t
soraarut	N	–ip, –it
soraarutaa¦voq	V	–nngilaq
soraarutig¦aa	V	–inngilaa
soraarutivi¦ppaa	V	–nngilaa
soralu¦aq	N	–ssap, –ssat
soraluar¦aa	V	–inngilaa
soriagassaanngissu¦seq	N	–tsip, –tsit
soriarsinnaajunnaarsi¦ppaa	V	–nngilaa
soriarsinnaajunnaar¦sippaa	V	{–sinngilaa, –tinngilaa}
soriarsinnaajunnaar¦toq	N	{–sup, –tup}, {–sut, –tut}
soriarsinnaannginne¦q	N	–rup, –rit
sorlaaja¦rpaa	V	–nngilaa
sorlaa¦rpaa	V	–nngilaa
Sorla¦k	N	–ap, –at
sorla¦k	N	–ap, –at
sorlani¦ppoq	V	–nngilaq
sorlanni¦ppoq	V	–nngilaq
sorla¦ppoq	V	–nngilaq
sorlaqarfi¦k	N	–up, –it
sorl¦eq	Pron	–iup, –iit
sorlia¦rpoq	V	–nngilaq
sorlu¦k	N	–up, –it
sorluki¦ppoq	V	–nngilaq
sorlukkoort¦oq	N	–up, –ut
sorlummiga¦rpoq	V	–nngilaq
sorlummi¦ppoq	V	–nngilaq
sorlummissa¦rpoq	V	–nngilaq
sorlummi¦ssarpoq	V	–ttanngilaq
sorlunnga¦voq	V	–nngilaq
sorlunnguna¦rpoq	V	–nngilaq
sorlutt¦ooq	N	–uup, –uut
sororiartorne¦q	N	–rup, –rit
sororiart¦orpoq	V	–unngilaq
sororne¦q	N	–rup, –rit
sor¦orpaa	V	–unngilaa
sor¦orpoq	V	–unngilaq
sororsimas¦oq	N	–up, –ut
sorpaju¦k	N	–p, –t
sorpalu¦ppoq	V	–nngilaq
sorraakkunnaa¦rpoq	V	–nngilaq
sorraalligaluttuinnarpoq	V	(no generation)
sorraalli¦voq	V	–nngilaq
sorraapajaarnerul¦erpoq	V	–inngilaq
sorraa¦ppoq	V	–nngilaq
sorraasaa¦rpoq	V	–nngilaq
sorraaseriataartart¦oq	N	–up, –ut
sorraatsuunngilaq	V	(no generation)
sorru¦k	N	–up, –it
sorrullua¦rpoq	V	–nngilaq
sorruppalu¦ppoq	V	–nngilaq
sorru¦ppoq	V	–nngilaq
sorruttaa¦rpoq	V	–nngilaq
sorsaakkunnaa¦rpaa	V	–nngilaa
sorsaa¦ppaa	V	–tinngilaa
sorsaatig¦aa	V	–inngilaa
sorsaatiginngilaa	V	(no generation)
sorsaativi¦ppaa	V	–nngilaa
sorsannaqaaq	V	(no generation)
sorsa¦ppoq	V	–nngilaq
sorsoqat	N	–ip, –it
sorsualiar¦aa	V	–inngilaa
sorsu¦aq	N	–up, –it
sorsuar¦aa	V	–inngilaa
sorsuarinni¦ppoq	V	–nngilaq
sorsuarisaa¦voq	V	–nngilaq
sorsuffig¦aa	V	–inngilaa
sorsuffi¦k	N	–up, –it
sorsukkiart¦orpaa	V	–unngilaa
sorsukkiart¦orpoq	V	–unngilaq
sorsukkumat¦ooq	N	–uup, –uut
sorsunne¦q	N	–rup, –rit
sorsunnersu¦aq	N	–up, –it
sorsu¦ppaa	V	–nngilaa
sorsu¦ppoq	V	–nngilaq
sorsuttaannarpoq	V	(no generation)
sorsuttart¦oq	N	–up, –ut
sorsuttartoqatigiit	N, pl.	-
sorsuttoqarfi¦k	N	–up, –it
sorsuttut	N, pl.	-
sorsuunne¦q	N	–rup, –rit
sorsuussu¦aq	N	–up, –it
sorsuut	N	–ip, –it
sorsuutee¦raq	N	–qqap, –qqat
sorsuutig¦aa	V	–inngilaa
sorta¦q	N	–p, –t
sorujuiaane¦q	N	–rup, –rit
sorujuiaat	N	–ip, –it
sorujuiaa¦voq	V	–nngilaq
sorujuia¦rpaa	V	–nngilaa
soruju¦k	N	–up, –it
sorujuni¦ppoq	V	–nngilaq
sorujussunni¦ppoq	V	–nngilaq
sorungavoq	V	(no generation)
sorusussuseerutt¦oq	N	–up, –ut
sorusussuseqannginne¦q	N	–rup, –rit
sorusussuseqanngits¦oq	N	–up, –ut
Sovjetunion¦imeersoq	N	{–enimeersup, –enimeertup, –eniminngaanneersup, –eniminngaanneertup, –imeersup, –imeertup, –iminngaanneersup, –iminngaanneertup, –iminngaanninngaanneersup, –iminngaanninngaanneertup}, {–enimeersut, –enimeertut, –eniminngaanneersut, –eniminngaanneertut, –imeersut, –imeertut, –iminngaanneersut, –iminngaanneertut, –iminngaanninngaanneersut, –iminngaanninngaanneertut}
Sovjetunionimioq	N	(no generation)
Sovjetunion¦imiu	N	{–enermiup, –enimiup, –ermiup, –imiup}, {–enermiut, –enimiut, –ermiut, –imiut}
Spaniamiu	N	–p, –t
Sparta¦miu	N	{–miup, –rmiup}, {–miut, –rmiut}
spillerfissa¦q	N	–p, –t
spritti	N	–p, –t
suaaqaa	V	(no generation)
suaarnersu¦aq	N	–up, –it
suaa¦rpaa	V	–nngilaa
suaarpalu¦ppoq	V	–nngilaq
suaa¦rpoq	V	–nngilaq
suaarta¦rpoq	V	–nngilaq
suaarujussua¦rpoq	V	–nngilaq
suaarut	N	–ip, –it
suaarutaa¦voq	V	–nngilaq
suaaruteqarne¦q	N	–rup, –rit
suaarutig¦aa	V	–inngilaa
suaasaaqqat	N, pl.	-
suaasaarart¦orpoq	V	–unngilaq
suaasaarar¦torpoq	V	{–sunngilaq, –tunngilaq}
suaasaarartorti¦ppaa	V	–nngilaa
suaasaarar¦tortippaa	V	{–sortinngilaa, –tortinngilaa}
suaasa¦q	N	–p, –t
suaasart¦orpoq	V	–unngilaq
suaasar¦torpoq	V	{–sunngilaq, –tunngilaq}
suaasarujussuit	N, pl.	-
suaasat	N, pl.	-
suaasiassat	N, pl.	-
suaasi¦orpoq	V	–unngilaq
suaa¦siorpoq	V	{–siunngilaq, –tiliunngilaq}
suaat	N	–ip, –it
sua¦k	N	–ap, –at
suakatta¦rpaa	V	–nngilaa
sual¦ik	N	{–iup, –lip, –lup}, –lit
suali¦orpoq	V	–unngilaq
suallaatiginngilaa	V	(no generation)
suallanngilaq	V	(no generation)
sualla¦ppoq	V	–nngilaq
sualug¦aa	V	–inngilaa
sualuginart¦oq	N	–up, –ut
sualugisassaanngilaq	V	(no generation)
sualugissaa¦voq	V	–nngilaq
sualugu¦ppaa	V	–tinngilaa
sualukkunnaa¦rpoq	V	–nngilaq
sualukku¦ppaa	V	–tinngilaa
sualukkussi¦voq	V	–nngilaq
sualulluinnart¦oq	N	–up, –ut
sualungaart¦oq	N	–up, –ut
sualunnerpaa¦ffik	N	{–ffiup, –juffiup}, {–ffiit, –juffiit}
sualunngilaq	V	(no generation)
sualunngits¦oq	N	–up, –ut
sualunnianngilaq	V	(no generation)
sualuppallaanngilaq	V	(no generation)
sualuppallaaqaaq	V	(no generation)
sualuppallaa¦rpoq	V	–nngilaq
sualuppallaart¦oq	N	–up, –ut
sualuppallaassu¦seq	N	–tsip, –tsit
sualu¦ppoq	V	–nngilaq
sualussu¦seq	N	–tsip, –tsit
sualutt¦oq	N	–up, –ut
sualuttorsu¦aq	N	–up, –it
suangarluffig¦aa	V	–inngilaa
suangarlu¦ppaa	V	–nngilaa
suangarlu¦ppoq	V	–nngilaq
suangarpalu¦ppoq	V	–nngilaq
suangarpalutt¦oq	N	–up, –ut
suangasaarfig¦aa	V	–inngilaa
suangasaa¦rpoq	V	–nngilaq
suangas¦oq	N	–up, –ut
suangassu¦seq	N	–tsip, –tsit
suangavaa	V	(no generation)
suangavoq	V	(no generation)
suani¦ppoq	V	–nngilaq
suanngaatig¦aa	V	–inngilaa
suannga¦ppaa	V	–nngilaa
suanngariart¦orpoq	V	–unngilaq
suannga¦rpoq	V	–nngilaq
suanngarsa¦rpaa	V	–nngilaa
suanngartart¦oq	N	–up, –ut
suanngarti¦ppaa	V	–nngilaa
suannga¦ssivoq	V	{–ssinngilaq, –tsinngilaq}
suanngavig¦aa	V	–inngilaa
suannia¦rpoq	V	–nngilaq
sua¦ppaa	V	–nngilaa
suappallaaqaa	V	(no generation)
sua¦ppoq	V	–nngilaq
suarrutig¦aa	V	–inngilaa
suarsuit	N, pl.	-
suarsu¦k	N	–up, –it
suatt¦ooq	N	–uup, –uut
su¦eq	N	–ip, –it
sueqaaq	V	(no generation)
suerlu¦erpoq	V	–inngilaq
su¦erpaa	V	–inngilaa
suerpallaaqaaq	V	(no generation)
su¦erpoq	V	–inngilaq
suersorsu¦uvoq	V	{–aanngilaq, –unngilaq}
suer¦sorsuuvoq	V	{–sorsuaanngilaq, –sorsuunngilaq, –torsuaanngilaq, –torsuunngilaq}
suersu¦aq	N	–up, –it
sueru¦ppaa	V	–tinngilaa
sueru¦ppoq	V	–tinngilaq
suerutt¦oorpoq	V	–uunngilaq
suffallua¦rpoq	V	–nngilaq
suffa¦ppoq	V	–nngilaq
suffari¦ppoq	V	–nngilaq
suffarissiart¦orpoq	V	–unngilaq
suffas¦erpaa	V	–inngilaa
sufferpianngilaq	V	(no generation)
suff¦erpoq	V	–inngilaq
suffisart¦oq	N	–up, –ut
suffi¦voq	V	–nngilaq
sug¦aa	V	–inngilaa
suginngisa¦q	N	–p, –t
sugisaaru¦ppoq	V	–tinngilaq
sugisa¦q	N	–p, –t
sugisaqa¦rpoq	V	–nngilaq
sugu¦ppoq	V	–tinngilaq
suiaaqatinoort¦oq	N	–up, –ut
suiaassu¦seq	N	–tsip, –tsit
suiaassuseqa¦timinoortuunngitsoq	N	{–timinoortuunngitsup, –mminoortuunngitsup}, {–timinoortuunngitsut, –mminoortuunngitsut}
suiaassu¦seqatiminoortuunngitsoq	N	{–seqatiminoortuunngitsup, –seqamminoortuunngitsup, –tileqatiminoortuunngitsup, –tileqamminoortuunngitsup}, {–seqatiminoortuunngitsut, –seqamminoortuunngitsut, –tileqatiminoortuunngitsut, –tileqamminoortuunngitsut}
suialaanngu¦aq	N	–up, –it
suialaanngua¦rpoq	V	–nngilaq
suialaarfigiti¦ppaa	V	–nngilaa
suialaarfigiti¦ppoq	V	–nngilaq
suialaa¦rpoq	V	–nngilaq
suiallappoq	V	(no generation)
suiallatta¦rpoq	V	–nngilaq
suialuppoq	V	(no generation)
suiaqa¦timinoortartoq	N	{–timinoortartup, –mminoortartup}, {–timinoortartut, –mminoortartut}
suiaqatinoort¦oq	N	–up, –ut
suiaqatinoortut	N, pl.	-
suiikkutaa¦voq	V	–nngilaq
suiikkuta¦q	N	–p, –t
suiikkutar¦aa	V	–inngilaa
suikkaanngilaq	V	(no generation)
suikkaas¦oq	N	–up, –ut
suikkaassu¦seq	N	–tsip, –tsit
suikkaa¦voq	V	–nngilaq
suikka¦k	N	–ap, –at
suikka¦q	N	–p, –t
suilaaqi¦voq	V	–nngilaq
suilaaqu¦sersorpaa	V	{–sersunngilaa, –tilersunngilaa}
suilaaqut	N	–ip, –it
suilaaqutaa¦voq	V	–nngilaq
suilaa¦rpoq	V	–nngilaq
suilaarsaa¦rpoq	V	–nngilaq
suilaarsaat	N	–ip, –it
suilaarsaataa¦voq	V	–nngilaq
suilaarsa¦rpoq	V	–nngilaq
suilatsi¦voq	V	–nngilaq
suinni	N	–p, –t
suinni¦ppoq	V	–nngilaq
suisuajunnaa¦rpoq	V	–nngilaq
suisua¦voq	V	–nngilaq
suit	N, pl.	-
sujumannginne¦q	N	–rup, –rit
sukaasiuinna¦rpoq	V	–nngilaq
sukaa¦siuinnarpoq	V	{–siuinnanngilaq, –tiliuinnanngilaq}
sukaat	N	–ip, –it
sukaataa¦voq	V	–nngilaq
sukaa¦vaa	V	–nngilaa
sukaa¦voq	V	–nngilaq
suka¦avoq	V	{–anngilaq, –tsinngilaq}
sukakkaluttuinnarpoq	V	(no generation)
sukalane¦q	N	–rup, –rit
sukalasorsu¦aq	N	–up, –it
sukala¦voq	V	–nngilaq
sukangane¦q	N	–rup, –rit
sukangasaa¦rpoq	V	–nngilaq
sukanga¦sooq	N	{–suup, –tuup}, {–suut, –tuut}
sukangas¦oq	N	–up, –ut
sukangavallaa¦rpoq	V	–nngilaq
sukanga¦voq	V	–nngilaq
sukannerluinna¦rpoq	V	–nngilaq
sukannerpallaaqaaq	V	(no generation)
sukann¦erpoq	V	–inngilaq
sukanners¦oq	N	–up, –ut
sukanner¦soq	N	{–sup, –tup}, {–sut, –tut}
sukannersorsu¦uvoq	V	{–aanngilaq, –unngilaq}
sukanner¦sorsuuvoq	V	{–sorsuaanngilaq, –sorsuunngilaq, –torsuaanngilaq, –torsuunngilaq}
sukanngaallag¦aa	V	–inngilaa
sukanngaalla¦ppoq	V	–nngilaq
sukanngavig¦aa	V	–inngilaa
sukanngavigisaa¦voq	V	–nngilaq
sukannisa¦rpoq	V	–nngilaq
suka¦ppaa	V	–nngilaa
suka¦ppoq	V	–nngilaq
suka¦q	N	–p, –t
sukar¦aa	V	–inngilaa
suka¦rpaa	V	–nngilaa
sukarsu¦aq	N	–up, –it
sukart¦orpaa	V	–unngilaa
sukartuut	N	–ip, –it
sukartuut	N, pl.	-
sukarut	N	–ip, –it
sukasagaa¦voq	V	–nngilaq
sukasa¦rpaa	V	–nngilaa
sukasa¦rpoq	V	–nngilaq
sukasarti¦ppaa	V	–nngilaa
sukasimaarfig¦aa	V	–inngilaa
sukas¦imaarfigaa	V	{–imaarfiginngilaa, –simaarfiginngilaa}
sukasimaa¦rpoq	V	–nngilaq
sukasimaarut	N	–ip, –it
sukasimaarutig¦aa	V	–inngilaa
sukassa¦rpoq	V	–nngilaq
sukassimaarpoq	V	(no generation)
sukassimas¦oq	N	–up, –ut
sukassu¦ppaa	V	–nngilaa
sukassu¦t	N	{–t, –tit, –p, –tip}, {–t, –tit}
sukassutaasa¦q	N	–p, –t
sukassu¦taasaq	N	{–taasap, –usap}, {–taasat, –usat}
sukataa¦rpoq	V	–nngilaq
sukataarutig¦aa	V	–inngilaa
sukaterine¦q	N	–rup, –rit
sukateri¦voq	V	–nngilaq
sukat¦erpaa	V	–inngilaa
sukat¦erpoq	V	–inngilaq
sukatertuinnaa¦voq	V	–nngilaq
sukater¦tuinnaavoq	V	{–suinnaanngilaq, –tuinnaanngilaq}
sukat¦ertuinnaavoq	V	{–ertuinnaanngilaq, –sertuinnaanngilaq}
sukateru¦ppaa	V	–tinngilaa
sukaterut	N	–ip, –it
suka¦tsivoq	V	{–anngilaq, –tsinngilaq}
sukatt¦oorpoq	V	–uunngilaq
sukavi¦ppoq	V	–nngilaq
sukisaarsaa¦rpoq	V	–nngilaq
sukisaarsaarut	N	–ip, –it
sukisaarsaat	N	–ip, –it
sukisaarsa¦rpoq	V	–nngilaq
sukkaallis¦oorpoq	V	–uunngilaq
sukkaalli¦voq	V	–nngilaq
sukkaa¦ppoq	V	–nngilaq
sukkalisaa¦rpoq	V	–nngilaq
sukkali¦voq	V	–nngilaq
sukkanersaa¦voq	V	–nngilaq
sukkanii¦ppoq	V	–nngilaq
sukkaniunne¦q	N	–rup, –rit
sukkaniu¦ppaa	V	–tinngilaa
sukkaqqisaa¦ppaa	V	–tinngilaa
sukkars¦orpoq	V	–unngilaq
sukkas¦ooq	N	–uup, –uut
sukkasuulia¦q	N	–p, –t
sukkat	N	–ip, –it
sukkatsikkaluttuinnarpoq	V	(no generation)
sukkatsikkiartorne¦q	N	–rup, –rit
sukkatsikkiart¦orpoq	V	–unngilaq
sukkatsinngisaanna¦rpoq	V	–nngilaq
sukkat¦sinngisaannarpoq	V	{–italinngisaannanngilaq, –sinngisaannanngilaq}
sukkatsi¦ppoq	V	–nngilaq
sukkatsisarne¦q	N	–rup, –rit
sukkatsi¦tippaa	V	{–sinngilaa, –tinngilaa, –tsinngilaa}
sukkavallaaqaaq	V	(no generation)
sukka¦voq	V	–nngilaq
sukkinna¦rpoq	V	–nngilaq
sukkinne¦q	N	–rup, –rit
sukki¦orpoq	V	–unngilaq
sukki¦ppoq	V	–nngilaq
sukkisaartitsi¦voq	V	–nngilaq
sukkititsi¦voq	V	–nngilaq
sukkiut	N	–ip, –it
sukkiutaa¦rpaa	V	–nngilaa
sukkiutaa¦voq	V	–nngilaq
sukkiutig¦aa	V	–inngilaa
sukk¦oq	N	–up, –ut
sukkoqa¦rpoq	V	–nngilaq
sukkoqut	N	–ip, –it
sukkorne¦q	N	–rup, –rit
sukk¦orpoq	V	–unngilaq
sukkort¦oq	N	–up, –ut
sukku	N	–p, –t
sukkua¦raq	N	–qqap, –qqat
sukkuararsi¦voq	V	–nngilaq
sukkuarar¦torpoq	V	{–sunngilaq, –tunngilaq}
sukkuarassi¦ppaa	V	–nngilaa
sukkuerullu¦innarpoq	V	{–innanngilaq, –aannanngilaq}
sukkueru¦ppoq	V	–tinngilaq
sukkulaajusa¦q	N	–p, –t
sukkulaali¦orpoq	V	–unngilaq
sukkulaa¦q	N	–p, –t
sukkulaasivi¦k	N	–up, –it
sukkulaat	N	–ip, –it
sukkulaat	N, pl.	-
sukkulaati	N	–p, –t
sukkulaatit¦orpoq	V	–unngilaq
sukkulaati¦torpoq	V	{–sunngilaq, –tunngilaq}
sukkulaat¦orpoq	V	–unngilaq
sukkulaa¦torpoq	V	{–sunngilaq, –tunngilaq}
sukkul¦erpoq	V	–inngilaq
sukkuler¦tarpoq	V	{–sanngilaq, –tanngilaq}
sukkunng¦erpoq	V	–inngilaq
sukkunngersi¦voq	V	–nngilaq
sukkunnger¦sunngorpoq	V	{–sunngunngilaq, –tunngunngilaq}
sukkut	N, pl.	-
sukkutorpallaa¦rpoq	V	–nngilaq
sukku¦torpallaarpoq	V	{–sorpallaanngilaq, –torpallaanngilaq}
sukkut¦orpoq	V	–unngilaq
sukku¦torpoq	V	{–sunngilaq, –tunngilaq}
sukkutorumat¦ooq	N	–uup, –uut
sukku¦torumatooq	N	{–sorumatuup, –torumatuup}, {–sorumatuut, –torumatuut}
sukkuusa¦q	N	–p, –t
suk¦oorpaa	V	–uunngilaa
sukors¦eq	N	–ip, –it
sukorserpalla¦ppoq	V	–nngilaq
sukorsi	N	–p, –t
sukorup¦oorpoq	V	–uunngilaq
sukuiaaffig¦aa	V	–inngilaa
sukuiaa¦ppaa	V	–tinngilaa
sukuiaas¦erpaa	V	–inngilaa
sukuiaa¦serpaa	V	{–sinngilaa, –tilinngilaa}
sukuiaa¦serpaa	V	–tilinngilaa
sukuiaasiu¦ppaa	V	–tinngilaa
sukuiaa¦siuppaa	V	{–siutinngilaa, –tiliutinngilaa}
sukuiaassi¦voq	V	–nngilaq
sukuiaat	N	–ip, –it
sukuiaataa¦voq	V	–nngilaq
sukuiaa¦voq	V	–nngilaq
sukuia¦gaq	N	–kkap, –kkat
sukuia¦rpaa	V	–nngilaa
sukuiarsimas¦oq	N	–up, –ut
sukujuit	N, pl.	-
sukuju¦k	N	–up, –it
sukujuusivi¦k	N	–up, –it
sukull¦erpoq	V	–inngilaq
sukulliu¦ppaa	V	–tinngilaa
sukul¦ooq	N	–uup, –uut
sukulooqa¦rpoq	V	–nngilaq
sukul¦oorpoq	V	–uunngilaq
sukuloorsinnaa¦voq	V	–nngilaq
sukuloorta¦rpoq	V	–nngilaq
sukuloortuu¦voq	V	–nngilaq
sukuluersa¦rpaa	V	–nngilaa
sukuluiaane¦q	N	–rup, –rit
sukuluia¦rpaa	V	–nngilaa
sukului¦ppoq	V	–nngilaq
sukuluit	N, pl.	-
sukuluits¦oq	N	–up, –ut
sukulu¦k	N	–up, –it
sukulupoorne¦q	N	–rup, –rit
sukulup¦oorpoq	V	–uunngilaq
sukuluss¦erpoq	V	–inngilaq
sukulussers¦orpoq	V	–unngilaq
sukulussiu¦ppaa	V	–tinngilaa
sukulutanngueru¦ppoq	V	–tinngilaq
sukuluunng¦erpoq	V	–inngilaq
sukuluussaaru¦ppoq	V	–tinngilaq
sukuluussaat	N	–ip, –it
sukuluussaateqa¦rpoq	V	–nngilaq
sukuluussa¦q	N	–p, –t
sukuluussarsi¦voq	V	–nngilaq
sukum¦erpaa	V	–inngilaa
sukumiis¦oq	N	–up, –ut
sukumi¦ppaa	V	–nngilaa
sukumivi¦ppaa	V	–nngilaa
sukusi¦orpoq	V	–unngilaq
sukuts¦eq	N	–ip, –it
sukuuts¦eq	N	–ip, –it
sukuutserne¦q	N	–rup, –rit
sukuuts¦erpoq	V	–inngilaq
sukuutsillaqqi¦ppoq	V	–nngilaq
sukuutsit	N, pl.	-
suleqat	N	–ip, –it
suleqataane¦q	N	–rup, –rit
suleqataa¦voq	V	–nngilaq
suleqatigiiler¦sitsiniarneq	N	{–sitsiniarnerup, –titsiniarnerup}, {–sitsiniarnerit, –titsiniarnerit}
suleqatigiilluannginne¦q	N	–rup, –rit
suleqatigiinne¦q	N	–rup, –rit
suleqatigiippassuit	N, pl.	-
suleqatigii¦ssitaaneq	N	{–ssitaanerup, –tsitaanerup}, {–ssitaanerit, –tsitaanerit}
suleqatigiissitalia¦q	N	–p, –t
suleqatigiissita¦q	N	–p, –t
suleqatigii¦ssitat	N, pl.	{–ssitat, –tsitat}
suleqatigii¦ssitsineq	N	{–ssitsinerup, –tsitsinerup}, {–ssitsinerit, –tsitsinerit}
suleqatigiit	N, pl.	-
suleqatigineqarallarsinnaavoq	V	(no generation)
suleriaa¦seq	N	–tsip, –tsit
suleriaaseqarne¦q	N	–rup, –rit
suleriaasissa¦q	N	–p, –t
sulerulunne¦q	N	–rup, –rit
suleruluppoq	V	(no generation)
sulerusukkaluaqaaq	V	(no generation)
sulerusukkunnaarpoq	V	(no generation)
sulerusulernikuu¦voq	V	–nngilaq
sulerusuler¦nikuuvoq	V	{–nikuunngilaq, –sinnikuunngilaq}
sulerusulluinnalerpoq	V	(no generation)
sulerusunnarpoq	V	(no generation)
sulerusunnarta¦rpoq	V	–nngilaq
sulerusunneruguna¦rpoq	V	–nngilaq
sulerusunneru¦voq	V	–nngilaq
sulerusunngikkaluarpoq	V	(no generation)
sulerusunngilaq	V	(no generation)
sulerusunngissu¦seq	N	–tsip, –tsit
sulerusussu¦seq	N	–tsip, –tsit
sulerusussuseqart¦oq	N	–up, –ut
sulerusuttuarpoq	V	(no generation)
suliaa¦voq	V	–nngilaq
suliakkerfi¦k	N	–up, –it
suliakk¦erpaa	V	–inngilaa
suliakk¦erpoq	V	–inngilaq
suliakkiiniartarfi¦k	N	–up, –it
suliannaa¦q	N	–p, –t
suliapilu¦k	N	–up, –it
sulia¦q	N	–p, –t
suliaqanngilaq	V	(no generation)
suliaqaqataas¦oq	N	–up, –ut
suliaqarfigisa¦q	N	–p, –t
suliaqarfi¦k	N	–up, –it
suliaqarne¦q	N	–rup, –rit
suliaqa¦rpoq	V	–nngilaq
suliaqartitsine¦q	N	–rup, –rit
suliar¦aa	V	–inngilaa
suliareqqiine¦q	N	–rup, –rit
suliareqqi¦ppaa	V	–nngilaa
suliareqqitassanngortita¦q	N	–p, –t
suliareqqitassanngortitsine¦q	N	–rup, –rit
suliar¦erpallappaa	V	{–erpallanngilaa, –ipallanngilaa}
suliarineqarne¦q	N	–rup, –rit
suliarineqarsinnaaler¦sippaa	V	{–sinngilaa, –tinngilaa}
suliarineqarsinnaas¦oq	N	–up, –ut
suliarineqart¦oq	N	–up, –ut
suliarinial¦erpaa	V	–inngilaa
suliarinneqataasinnaannginne¦q	N	–rup, –rit
suliarinninne¦q	N	–rup, –rit
suliarinnitt¦oq	N	–up, –ut
suliarinnittussarsiuussine¦q	N	–rup, –rit
suliarisa¦q	N	–p, –t
suliariumannittussarsiuine¦q	N	–rup, –rit
suliariumannittussarsiuu¦ppaa	V	–tinngilaa
suliariumannittussarsiuussine¦q	N	–rup, –rit
suliariuminaats¦oq	N	–up, –ut
suliart¦orpoq	V	–unngilaq
suliar¦torpoq	V	{–sunngilaq, –tunngilaq}
suliar¦tortuarpoq	V	{–sortuanngilaq, –tortuanngilaq}
suliartussanngilaq	V	(no generation)
suliassaaru¦ppoq	V	–tinngilaq
suliassanngorti¦ppaa	V	–nngilaa
suliassanngortita¦q	N	–p, –t
suliassanngortitseqqinne¦q	N	–rup, –rit
suliassanngortitsine¦q	N	–rup, –rit
suliassanngortitsissut	N	–ip, –it
suliassa¦q	N	–p, –t
suliassaqarfi¦k	N	–up, –it
suliassaqarpallaarne¦q	N	–rup, –rit
suliassaqa¦rpoq	V	–nngilaq
suliassaqartitaane¦q	N	–rup, –rit
suliassaqartitaas¦oq	N	–up, –ut
suliassaqartitsiniarne¦q	N	–rup, –rit
suliassaqartitsiniut	N	–ip, –it
suliassaqassu¦seq	N	–tsip, –tsit
suliassaqqi¦ppoq	V	–nngilaq
suliassar¦aa	V	–inngilaa
suliasseqqinneqarne¦q	N	–rup, –rit
suliasseqqinneqartarne¦q	N	–rup, –rit
suliassers¦orpaa	V	–unngilaa
suliassersuiffi¦k	N	–up, –it
suliassiis¦oq	N	–up, –ut
suliassiissut	N	–ip, –it
suliassikkuma¦vaa	V	–nngilaa
suliassinneqartart¦oq	N	–up, –ut
suliassi¦ppaa	V	–nngilaa
suliassissutig¦aa	V	–inngilaa
suliffeqanngilaq	V	(no generation)
suliffeqannginne¦q	N	–rup, –rit
suliffeqarfeqarfi¦k	N	–up, –it
suliffeqarfiit	N, pl.	-
suliffeqarfi¦k	N	–up, –it
suliffeqarfissu¦aq	N	–up, –it
suliffeqarfiutil¦ik	N	{–iup, –lip, –lup}, –lit
suliffeqarne¦q	N	–rup, –rit
suliffeqa¦rpoq	V	–nngilaq
suliffeqartitsine¦q	N	–rup, –rit
suliffeqart¦oq	N	–up, –ut
suliffi¦k	N	–up, –it
suliffissaaleqine¦q	N	–rup, –rit
suliffissaaleqis¦oq	N	–up, –ut
suliffissaarunne¦q	N	–rup, –rit
suliffissaarutt¦oq	N	–up, –ut
suliffissaqanngits¦oq	N	–up, –ut
suliffissaqartitsiniut	N	–ip, –it
suliffissarsi¦orpoq	V	–unngilaq
suliffissarsiortarfi¦k	N	–up, –it
suliffissarsiort¦oq	N	–up, –ut
suliffissarsiuussiffi¦k	N	–up, –it
suliffissarsiuussisarfi¦k	N	–up, –it
suliffissarsiuussi¦vik	N	{–ffiup, –viup}, {–ffiit, –viit}
suliffissu¦aq	N	–up, –it
suliffissuaqalerne¦q	N	–rup, –rit
suliffissuaqarfi¦k	N	–up, –it
suliffissuaqarne¦q	N	–rup, –rit
suligajunneru¦voq	V	–nngilaq
suligajuppoq	V	(no generation)
suligasuart¦oq	N	–up, –ut
suliguna¦rpoq	V	–nngilaq
suliinnarallassaaq	V	(no generation)
suliinnartariaqa¦rpoq	V	–nngilaq
sulikatatta¦rpoq	V	–nngilaq
sulikk¦erpoq	V	–inngilaq
sulileqqippoq	V	(no generation)
sulilerlaa¦q	N	–p, –t
sulilerne¦q	N	–rup, –rit
suliler¦sitsineq	N	{–sitsinerup, –titsinerup}, {–sitsinerit, –titsinerit}
sulilerumaarpoq	V	(no generation)
suliliinnarpoq	V	(no generation)
suliliinnarta¦rpoq	V	–nngilaq
suliliinnartarsimavoq	V	(no generation)
sulillatsiarpoq	V	(no generation)
sulillua¦rpoq	V	–nngilaq
sulilluarumaarpoq	V	(no generation)
sulilukkumat¦ooq	N	–uup, –uut
sulilu¦ppoq	V	–nngilaq
sulilussinnaa¦voq	V	–nngilaq
suliluttaannarpoq	V	(no generation)
sulimisaarpoq	V	(no generation)
suline¦q	N	–rup, –rit
sulinerpoq	V	(no generation)
suliniarne¦q	N	–rup, –rit
sulinia¦rpoq	V	–nngilaq
suliniinnaraluarpoq	V	(no generation)
suliniinna¦rpoq	V	–nngilaq
suliniut	N	–ip, –it
suliniuteqaqataas¦oq	N	–up, –ut
suliniuteqarfi¦k	N	–up, –it
suliniuteqarne¦q	N	–rup, –rit
sulinngiffeqarallarfi¦k	N	–up, –it
sulinngiffeqarallarne¦q	N	–rup, –rit
sulinngiffeqarallarsinnaane¦q	N	–rup, –rit
sulinngiffeqarallarsinnaas¦oq	N	–up, –ut
sulinngiffeqarallarsinnaavoq	V	(no generation)
sulinngiffeqarallassaaq	V	(no generation)
sulinngiffeqarfi¦k	N	–up, –it
sulinngiffeqarne¦q	N	–rup, –rit
sulinngiffeqarnersiut	N	–ip, –it
sulinngiffeqa¦rpoq	V	–nngilaq
sulinngiffi¦k	N	–up, –it
sulinngikkallarfi¦k	N	–up, –it
sulinngikkallarne¦q	N	–rup, –rit
sulinngikkallart¦oq	N	–up, –ut
sulinnginne¦q	N	–rup, –rit
sulinngitsoorne¦q	N	–rup, –rit
sulinni¦voq	V	–nngilaq
suliorfig¦aa	V	–inngilaa
suli¦orpoq	V	–unngilaq
sulisart¦oq	N	–up, –ut
sulisartoqarne¦q	N	–rup, –rit
sulisartuinna¦q	N	–ap, –at
sulisartulersaarutit	N, pl.	-
sulisartuune¦q	N	–rup, –rit
sulisinnaajunnaarne¦q	N	–rup, –rit
sulisinnaane¦q	N	–rup, –rit
sulisinnaannginne¦q	N	–rup, –rit
sulisinnaas¦oq	N	–up, –ut
sulisinnaassu¦seq	N	–tsip, –tsit
sulisinnaasut	N, pl.	-
sulisinnaatitaane¦q	N	–rup, –rit
sulisita¦q	N	–p, –t
sulisitaqarumajunnaarne¦q	N	–rup, –rit
sulisitsis¦oq	N	–up, –ut
Sulisitsisut	N, pl.	-
Sulisitsisut	Prop, pl.	-
sulisitsiumajunnaarne¦q	N	–rup, –rit
sulis¦oq	N	–up, –ut
sulisoqarne¦q	N	–rup, –rit
sulisorisat	N, pl.	-
sulissukkuma¦vaa	V	–nngilaa
sulissullua¦rpaa	V	–nngilaa
sulissu¦ppaa	V	–tinngilaa
sulissussine¦q	N	–rup, –rit
sulissuteqarne¦q	N	–rup, –rit
sulissutig¦aa	V	–inngilaa
sulissutiginninne¦q	N	–rup, –rit
sulissutigisassa¦q	N	–p, –t
sulisussaaleqine¦q	N	–rup, –rit
sulisussalersorne¦q	N	–rup, –rit
sulisussarsiortarfi¦k	N	–up, –it
sulisut	N, pl.	-
suliuarti¦ppaa	V	–nngilaa
suliumajunnaarne¦q	N	–rup, –rit
suliumajunnaarnerit	N, pl.	-
suliumajunnaarpoq	V	(no generation)
suliumajunnaarsinnaavoq	V	(no generation)
suliumanngivippoq	V	(no generation)
suliumareerpoq	V	(no generation)
suliumat¦ooq	N	–uup, –uut
suliumatussu¦seq	N	–tsip, –tsit
suliunnaarniarpoq	V	(no generation)
suliunnaa¦rpoq	V	–nngilaq
suliunnaavissaaq	V	(no generation)
sulivallaaginnarpoq	V	(no generation)
sulivallaarnaveersaarpoq	V	(no generation)
sulivallaa¦rpoq	V	–nngilaq
sulivallaaruna¦rpoq	V	–nngilaq
suli¦voq	V	–nngilaq
sullaajaasi¦orpoq	V	–unngilaq
sullaajaa¦siorpoq	V	{–siunngilaq, –tiliunngilaq}
sullaajaat	N	–ip, –it
sullaajaa¦voq	V	–nngilaq
sullaaja¦rpaa	V	–nngilaa
sullanne¦q	N	–rup, –rit
sullannguanngilaq	V	(no generation)
sullanniia¦rpaa	V	–nngilaa
sulla¦ppaa	V	–nngilaa
sulla¦ppoq	V	–nngilaq
sullarne¦q	N	–rup, –rit
sullarniia¦rpaa	V	–nngilaa
sulla¦rpaa	V	–nngilaa
sulla¦rpoq	V	–nngilaq
sullart¦oq	N	–up, –ut
sullatsaalisaa¦voq	V	–nngilaq
sullatsaali¦vaa	V	–nngilaa
sulleri¦ppoq	V	–nngilaq
sullerissi¦voq	V	–nngilaq
sullerissuu¦voq	V	–nngilaq
sulleri¦ssuuvoq	V	{–ssuunngilaq, –ttuunngilaq}
sul¦lerluppoq	V	–inerlunngilaq
sullikkuma¦vaa	V	–nngilaa
sullineeru¦ppoq	V	–tinngilaq
sulline¦q	N	–rup, –rit
sull¦ineq	N	–ernup, –ernit
sullinersi¦orpoq	V	–unngilaq
sullinertuumasut	N, pl.	-
sullinneqarne¦q	N	–rup, –rit
sulli¦ppaa	V	–sinngilaa
sulli¦ppoq	V	–nngilaq
sullisaa¦voq	V	–nngilaq
sullis¦erpoq	V	–inngilaq
sullisig¦aa	V	–inngilaa
sulli¦sigaa	V	–tiginngilaa
sullisima¦voq	V	–nngilaq
sullis¦imavoq	V	–simanngilaq
sullisissa¦q	N	–p, –t
sullisit	N, pl.	-
sullissa¦q	N	–p, –t
sullissine¦q	N	–rup, –rit
sullissis¦oq	N	–up, –ut
sullissiumat¦ooq	N	–uup, –uut
sullissi¦vik	N	{–ffiup, –viup}, {–ffiit, –viit}
sullissi¦voq	V	–nngilaq
sulli¦t	N	–sip, –sit
sullita¦q	N	–p, –t
sulli¦vaa	V	–nngilaa
sullivig¦aa	V	–inngilaa
sullivi¦k	N	–up, –it
sullivinnaa¦q	N	–p, –t
sullivissaaru¦ppoq	V	–tinngilaq
sulli¦voq	V	–nngilaq
sull¦oq	N	–up, –ut
sulloqqu¦ppaa	V	–tinngilaa
sulloqus¦erpaa	V	–inngilaa
sulloqu¦serpaa	V	{–sinngilaa, –tilinngilaa}
sulloqut	N	–ip, –it
sulloqutaaja¦rpaa	V	–nngilaa
sulloqutaa¦rpaa	V	–nngilaa
sulloquteqarsima¦voq	V	–nngilaq
sullorsa¦q	N	–p, –t
sullorsa¦rpoq	V	–nngilaq
sullorsartu¦voq	V	–nngilaq
Sullorsu¦aq	N	–up, –it
sullort¦ooq	N	–uup, –uut
sullortu¦voq	V	–nngilaq
Sullualu¦k	N	–up, –it
Sullualu¦k	Prop	–up, –it
sullua¦raq	N	–qqap, –qqat
sulluarne¦q	N	–rup, –rit
sullua¦rpaa	V	–nngilaa
sullua¦rpoq	V	–nngilaq
sulluartaassu¦aq	N	–up, –it
sulluartaat	N	–ip, –it
sullug¦aa	V	–inngilaa
sullugisa¦q	N	–p, –t
sulluits¦oq	N	–up, –ut
sulluitsulia¦rpoq	V	–nngilaq
sullukilleriarne¦q	N	–rup, –rit
sullukilleriarsimas¦oq	N	–up, –ut
sullukilli¦voq	V	–nngilaq
sullukinneru¦voq	V	–nngilaq
sullukippallaa¦rpoq	V	–nngilaq
sulluki¦ppoq	V	–nngilaq
sullulia¦q	N	–p, –t
sullul¦ik	N	{–iup, –lip, –lup}, –lit
sullulilia¦q	N	–p, –t
sullulili¦aq	N	–ssap, –ssat
sulluliorne¦q	N	–rup, –rit
sullulissu¦aq	N	–up, –it
sullul¦issuaq	N	{–ersuup, –issuup}, {–ersuit, –issuit}
sullunanngits¦oq	N	–up, –ut
sullunaqaaq	V	(no generation)
sulluna¦rpoq	V	–nngilaq
sulluni¦ppoq	V	–nngilaq
sullunngulaa¦rpoq	V	–nngilaq
sullunngusaannarpoq	V	(no generation)
sullunngutitsi¦voq	V	–nngilaq
sullunngu¦voq	V	–nngilaq
sullusi¦voq	V	–nngilaq
sullussera¦rpoq	V	–nngilaq
sulluss¦erpoq	V	–inngilaq
sulluulane¦q	N	–rup, –rit
sulluulasuinnaa¦voq	V	–nngilaq
sulluula¦voq	V	–nngilaq
suloorajuppoq	V	(no generation)
sul¦oorpoq	V	–uunngilaq
suloqqat	N, pl.	-
suloqqiu¦ppaa	V	–tinngilaa
suloqqi¦voq	V	–nngilaq
suloral¦ik	N	{–iup, –lip, –lup}, –lit
sulo¦raq	N	–qqap, –qqat
sulorarne¦q	N	–rup, –rit
sulorartart¦oq	N	–up, –ut
sulugissa¦rpoq	V	–nngilaq
sulugi¦ssarpoq	V	–ttanngilaq
sulugissartuinnaa¦voq	V	–nngilaq
sulugi¦ssartuinnaavoq	V	{–ssartuinnaanngilaq, –ttartuinnaanngilaq}
sulu¦k	N	–up, –it
sulul¦ik	N	{–iup, –lip, –lup}, –lit
sululissu¦aq	N	–up, –it
sulul¦issuaq	N	{–ersuup, –issuup}, {–ersuit, –issuit}
sulullu¦ppoq	V	–nngilaq
suluni¦ppoq	V	–nngilaq
suluppaagaa¦raq	N	–qqap, –qqat
suluppaagaasanngu¦aq	N	–up, –it
suluppaa¦gaq	N	–kkap, –kkat
suluppaagarsiut	N	–ip, –it
suluppaagar¦torpoq	V	{–sunngilaq, –tunngilaq}
suluppaavaa¦raq	N	–qqap, –qqat
suluppaava¦q	N	–p, –t
suluppaavarsiut	N	–ip, –it
suluppalu¦k	N	–up, –it
suluppi	N	–p, –t
sulussugut	N	–ip, –it
sulussugutigiss¦oq	N	–up, –ut
sulussugutigi¦ssoq	N	{–ssup, –ttup}, {–ssut, –ttut}
sulussugutil¦ik	N	{–iup, –lip, –lup}, –lit
sulussugutilutt¦oq	N	–up, –ut
suluttal¦ik	N	{–iup, –lip, –lup}, –lit
sulutt¦ooq	N	–uup, –uut
suluunnaliu¦gaq	N	–kkap, –kkat
suluunna¦q	N	–p, –t
suluusa¦q	N	–p, –t
sumiginnaane¦q	N	–rup, –rit
sumiginnaa¦voq	V	–nngilaq
sumiginna¦gaq	N	–kkap, –kkat
sumiginna¦rpaa	V	–nngilaa
sumiiffeeru¦ppoq	V	–tinngilaq
sumiiffigili¦gaq	N	–kkap, –kkat
sumiiffi¦k	N	–up, –it
sumiiffilersuine¦q	N	–rup, –rit
sumiiffilerut	N	–ip, –it
sumiiffissiine¦q	N	–rup, –rit
sumiiffissiut	N	–ip, –it
sumiikkallarsinnaane¦q	N	–rup, –rit
sumii¦ppoq	V	–nngilaq
sumiissu¦seq	N	–tsip, –tsit
sumi¦issuseq	N	{–issutsip, –nngaanniissutsip}, {–issutsit, –nngaanniissutsit}
sumiissusersi¦orpoq	V	–unngilaq
sumi¦issusersiorpoq	V	{–issusersiunngilaq, –nngaanniissusersiunngilaq}
sumiissusersiut	N	–ip, –it
sumi¦issusersiut	N	{–issusersiutip, –nngaanniissusersiutip}, {–issusersiutit, –nngaanniissusersiutit}
sumiorpaluut	N	–ip, –it
sumiorpaluutit	N, pl.	-
sumitsakiaq	Interj	(no generation)
summiffig¦aa	V	–inngilaa
summippalu¦ppoq	V	–nngilaq
summi¦ppoq	V	–nngilaq
sumunna¦rpoq	V	–nngilaq
su¦na	Pron	–up, –ut
sunaaffa	Interj	(no generation)
sunaaffaana	Interj	(no generation)
sunaa¦voq	V	–nngilaq
sunalikiaq	Interj	(no generation)
su¦naluunniit	Pron	–ulluunniit, –ulluunniit
sunam¦erpaa	V	–inngilaa
sun¦erpoq	V	–inngilaq
sungaaq¦eq	N	–ip, –it
sungaaqivi¦k	N	–up, –it
sungaaqqi¦k	N	–up, –it
sungaaqqi¦ppoq	V	–nngilaq
sungaa¦rpoq	V	–nngilaq
sungaartinne¦q	N	–rup, –rit
sungaart¦oq	N	–up, –ut
sungaartorsu¦aq	N	–up, –it
sungaartua¦raq	N	–qqap, –qqat
sungaartuaratsia¦q	N	–ap, –at
sungaassaa¦rpoq	V	–nngilaq
sungarnialaa¦rpoq	V	–nngilaq
sungarni¦ppoq	V	–nngilaq
sungarnits¦oq	N	–up, –ut
sungarnitsussat	N, pl.	-
sungarpallanne¦q	N	–rup, –rit
sungarpallannersu¦aq	N	–up, –it
sungarpalla¦ppoq	V	–nngilaq
sungarpalualaa¦rpoq	V	–nngilaq
sungarpalu¦ppoq	V	–nngilaq
sungarpalutsippoq	V	(no generation)
sungarpalutt¦oq	N	–up, –ut
sung¦erpoq	V	–inngilaq
sungersart¦orpaa	V	–unngilaa
sungersuut	N	–ip, –it
sunger¦suut	N	{–suutip, –tuutip}, {–suutit, –tuutit}
sungersuutaa¦voq	V	–nngilaq
sunger¦suutaavoq	V	{–suutaanngilaq, –tuutaanngilaq}
sungersuutig¦aa	V	–inngilaa
sunger¦suutigaa	V	{–suutiginngilaa, –tuutiginngilaa}
sungillisaars¦erpoq	V	–inngilaq
sungiukkiart¦orpaa	V	–unngilaa
sungiu¦ppaa	V	–tinngilaa
sungiusaasartoqatigiit	N, pl.	-
sungiusaasi¦orpoq	V	–unngilaq
sungiusaa¦siorpoq	V	{–siunngilaq, –tiliunngilaq}
sungiusaas¦oq	N	–up, –ut
sungiusaat	N	–ip, –it
sungiusaatig¦aa	V	–inngilaa
sungiusaatissa¦q	N	–p, –t
sungiusaatit	N, pl.	-
sungiusaa¦voq	V	–nngilaq
sungiusagaane¦q	N	–rup, –rit
sungiusa¦gaq	N	–kkap, –kkat
sungiusajuippoq	V	(no generation)
sungiusakatatta¦rpoq	V	–nngilaq
sungiusalereeraluarpoq	V	(no generation)
sungiusalerfi¦k	N	–up, –it
sungiusaqqinne¦q	N	–rup, –rit
sungiusaqqi¦ppaa	V	–nngilaa
sungiusarfi¦k	N	–up, –it
sungiusarluarsima¦voq	V	–nngilaq
sungiusarne¦q	N	–rup, –rit
sungiusa¦rpaa	V	–nngilaa
sungiusa¦rpoq	V	–nngilaq
sungiusartuaanna¦rpoq	V	–nngilaq
sungiusarunnaarallarpoq	V	(no generation)
sungiusarunnaa¦rpoq	V	–nngilaq
sungiusimanngilaa	V	(no generation)
sungiusima¦vaa	V	–nngilaa
sungiussa¦q	N	–p, –t
sungiussilluarsimas¦oq	N	–up, –ut
sungiussine¦q	N	–rup, –rit
sungiussiniarne¦q	N	–rup, –rit
sungiussisimane¦q	N	–rup, –rit
sungiussisimas¦oq	N	–up, –ut
sungiussititsiniarne¦q	N	–rup, –rit
sungiussi¦voq	V	–nngilaq
sungiutaa¦voq	V	–nngilaq
sungiutissaanngilaq	V	(no generation)
sungorsiusa¦q	N	–p, –t
sunianngits¦oq	N	–up, –ut
suniu¦ppaa	V	–tinngilaa
sunneeqataane¦q	N	–rup, –rit
sunneeqataasinnaane¦q	N	–rup, –rit
sunneeqatigiinne¦q	N	–rup, –rit
sunneqatigiinne¦q	N	–rup, –rit
sunnerneqarsimas¦oq	N	–up, –ut
sunnerneqarsinnaanngits¦oq	N	–up, –ut
sunnerneqart¦oq	N	–up, –ut
sunn¦erpaa	V	–inngilaa
sunnersimaannarpaa	V	(no generation)
sunnersimaneqa¦rpoq	V	–nngilaq
sunnersinnaanngilaa	V	(no generation)
sunnertias¦oq	N	–up, –ut
sunner¦tippoq	V	{–sinngilaq, –tinngilaq}
sunngiffeqarne¦q	N	–rup, –rit
sunngiffi¦k	N	–up, –it
sunngilaa	V	(no generation)
sunngilaq	V	(no generation)
sunngitsoorpoq	V	(no generation)
sunngorne¦q	N	–rup, –rit
sunng¦orpoq	V	–unngilaq
sunngortikkiart¦orpoq	V	–unngilaq
sunngortuinnaa¦voq	V	–nngilaq
sunngu¦aq	N	–up, –it
sunnguaqanngilaq	V	(no generation)
sunnigaane¦q	N	–rup, –rit
sunnigaa¦voq	V	–nngilaq
sunni¦gaq	N	–kkap, –kkat
sunniillua¦rpoq	V	–nngilaq
sunniilluart¦oq	N	–up, –ut
sunniine¦q	N	–rup, –rit
sunniiniarne¦q	N	–rup, –rit
sunniinia¦rpoq	V	–nngilaq
sunniiniut	N	–ip, –it
sunniiniutit	N, pl.	-
sunniipilunne¦q	N	–rup, –rit
sunniisima¦voq	V	–nngilaq
sunniisinnaaneerut¦sitsiniarneq	N	{–itsiniarnerup, –sitsiniarnerup}, {–itsiniarnerit, –sitsiniarnerit}
sunniisinnaas¦oq	N	–up, –ut
sunniisinnaa¦voq	V	–nngilaq
sunniivig¦aa	V	–inngilaa
sunnii¦vigaa	V	{–ffiginngilaa, –viginngilaa}
sunniivigeqatigiinne¦q	N	–rup, –rit
sunnii¦vigeqatigiinneq	N	{–ffigeqatigiinnerup, –vigeqatigiinnerup}, {–ffigeqatigiinnerit, –vigeqatigiinnerit}
sunniivigeqatigii¦ttarneq	N	{–ssarnerup, –ttarnerup}, {–ssarnerit, –ttarnerit}
sunnii¦vigeqatigiittarneq	N	{–ffigeqatigiissarnerup, –ffigeqatigiittarnerup, –vigeqatigiissarnerup, –vigeqatigiittarnerup}, {–ffigeqatigiissarnerit, –ffigeqatigiittarnerit, –vigeqatigiissarnerit, –vigeqatigiittarnerit}
sunnii¦voq	V	–nngilaq
sunniukkiart¦orpoq	V	–unngilaq
sunniulluarsimas¦oq	N	–up, –ut
sunniulluinna¦rpoq	V	–nngilaq
sunniullu¦innarpoq	V	{–aannanngilaq, –innanngilaq}
sunniu¦ppoq	V	–tinngilaq
sunniut	N	–ip, –it
sunniutaarunne¦q	N	–rup, –rit
sunniuteqalersinnaa¦voq	V	–nngilaq
sunniuteqanngits¦oq	N	–up, –ut
sunniuteqarfig¦aa	V	–inngilaa
sunniuteqarlua¦rpoq	V	–nngilaq
sunniuteqarluart¦oq	N	–up, –ut
sunniuteqarne¦q	N	–rup, –rit
sunniuteqarsinnaane¦q	N	–rup, –rit
sunniuteqarsinnaas¦oq	N	–up, –ut
sunniutil¦erpoq	V	–inngilaq
sunniu¦tilerpoq	V	{–sinngilaq, –tilinngilaq}
sunniutinngitsoorpoq	V	(no generation)
sunoors¦erpoq	V	–inngilaq
sunoorsill¦erpoq	V	–inngilaq
sunoorsillertaannarpoq	V	(no generation)
sunoorsisa¦rpoq	V	–nngilaq
sunoorsisuuma¦voq	V	–nngilaq
sunoorsit	N, pl.	-
sunoorsivi¦k	N	–up, –it
sunoorsivittaa¦rpoq	V	–nngilaq
sunoorsi¦voq	V	–nngilaq
supi	N	–p, –t
supiff¦eerpoq	V	–iinngilaq
supikkiart¦orpoq	V	–unngilaq
supilersinnarmi¦oq	N	–up, –ut
supina¦rpoq	V	–nngilaq
supine¦q	N	–rup, –rit
supinga¦voq	V	–nngilaq
supinil¦ik	N	{–iup, –lip, –lup}, –lit
supi¦ppaa	V	–nngilaa
supi¦ppoq	V	–nngilaq
supisa¦q	N	–p, –t
supisarfi¦k	N	–up, –it
supisoorne¦q	N	–rup, –rit
supis¦oorpoq	V	–uunngilaq
supissaas¦erpaa	V	–inngilaa
supissaa¦serpaa	V	{–sinngilaa, –tilinngilaa}
supi¦ssaaserpaa	V	{–ssaasinngilaa, –ssaatilinngilaa, –ttaasinngilaa, –ttaatilinngilaa}
supissaat	N	–ip, –it
supi¦ssaat	N	{–ssaatip, –ttaatip}, {–ssaatit, –ttaatit}
supi¦vaa	V	–nngilaa
supi¦voq	V	–nngilaq
sup¦oorpaa	V	–uunngilaa
supoort¦oq	N	–up, –ut
supoortuarpaa	V	(no generation)
supoorussu¦aq	N	–up, –it
supoorut	N	–ip, –it
supoorutaa¦voq	V	–nngilaq
suppa	N	–p, –t
suppali¦orpoq	V	–unngilaq
suppa¦torpoq	V	{–sunngilaq, –tunngilaq}
supp¦eerpoq	V	–iinngilaq
su¦ppoq	V	–nngilaq
suppori¦ppoq	V	–nngilaq
supporissi¦voq	V	–nngilaq
supporlukkunnaa¦rpoq	V	–nngilaq
supporlu¦ppoq	V	–nngilaq
supporluttunng¦orpoq	V	–unngilaq
suppu¦ppaa	V	–tinngilaa
suppusi¦orpoq	V	–unngilaq
suppu¦siorpoq	V	{–siunngilaq, –tiliunngilaq}
suppussaa¦voq	V	–nngilaq
suppussa¦q	N	–p, –t
suppussi¦voq	V	–nngilaq
supput	N	–ip, –it
supputaaru¦ppoq	V	–tinngilaq
supputaasa¦q	N	–p, –t
supputaasa¦rpoq	V	–nngilaq
supputilu¦ppoq	V	–nngilaq
supu¦voq	V	–nngilaq
susaanngisaanna¦rpoq	V	–nngilaq
susaarajuppoq	V	(no generation)
susaa¦rpoq	V	–nngilaq
susaartitsine¦q	N	–rup, –rit
susaats¦oq	N	–up, –ut
susaa¦voq	V	–nngilaq
susal¦ik	N	{–iup, –lip, –lup}, –lit
susa¦q	N	–p, –t
susaqanngits¦oq	N	–up, –ut
susaqa¦rpoq	V	–nngilaq
susassal¦ik	N	{–iup, –lip, –lup}, –lit
susassaqanngilaq	V	(no generation)
susassaqanngits¦oq	N	–up, –ut
susassaqarfi¦k	N	–up, –it
susassaqartitaaffi¦k	N	–up, –it
susassaqart¦oq	N	–up, –ut
susassareqatigiit	N, pl.	-
susassarinngilaa	V	(no generation)
susassarinngisa¦q	N	–p, –t
susiniut	N	–ip, –it
susiniutig¦aa	V	–inngilaa
susinnaanngilaq	V	(no generation)
susinnaanngits¦oq	N	–up, –ut
susiutig¦aa	V	–inngilaa
susi¦voq	V	–nngilaq
sus¦oq	N	–up, –ut
susorsu¦uvoq	V	{–aanngilaq, –unngilaq}
sussa	Interj	(no generation)
sussaajunnaa¦rpoq	V	–nngilaq
sussaanngilaq	V	(no generation)
sussaaru¦ppoq	V	–tinngilaq
sussaa¦voq	V	–nngilaq
sussakasi¦ppoq	V	–nngilaq
sussakk¦eerpaa	V	–iinngilaa
sussamaa¦rpaa	V	–nngilaa
sussa¦q	N	–p, –t
sussar¦aa	V	–inngilaa
sussarinerpaa	V	(no generation)
sussarinngilaa	V	(no generation)
sussas¦oorpoq	V	–uunngilaq
sussas¦oq	N	–up, –ut
suss¦orpoq	V	–unngilaq
sussuteqanngits¦oq	N	–up, –ut
susunneqanngilaq	V	(no generation)
susunneqanngissu¦seq	N	–tsip, –tsit
susunneqanngits¦oq	N	–up, –ut
susunninngilaq	V	(no generation)
susunni¦ppoq	V	–nngilaq
sutaar¦aa	V	–inngilaa
sutanngueru¦ppoq	V	–tinngilaq
suteraats¦oq	N	–up, –ut
sutornia¦rpoq	V	–nngilaq
sutorniartarfi¦k	N	–up, –it
sutorniartarfiutil¦ik	N	{–iup, –lip, –lup}, –lit
sut¦orpoq	V	–unngilaq
sutorujoorne¦q	N	–rup, –rit
sutsiaa¦rpoq	V	–nngilaq
sutsiaarunnaa¦rpoq	V	–nngilaq
sutuu¦ppoq	V	–tinngilaq
suu	Interj	(no generation)
suuallaanngilaq	V	(no generation)
suuanngilaq	V	(no generation)
suuanngissu¦seq	N	–tsip, –tsit
suua¦rpoq	V	–nngilaq
suuarunnaa¦rpoq	V	–nngilaq
suugaars¦erpoq	V	–inngilaq
suugaaru¦ppoq	V	–tinngilaq
suu¦gaq	N	–kkap, –kkat
suugarmi¦ppaa	V	–nngilaa
suugassa¦q	N	–p, –t
suugassia¦q	N	–p, –t
suujunnaarluinnarpoq	V	(no generation)
suujunnaar¦sippaa	V	{–sinngilaa, –tinngilaa}
su¦ujunnaarsippaa	V	{–naajunnaarsinngilaa, –naajunnaartinngilaa, –ujunnaarsinngilaa, –ujunnaartinngilaa}
suujunnaar¦sitaaneq	N	{–sitaanerup, –titaanerup}, {–sitaanerit, –titaanerit}
su¦ujunnaarsitaaneq	N	{–naajunnaarsitaanerit, –naajunnaartitaanerit, –ujunnaarsitaanerit, –ujunnaartitaanerit}
suujunnaar¦sitsineq	N	{–sitsinerup, –titsinerup}, {–sitsinerit, –titsinerit}
su¦ujunnaarsitsineq	N	{–naajunnaarsitsinerit, –naajunnaartitsinerit, –ujunnaarsitsinerit, –ujunnaartitsinerit}
suuki	Interj	(no generation)
suukia	Interj	(no generation)
suukiartassa	Interj	(no generation)
suukk¦erpaa	V	–inngilaa
suukkiu¦ppaa	V	–tinngilaa
suulluanngilaq	V	(no generation)
suulluanngits¦oq	N	–up, –ut
su¦ulluanngitsoq	N	{–naalluanngitsut, –ulluanngitsut}
suulluanngitsut	N, pl.	-
suulluunniit	Pron, pl.	-
suummiu¦ppaa	V	–tinngilaa
suunngilaq	V	(no generation)
suunngissu¦seq	N	–tsip, –tsit
su¦unngissuseq	N	{–naanngissutsit, –unngissutsit}
suunngits¦oq	N	–up, –ut
su¦unngitsoq	N	{–naanngitsut, –unngitsut}
suunngitsuunngilaq	V	(no generation)
suunngitsuu¦voq	V	–nngilaq
su¦unngitsuuvoq	V	{–naanngitsuunngilaq, –unngitsuunngilaq}
suussu¦seq	N	–tsip, –tsit
su¦ussuseq	N	{–naassutsit, –ussutsit}
suussu¦serpaa	V	{–sinngilaa, –tilinngilaa}
suussu¦serpaa	V	–tilinngilaa
su¦ussuserpaa	V	{–naassusinngilaa, –naassutilinngilaa, –ussusinngilaa, –ussutilinngilaa}
suussu¦sersiineq	N	{–sersiinerup, –tilersiinerup}, {–sersiinerit, –tilersiinerit}
su¦ussusersiineq	N	{–naassusersiinerit, –naassutilersiinerit, –ussusersiinerit, –ussutilersiinerit}
suussusersiorneqart¦oq	N	–up, –ut
su¦ussusersiorneqartoq	N	{–naassusersiorneqartut, –ussusersiorneqartut}
suussusersiut	N	–ip, –it
su¦ussusersiut	N	{–naassusersiutit, –ussusersiutit}
suusupag¦aa	V	–inngilaa
suusupagineqarne¦q	N	–rup, –rit
suusupaginninne¦q	N	–rup, –rit
suusupagisa¦q	N	–p, –t
suusupig¦aa	V	–inngilaa
suut	N	–ip, –it
suut	Pron, pl.	-
suutaaru¦ppaa	V	–tinngilaa
suutat	N, pl.	-
suutinngilaa	V	(no generation)
suuti¦ppaa	V	–nngilaa
su¦utippaa	V	{–naatinngilaa, –utinngilaa}
suu¦voq	V	–nngilaq
suvoq	V	(no generation)
svensk¦eq	N	–ip, –it
svenski¦t	N, pl.	{–it, –t}
Sydafrikam¦eersoq	N	{–eersup, –eertup, –inngaanneersup, –inngaanneertup, –inngaanninngaanneersup, –inngaanninngaanneertup}, {–eersut, –eertut, –inngaanneersut, –inngaanneertut, –inngaanninngaanneersut, –inngaanninngaanneertut}
Sydafrika¦miu	N	{–miup, –rmiup}, {–miut, –rmiut}
Sydamerika¦miu	N	{–miup, –rmiup}, {–miut, –rmiut}
Syriam¦eersoq	N	{–eersup, –eertup, –inngaanneersup, –inngaanneertup, –inngaanninngaanneersup, –inngaanninngaanneertup}, {–eersut, –eertut, –inngaanneersut, –inngaanneertut, –inngaanninngaanneersut, –inngaanninngaanneertut}
Syriam¦eersoq	N	{–eersup, –eertup, –inngaanneersup, –inngaanneertup}, {–eersut, –eertut, –inngaanneersut, –inngaanneertut}
Syriamioq	N	(no generation)
