Lexeme	WC	Flexion
K-vitamini	N	–p, –t
kaaffarippoq	V	(no generation)
kaaffarissaarpoq	V	(no generation)
kaaffarissorsivoq	V	(no generation)
kaaffarluppoq	V	(no generation)
kaaffaserpoq	V	(no generation)
kaaffi¦k	N	–up, –it
kaaffissa¦q	N	–p, –t
kaaffissu¦aq	N	–up, –it
kaag¦eeraliaq	N	{–eeraliap, –iaraliap}, {–eeraliat, –iaraliat}
kaag¦eeraq	N	{–eeqqap, –iaqqap}, {–eeqqat, –iaqqat}
kaagi	N	–p, –t
kaagilia¦q	N	–p, –t
kaagiliassa¦q	N	–p, –t
kaagiliorfi¦k	N	–up, –it
kaagiliorpoq	V	(no generation)
kaagiliukatannerarpoq	V	(no generation)
kaagilivi¦k	N	–up, –it
kaagillerpoq	V	(no generation)
kaagisorpoq	V	(no generation)
kaaguppaa	V	(no generation)
kaagussa¦q	N	–p, –t
kaajaa¦q	N	–p, –t
kaajaarmippaa	V	(no generation)
kaajallaane¦q	N	–rup, –rit
kaajallaannarpoq	V	(no generation)
kaajallaappoq	V	(no generation)
kaajallaasita¦q	N	–p, –t
kaajallaasitat	N, pl.	-
kaajallaatsippaa	V	(no generation)
kaajallaavoq	V	(no generation)
kaajalla¦k	N	–ap, –at
kaajallakkaluallarpoq	V	(no generation)
kaajallakkiartuaart¦oq	N	–up, –ut
kaajallaliorfi¦k	N	–up, –it
kaajallanne¦q	N	–rup, –rit
kaajallappaa	V	(no generation)
kaajallappoq	V	(no generation)
kaajallatsippaa	V	(no generation)
kaajallatsitsine¦q	N	–rup, –rit
kaajallat¦sitsineq	N	{–sitsinerup, –itsinerup}, {–sitsinerit, –itsinerit}
kaajallattarpoq	V	(no generation)
kaajallatt¦oq	N	–up, –ut
kaajaluine¦q	N	–rup, –rit
kaajaluinne¦q	N	–rup, –rit
kaajaluippoq	V	(no generation)
kaajaluisal¦ik	N	{–iup, –lip, –lup}, –lit
kaajaluisa¦q	N	–p, –t
kaajaluits¦oq	N	–up, –ut
kaajalui¦tsoq	N	{–ssup, –tsup, –ttup}, {–ssut, –tsut, –ttut}
kaajaluivaa	V	(no generation)
kaajaluivoq	V	(no generation)
kaajalukaarne¦q	N	–rup, –rit
kaajalukaarpoq	V	(no generation)
kaajalukaartippaa	V	(no generation)
kaajalukaart¦oq	N	–up, –ut
kaajarna¦q	N	–p, –t
kaa¦k	N	–ap, –vit
kaakkippaa	V	(no generation)
kaakkivaa	V	(no generation)
kaakkunnaarpoq	V	(no generation)
kaakkuppaa	V	(no generation)
kaakkussa¦q	N	–p, –t
kaakkussivoq	V	(no generation)
kaalerpoq	V	(no generation)
kaalersoorpoq	V	(no generation)
kaamikkiartorpaa	V	(no generation)
kaamippaa	V	(no generation)
kaamisaasiorpoq	V	(no generation)
kaamisaat	N	–ip, –it
kaamisaatigaa	V	(no generation)
kaamisaavoq	V	(no generation)
kaamisarpaa	V	(no generation)
kaamisarti¦ppoq	V	–nngilaq
kaamitsivoq	V	(no generation)
kaamittari¦aq	N	{–ssap, –ap}, {–ssat, –at}
kaamittari¦aq	N	–ssap, –ssat
kaammappaa	V	(no generation)
kaammaqquserpaa	V	(no generation)
kaammaqqut	N	–ip, –it
kaammattoqatigiinne¦q	N	–rup, –rit
kaammattorpaa	V	(no generation)
kaammattu¦gaq	N	–kkap, –kkat
kaammattuine¦q	N	–rup, –rit
kaammattuisaannarpoq	V	(no generation)
kaammattuivoq	V	(no generation)
kaammattuut	N	–ip, –it
kaammattuutiginart¦oq	N	–up, –ut
kaamuumine¦q	N	–rup, –rit
kaamuumisaarpoq	V	(no generation)
kaamuumivoq	V	(no generation)
kaangaarpoq	V	(no generation)
kaangaart¦oq	N	–up, –ut
kaangalasuinnaavoq	V	(no generation)
kaangalavoq	V	(no generation)
kaangallappoq	V	(no generation)
kaannarpoq	V	(no generation)
kaannarsivoq	V	(no generation)
kaannartueruppoq	V	(no generation)
kaannarunnaarpoq	V	(no generation)
kaanne¦q	N	–rup, –rit
kaanneqart¦oq	N	–up, –ut
kaannersu¦aq	N	–up, –it
kaannerujussu¦aq	N	–up, –it
kaanngalavoq	V	(no generation)
kaanngarpoq	V	(no generation)
kaanngartikkuminaappoq	V	(no generation)
kaanngartikkuminarpoq	V	(no generation)
kaanngartippaa	V	(no generation)
kaanngartitsine¦q	N	–rup, –rit
kaanngart¦oq	N	–up, –ut
kaapajaarpoq	V	(no generation)
kaapajaartippaa	V	(no generation)
kaapajaartitaas¦oq	N	–up, –ut
kaapajaart¦oq	N	–up, –ut
kaaperaarpoq	V	(no generation)
kaaperaart¦oq	N	–up, –ut
kaappaa	V	(no generation)
kaappatsappoq	V	(no generation)
kaappatsassimas¦oq	N	–up, –ut
kaappoq	V	(no generation)
kaaqqippaa	V	(no generation)
kaaqquarpaa	V	(no generation)
kaariarne¦q	N	–rup, –rit
kaa¦riarneq	N	{–periarnerup, –riarnerup}, {–periarnerit, –riarnerit}
kaasarerpalutt¦oq	N	–up, –ut
kaasarfi¦k	N	–up, –it
kaasarfil¦ik	N	{–iup, –lip, –lup}, –lit
kaasarfimmiorisarta¦gaq	N	–kkap, –kkat
kaasarfimmiu	N	–p, –t
kaasarfimmiugaa	V	(no generation)
kaasarfimmiuliuppaa	V	(no generation)
kaasarfimmiut	N, pl.	-
kaasarfissi¦ooq	N	–uup, –uut
kaasarfissiorpoq	V	(no generation)
kaasarfissorpaa	V	(no generation)
kaasarfissorpoq	V	(no generation)
kaasaria¦q	N	–p, –t
kaasari¦aq	N	{–ap, –ssap}, {–at, –ssat}
kaasariuvoq	V	(no generation)
kaasimaaginnart¦oq	N	–up, –ut
kaasimaarajuppoq	V	(no generation)
kaasimaarfiit	N, pl.	-
kaas¦imaarfiit	N, pl.	{–imaarfiit, –simaarfiit}
kaasimaarfi¦k	N	–up, –it
kaas¦imaarfik	N	{–imaarfiup, –simaarfiup}, {–imaarfiit, –simaarfiit}
kaasimaarpoq	V	(no generation)
kaasimaartuarpoq	V	(no generation)
kaasivoq	V	(no generation)
kaasoorpaa	V	(no generation)
kaasoorpoq	V	(no generation)
kaassaa¦q	N	–p, –t
kaassaarpoq	V	(no generation)
kaassaarsu¦aq	N	–up, –it
kaassa¦k	N	–ap, –at
kaassalerpaa	V	(no generation)
kaassalisaarpoq	V	(no generation)
kaassalivoq	V	(no generation)
kaassa¦q	N	–p, –t
kaasserpaa	V	(no generation)
kaassivi¦k	N	–up, –it
kaassivissa¦q	N	–p, –t
kaassivoq	V	(no generation)
kaassorfigaa	V	(no generation)
kaassorpoq	V	(no generation)
kaassuaat	N	–ip, –it
kaassuarpaa	V	(no generation)
kaassuarpoq	V	(no generation)
kaassuinna¦q	N	–ap, –at
kaassuppaa	V	(no generation)
kaassuttorujussuuvoq	V	(no generation)
kaataa¦raq	N	–qqap, –qqat
kaata¦q	N	–p, –t
kaat¦aq	N	{–ap, –tap}, {–at, –tat}
kaatarsu¦aq	N	–up, –it
kaatippaa	V	(no generation)
kaatita¦q	N	–p, –t
kaat¦itaq	N	{–itap, –sitap}, {–itat, –sitat}
kaatitsivoq	V	(no generation)
kaatorpaa	V	(no generation)
kaatorpoq	V	(no generation)
kaatsiorpoq	V	(no generation)
kaatsippaa	V	(no generation)
kaatsivoq	V	(no generation)
kaattaanne¦q	N	–rup, –rit
kaattaappaa	V	(no generation)
kaattaassine¦q	N	–rup, –rit
kaattaat	N	–ip, –it
kaattaat	N, pl.	-
kaattaraluaqaaq	V	(no generation)
kaattari¦aq	N	{–ssap, –ap}, {–ssat, –at}
kaattari¦aq	N	–ssap, –ssat
kaattarne¦q	N	–rup, –rit
kaattarpaa	V	(no generation)
kaattarpoq	V	(no generation)
kaatt¦oq	N	–up, –ut
kaattorpaa	V	(no generation)
kaattorpoq	V	(no generation)
kaattorsu¦aq	N	–up, –it
kaattorujussu¦aq	N	–up, –it
kaattuaannart¦oq	N	–up, –ut
kaattuine¦q	N	–rup, –rit
kaattuivoq	V	(no generation)
kaattungiaasa¦q	N	–p, –t
kaattungi¦aq	N	–ssap, –ssat
kaatuarpaa	V	(no generation)
kaatuarpoq	V	(no generation)
kaatuiumanngilaq	V	(no generation)
kaatuivoq	V	(no generation)
kaavaa	V	(no generation)
kaavaasarpoq	V	(no generation)
kaavaavi¦k	N	–up, –it
kaavaavoq	V	(no generation)
kaavalane¦q	N	–rup, –rit
kaavarpaa	V	(no generation)
kaavarpoq	V	(no generation)
kaavarsi¦t	N	–sip, –sit
kaavarsivi¦k	N	–up, –it
kaavarsivoq	V	(no generation)
kaavarta¦q	N	–p, –t
kaav¦eq	N	–ip, –it
kaavequt	N	–ip, –it
kaavequt	N, pl.	-
kaavequteqarfi¦k	N	–up, –it
kaavequtil¦ik	N	{–iup, –lip, –lup}, –lit
kaaveri¦aq	N	–ssap, –ssat
kaaverissiort¦oq	N	–up, –ut
kaaverissiullaqqiss¦oq	N	–up, –ut
kaaviaartitaavoq	V	(no generation)
kaaviffi¦k	N	–up, –it
kaaviiaaginnart¦oq	N	–up, –ut
kaavi¦iaaginnartoq	N	{–ajaaginnartup, –iaaginnartup}, {–ajaaginnartut, –iaaginnartut}
kaaviiaalersita¦q	N	–p, –t
kaaviiaaler¦sitaq	N	{–sitap, –titap}, {–sitat, –titat}
kaavi¦iaalersitaq	N	{–ajaalersitap, –ajaalertitap, –iaalersitap, –iaalertitap}, {–ajaalersitat, –ajaalertitat, –iaalersitat, –iaalertitat}
kaaviiaalersitsine¦q	N	–rup, –rit
kaaviiaaler¦sitsineq	N	{–sitsinerup, –titsinerup}, {–sitsinerit, –titsinerit}
kaavi¦iaalersitsineq	N	{–ajaalersitsinerup, –ajaalertitsinerup, –iaalersitsinerup, –iaalertitsinerup}, {–ajaalersitsinerit, –ajaalertitsinerit, –iaalersitsinerit, –iaalertitsinerit}
kaaviiaalersitsis¦oq	N	–up, –ut
kaaviiaaler¦sitsisoq	N	{–sitsisup, –titsisup}, {–sitsisut, –titsisut}
kaavi¦iaalersitsisoq	N	{–ajaalersitsisup, –ajaalertitsisup, –iaalersitsisup, –iaalertitsisup}, {–ajaalersitsisut, –ajaalertitsisut, –iaalersitsisut, –iaalertitsisut}
kaaviiaarne¦q	N	–rup, –rit
kaaviiaarpaa	V	(no generation)
kaaviiaarpoq	V	(no generation)
kaaviiaartitsine¦q	N	–rup, –rit
kaaviiaart¦oq	N	–up, –ut
kaaviiaaruppaa	V	(no generation)
kaaviinnaleruttorpoq	V	(no generation)
kaaviinna¦q	N	–ap, –at
kaaviivoq	V	(no generation)
kaavikajaarpoq	V	(no generation)
kaavikajaartippaa	V	(no generation)
kaavikajaaruppaa	V	(no generation)
kaaviki¦ak	N	{–aap, –ssap}, {–aat, –ssat}
kaavikoorajuppoq	V	(no generation)
kaavikoorajutt¦oq	N	–up, –ut
kaavikoorpoq	V	(no generation)
kaavikoort¦oq	N	–up, –ut
kaavikoortorsuit	N, pl.	-
kaavikoortorujussu¦aq	N	–up, –it
kaavikoortorujussu¦uneq	N	{–aanerup, –unerup}, {–aanerit, –unerit}
kaavikoortorujussu¦usoq	N	{–aasup, –usup}, {–aasut, –usut}
kaavikoortorujussuuvoq	V	(no generation)
kaavikul¦ooq	N	–uup, –uut
kaavikuloorpoq	V	(no generation)
kaavikuulaarne¦q	N	–rup, –rit
kaavilillarpoq	V	(no generation)
kaavinnaa¦q	N	–p, –t
kaavinne¦q	N	–rup, –rit
kaavippaa	V	(no generation)
kaavippalunne¦q	N	–rup, –rit
kaavippaluppoq	V	(no generation)
kaavippoq	V	(no generation)
kaavissuppaa	V	(no generation)
kaavitiaa¦q	N	–p, –t
kaavitippaa	V	(no generation)
kaavititsisarpoq	V	(no generation)
kaavititsivi¦k	N	–up, –it
kaavititsivoq	V	(no generation)
kaavitsivi¦k	N	–up, –it
kaavittaria¦q	N	–p, –t
kaavittari¦aq	N	{–ssap, –ap}, {–ssat, –at}
kaavittari¦aq	N	–ssap, –ssat
kaavitt¦oq	N	–up, –ut
kaavi¦ttoq	N	{–ssup, –ttup}, {–ssut, –ttut}
kaavit¦tuarneq	N	{–tuarnerup, –uarnerup}, {–tuarnerit, –uarnerit}
kaavittuarpaa	V	(no generation)
kaavittuarpoq	V	(no generation)
kaavittuliorne¦q	N	–rup, –rit
kaavi¦ttuliorneq	N	{–ssuliornerup, –ttuliornerup}, {–ssuliornerit, –ttuliornerit}
kaavittuliorpoq	V	(no generation)
kaavoq	V	(no generation)
kabal¦i	N	–ip, {–er, –it}
kabeleqanngits¦oq	N	–up, –ut
kabeli	N	–p, –t
kabelilersuine¦q	N	–rup, –rit
kabelilersuisart¦oq	N	–up, –ut
kaffequt	N	–ip, –it
kaffi	N	–p, –t
kaff¦i	N	–ip, {–er, –it}
kaffiguppoq	V	(no generation)
kaffiina	N	–p, –t
kaffiinat	N, pl.	-
kaffilaa¦q	N	–p, –t
kaffilaat	N, pl.	-
kaffiliorpoq	V	(no generation)
kaffiliuserpoq	V	(no generation)
kaffiliut	N	–ip, –it
kaffiliut	N, pl.	-
kaffiliuut	N	–ip, –it
kaffilivi¦k	N	–up, –it
kaffillerne¦q	N	–rup, –rit
kaffillerpoq	V	(no generation)
kaffinngerpoq	V	(no generation)
kaffipaju¦k	N	–up, –it
kaffisivoq	V	(no generation)
kaffisoqatigiinnersu¦aq	N	–up, –it
kaffi¦soqatigiinnersuaq	N	{–soqatigiinnersuup, –toqatigiinnersuup}, {–soqatigiinnersuit, –toqatigiinnersuit}
kaffisorfi¦k	N	–up, –it
kaffi¦sorfik	N	{–sorfiup, –torfiup}, {–sorfiit, –torfiit}
kaffisoriartorpoq	V	(no generation)
kaffisorniartarfi¦k	N	–up, –it
kaffi¦sorniartarfik	N	{–sorniartarfiup, –torniartarfiup}, {–sorniartarfiit, –torniartarfiit}
kaffisorpoq	V	(no generation)
kaffisorsuataarpoq	V	(no generation)
kaffisunni	N	–p, –t
kaffisuumavoq	V	(no generation)
kaffisuuterujoorne¦q	N	–rup, –rit
kaffisuut¦erujoorneq	N	{–erujoornerup, –serujoornerup}, {–erujoornerit, –serujoornerit}
kaggerluppaa	V	(no generation)
Kairo	Prop	–p, –t
kajaallivoq	V	(no generation)
kajaappoq	V	(no generation)
kajaaserpoq	V	(no generation)
kajaasertaannarpoq	V	(no generation)
kajaasiuippoq	V	(no generation)
kajarnianngilaq	V	(no generation)
kajarpoq	V	(no generation)
kaj¦ooq	N	–uup, –uut
kajoorpoq	V	(no generation)
kaj¦oq	N	–up, –ut
kajoraammerpoq	V	(no generation)
kajoranaqaaq	V	(no generation)
kajoravoq	V	(no generation)
kajorpoq	V	(no generation)
kajorra¦q	N	–p, –t
kajorravoq	V	(no generation)
kajortippaa	V	(no generation)
kajorti¦ppoq	V	–nngilaq
kajortisippaa	V	(no generation)
kajorti¦sitsineq	N	{–sitsinerup, –titsinerup, –tsitsinerup}, {–sitsinerit, –titsinerit, –tsitsinerit}
kajortit¦ippoq	V	–sinngilaq
kajort¦oq	N	–up, –ut
kajortuinnaavoq	V	(no generation)
kajoru¦eq	N	–ip, –it
kajorujutt¦oq	N	–up, –ut
kajorujuttuinna¦q	N	{–p, –ap}, {–t, –at}
kajorujuttuinna¦q	N	–ap, –at
kajoru¦seq	N	–tsip, –tsit
kajorutsikkaluttuinnarpoq	V	(no generation)
kajorutsi¦ppoq	V	–nngilaq
kajua¦raq	N	–qqap, –qqat
kajuarpoq	V	(no generation)
kajuarsarpaa	V	(no generation)
kajuart¦oq	N	–up, –ut
kajujuumminart¦oq	N	–up, –ut
kajujuummisaarpoq	V	(no generation)
kajujuummisaat	N	–ip, –it
kajujuummisippaa	V	(no generation)
kajujuummivoq	V	(no generation)
kajumigaa	V	(no generation)
kajumigeqaa	V	(no generation)
kajumiginngilaa	V	(no generation)
kajumigisaqannginne¦q	N	–rup, –rit
kajumiikkunnaarpoq	V	(no generation)
kajumiilliartorpoq	V	(no generation)
kajumiilliorpoq	V	(no generation)
kajumiillivoq	V	(no generation)
kajumii¦ppoq	V	–nngilaq
kajumiissu¦seq	N	–tsip, –tsit
kajumi¦issuseq	N	{–issutsip, –nngaanniissutsip}, {–issutsit, –nngaanniissutsit}
kajumiits¦oq	N	–up, –ut
kajumiler¦saat	N	{–saatip, –taatip}, {–saatit, –taatit}
kajumilersinneqarne¦q	N	–rup, –rit
kajumilersitsine¦q	N	–rup, –rit
kajumingerpoq	V	(no generation)
kajuminnaqaaq	V	(no generation)
kajuminnart¦oq	N	–up, –ut
kajuminne¦q	N	–rup, –rit
kajuminngilaq	V	(no generation)
kajuminngissu¦seq	N	–tsip, –tsit
kajuminngits¦oq	N	–up, –ut
kajumippoq	V	(no generation)
kajumissaarillaqqissu¦seq	N	–tsip, –tsit
kajumissaarine¦q	N	–rup, –rit
kajumissaarivoq	V	(no generation)
kajumissaarneqanngits¦oq	N	–up, –ut
kajumi¦ssaarneqanngitsoq	N	{–ssaarneqanngitsup, –ttaarneqanngitsup}, {–ssaarneqanngitsut, –ttaarneqanngitsut}
kajumissaarneqarne¦q	N	–rup, –rit
kajumi¦ssaarneqarneq	N	{–ssaarneqarnerup, –ttaarneqarnerup}, {–ssaarneqarnerit, –ttaarneqarnerit}
kajumissaarpaa	V	(no generation)
kajumissaarut	N	–ip, –it
kajumissaarutissaanngits¦oq	N	–up, –ut
kajumissaaserpaa	V	(no generation)
kajumissaat	N	–ip, –it
kajumi¦ssaat	N	{–ssaatip, –ttaatip}, {–ssaatit, –ttaatit}
kajumissaatisia¦q	N	–p, –t
kajumi¦ssaatisiaq	N	{–ssaatisiap, –ttaatisiap}, {–ssaatisiat, –ttaatisiat}
kajumissaatissa¦q	N	–p, –t
kajumi¦ssaatissaq	N	{–ssaatissap, –ttaatissap}, {–ssaatissat, –ttaatissat}
kajumissisippaa	V	(no generation)
kajumissitinniarpaa	V	(no generation)
kajumissivoq	V	(no generation)
kajumissu¦seq	N	–tsip, –tsit
kajumissuseqanngissu¦seq	N	–tsip, –tsit
kajumissuseqanngits¦oq	N	–up, –ut
kajumissuseqarluart¦oq	N	–up, –ut
kajumissusil¦ik	N	{–iup, –lip, –lup}, –lit
kajumitsippoq	V	(no generation)
kajumitt¦oq	N	–up, –ut
kajumi¦ttoq	N	{–ssup, –ttup}, {–ssut, –ttut}
kajummisaarpoq	V	(no generation)
kajummisaartippaa	V	(no generation)
kajummisaarutigaa	V	(no generation)
kajummisaavippoq	V	(no generation)
kajungeraa	V	(no generation)
kajungereqaa	V	(no generation)
kajungerineruaa	V	(no generation)
kajungerisaat	N	–ip, –it
kajungerisa¦q	N	–p, –t
kajungeris¦oq	N	–up, –ut
kajungerivallaanngilaa	V	(no generation)
kajungernaappoq	V	(no generation)
kajungernaqaaq	V	(no generation)
kajungernarpoq	V	(no generation)
kajungernart¦oq	N	–up, –ut
kajungernassu¦seq	N	–tsip, –tsit
kajungerne¦q	N	–rup, –rit
kajungerpoq	V	(no generation)
kajungersaat	N	–ip, –it
kajunger¦saat	N	{–saatip, –taatip}, {–saatit, –taatit}
kajungersippaa	V	(no generation)
kajungissuseqanngits¦oq	N	–up, –ut
kajungissutigaa	V	(no generation)
kajunngut	N	–ip, –it
kajunngutaavoq	V	(no generation)
kajunngutigaa	V	(no generation)
kajupappoq	V	(no generation)
kajusivoq	V	(no generation)
kajussuppoq	V	(no generation)
kakaav¦i	N	{–ip, –up}, {–it, –ut}
kakagaa	V	(no generation)
kaka¦gaq	N	–kkap, –kkat
kakaginnippoq	V	(no generation)
kakagiti¦ppoq	V	–nngilaq
kaka¦k	N	–ap, –at
kaka¦o	N	–up, –ut
kakappaa	V	(no generation)
kakappallaaqaaq	V	(no generation)
kakappoq	V	(no generation)
kakaqaaq	V	(no generation)
kakassa¦k	N	–ap, –at
kakassa¦q	N	–p, –t
kakattorsuuvoq	V	(no generation)
kaki¦aat	N	{–aat, –ssat, –aatip}, –aatit
kaki¦ak	N	{–aap, –ssap}, {–aat, –ssat}
kakiarpaa	V	(no generation)
kakikkaalunne¦q	N	–rup, –rit
kakikkaaluppoq	V	(no generation)
kakikkaalutsi¦ppoq	V	–nngilaq
kakikkaalutsitsivoq	V	(no generation)
kakikkalaarpoq	V	(no generation)
kakikkalaartitsivoq	V	(no generation)
kakikkalaartuinnaavoq	V	(no generation)
kakikkarsine¦q	N	–rup, –rit
kakikkarsivoq	V	(no generation)
kakilisaa¦raq	N	–qqap, –qqat
kakilisa¦k	N	–ap, –at
kakilisanniarpoq	V	(no generation)
kakillaalunne¦q	N	–rup, –rit
kakillaaluppoq	V	(no generation)
kakillaaluttuinnaavoq	V	(no generation)
kakillalaarpoq	V	(no generation)
kakillalaartitsivoq	V	(no generation)
kakillarnaasat	N, pl.	-
kakillarna¦q	N	–p, –t
kakillarnaqut	N	–ip, –it
kakillarnaqutaasa¦q	N	–p, –t
kakillarnarta¦q	N	–p, –t
kakillarnartarpoq	V	(no generation)
kakine¦q	N	–rup, –rit
kakioraat	N	–ip, –it
kakiorne¦q	N	–rup, –rit
kakiorpaa	V	(no generation)
kakiorpoq	V	(no generation)
kakiortinne¦q	N	–rup, –rit
kakipattuuppaa	V	(no generation)
kakipattuussivoq	V	(no generation)
kakisivoq	V	(no generation)
kakivaa	V	(no generation)
kakivippoq	V	(no generation)
kakivoq	V	(no generation)
kakkaak	Interj	(no generation)
kakkaffi¦k	N	–up, –it
kakkagaa	V	(no generation)
kakkaginarpoq	V	(no generation)
kakkaginnippoq	V	(no generation)
kakkagitippoq	V	(no generation)
kakkakkaa	N	–p, –t
kakkakkaartorpaluppoq	V	(no generation)
kakkakkaartorpoq	V	(no generation)
kakkalluinnarpoq	V	(no generation)
kakkappoq	V	(no generation)
kakkaqaaq	V	(no generation)
kakkatt¦oq	N	–up, –ut
kakkattorsu¦aq	N	–up, –it
kakkattorujussu¦aq	N	–up, –it
kakkeqattaarpoq	V	(no generation)
kakkersaane¦q	N	–rup, –rit
kakkersaas¦oq	N	–up, –ut
kakkersaat	N	–ip, –it
kakkersaavi¦k	N	–up, –it
kakkersaa¦vik	N	{–ffiup, –viup}, {–ffiit, –viit}
kakkersaavoq	V	(no generation)
kakkersarpaa	V	(no generation)
kakkersorpaa	V	(no generation)
kakkersui¦vik	N	{–ffiup, –viup}, {–ffiit, –viit}
kakkersuuppaa	V	(no generation)
kakkersuussivoq	V	(no generation)
kakkiffi¦k	N	–up, –it
kakki¦k	N	–up, –it
kakkilertane¦q	N	–rup, –rit
kakkilertaqaaq	V	(no generation)
kakkilertas¦oq	N	–up, –ut
kakkilertavoq	V	(no generation)
kakkinneqarne¦q	N	–rup, –rit
kakkippaa	V	(no generation)
kakkippoq	V	(no generation)
kakkissaaserpoq	V	(no generation)
kakkissaassu¦aq	N	–up, –it
kakkissaat	N	–ip, –it
kakkissarfi¦k	N	–up, –it
kakkissivoq	V	(no generation)
kakkissorpaa	V	(no generation)
kakkissorpoq	V	(no generation)
kakkitsivoq	V	(no generation)
kakkiuppaa	V	(no generation)
kakkiussa¦q	N	–p, –t
kakkiviakippoq	V	(no generation)
kakkiviakkaa¦q	N	–p, –t
kakkivi¦aq	N	–ssap, –ssat
kakkiviart¦ooq	N	–uup, –uut
kakkivi¦k	N	–up, –it
kakkiviliorpoq	V	(no generation)
kakkivittaarpoq	V	(no generation)
kakku	Pron, pl.	–a
kakuja¦k	N	–ap, –at
kalaal¦eq	N	–lip, –lit
kalaalerpaluttunngorsaane¦q	N	–rup, –rit
kalaalerpaluttunngortippaa	V	(no generation)
kalaalerpasippoq	V	(no generation)
Kalaalia¦raq	N	{–qqap, –qqap}, {–qqat, –qqat}
Kalaalia¦raq	Prop	–qqap
kalaalimineerniarfi¦k	N	–up, –it
kalaalim¦ineq	N	–ernup, –ernit
kalaalingavoq	V	(no generation)
kalaalinngorsa¦rpaa	V	–nngilaa
kalaaliussu¦seq	N	–tsip, –tsit
kalaaliuvoq	V	(no generation)
kalaalivi¦k	N	–up, –it
kalaaliviuvoq	V	(no generation)
kalaallari¦k	N	–up, –it
kalaallis¦ooq	N	–uup, –uut
kalaallisooqarpoq	V	(no generation)
kalaalli¦soorneq	N	{–soornerup, –toornerup}, {–soornerit, –toornerit}
kalaallisoorpoq	V	(no generation)
kalaallisoortaannarpoq	V	(no generation)
kalaallisuunngortippaa	V	(no generation)
kalaallisuut	N, pl.	-
kalaallit	N, pl.	-
kalaane¦q	N	–rup, –rit
kala¦k	N	–ap, –at
kalallivoq	V	(no generation)
kalassivoq	V	(no generation)
kalatt¦ooq	N	–uup, –uut
kalattoorne¦q	N	–rup, –rit
kalattoorpoq	V	(no generation)
kalattuut	N, pl.	-
kalavi¦k	N	–up, –it
kalerrappoq	V	(no generation)
kalerra¦q	N	–ap, –at
kalerraqarpoq	V	(no generation)
kalerriiartorpoq	V	(no generation)
kalerriiartort¦oq	N	–up, –ut
kalerriine¦q	N	–rup, –rit
kalerriini¦ooq	N	–uup, –uut
kalerriitsiarne¦q	N	–rup, –rit
kalerriivoq	V	(no generation)
kalerrippaa	V	(no generation)
kalerrippoq	V	(no generation)
kalerrisaareriaannaane¦q	N	–rup, –rit
kalerrisaarine¦q	N	–rup, –rit
kalerrisaarisarfi¦k	N	–up, –it
kalerrisaarivoq	V	(no generation)
kalerrisaarpaa	V	(no generation)
kalerrisaarut	N	–ip, –it
kalerrisaaru¦tilerisoq	N	{–serisup, –tilerisup}, {–serisut, –tilerisut}
kalerrisimassu¦seq	N	–tsip, –tsit
kalerris¦imassuseq	N	{–imassutsip, –simassutsip}, {–imassutsit, –simassutsit}
kalerritsorpoq	V	(no generation)
kalerriuppaa	V	(no generation)
kalerriussaqarpoq	V	(no generation)
kalerriutigaa	V	(no generation)
kaliappoq	V	(no generation)
kaliattuinnaavoq	V	(no generation)
kaligaa	V	(no generation)
kali¦gaq	N	–kkap, –kkat
kaligiikkut	N	–ip, –it
kaligut	N	–ip, –it
kalikalaarpaa	V	(no generation)
kalikalaarpoq	V	(no generation)
kalikalaartuinnaavoq	V	(no generation)
kalikataarpaa	V	(no generation)
kalikataarpoq	V	(no generation)
kalikattaavoq	V	(no generation)
kalikatta¦q	N	–p, –t
kalikattaraa	V	(no generation)
kalikkiarpoq	V	(no generation)
kalinne¦q	N	–rup, –rit
kalinneqarne¦q	N	–rup, –rit
kalinneqarpoq	V	(no generation)
kalinneqart¦oq	N	–up, –ut
kalippaa	V	(no generation)
kalippoq	V	(no generation)
kalisappalaanngu¦aq	N	–up, –it
kalisappoq	V	(no generation)
kalisattorpoq	V	(no generation)
kalisattorsuuvoq	V	(no generation)
kalissarpoq	V	(no generation)
kalissugaa	V	(no generation)
kalitaaruppoq	V	(no generation)
kalita¦q	N	–p, –t
kalitaqarpoq	V	(no generation)
kalitippaa	V	(no generation)
kalitsippaa	V	(no generation)
kalitsi¦ppoq	V	–nngilaq
kalittaat	N	–ip, –it
kali¦ttaat	N	{–ssaatip, –ttaatip}, {–ssaatit, –ttaatit}
kalitta¦gaq	N	–kkap, –kkat
kalitt¦oq	N	–up, –ut
kali¦ttoq	N	{–ssup, –ttup}, {–ssut, –ttut}
kalk	N	–ip, –it
kalkeerunne¦q	N	–rup, –rit
kalkininne¦q	N	–rup, –rit
kalkitaqart¦oq	N	–up, –ut
kalkiterine¦q	N	–rup, –rit
kalkiterivoq	V	(no generation)
kalkiterpaa	V	(no generation)
kallagaappoq	V	(no generation)
kallangaappoq	V	(no generation)
kallangavoq	V	(no generation)
kalle¦q	N	–rup, –rit
kalleqqammerpoq	V	(no generation)
kallerpaluppoq	V	(no generation)
kallerpoq	V	(no generation)
kallersorsuuvoq	V	(no generation)
kallersu¦aq	N	–up, –it
kallilerpoq	V	(no generation)
kalliliussaavoq	V	(no generation)
kalloorfi¦k	N	–up, –it
kalloorpaa	V	(no generation)
kallormippaa	V	(no generation)
kallu	N	–p, –t
kalluaas¦oq	N	–up, –ut
kalluaavoq	V	(no generation)
kallua¦gaq	N	–kkap, –kkat
kalluarpaa	V	(no generation)
kalluarti¦ppoq	V	–nngilaq
kalluppaa	V	(no generation)
kalluppoq	V	(no generation)
kalluserpaa	V	(no generation)
kalluserpoq	V	(no generation)
kallussa¦q	N	–p, –t
kallussarpoq	V	(no generation)
kallut	N	–ip, –it
kallut	N, pl.	-
kalluunnaveersaarne¦q	N	–rup, –rit
kalluunnaveersaartippaa	V	(no generation)
kalluuppaa	V	(no generation)
kalluuppoq	V	(no generation)
kalluussaappaa	V	(no generation)
kalluussaappoq	V	(no generation)
kalluussarpoq	V	(no generation)
kaloria	N	–p, –t
kaluippoq	V	(no generation)
kaluissimavoq	V	(no generation)
kalummaraa	V	(no generation)
kalunne¦q	N	–rup, –rit
kalunnerit	N, pl.	-
kalupippoq	V	(no generation)
kalupittaannarpoq	V	(no generation)
kalupittarpoq	V	(no generation)
kaluppoq	V	(no generation)
kaluserfi¦k	N	–up, –it
kalu¦serfik	N	{–serfiup, –tilerfiup}, {–serfiit, –tilerfiit}
kaluserpaa	V	(no generation)
kaluserpoq	V	(no generation)
kalusiivoq	V	(no generation)
kalusiuppaa	V	(no generation)
kalusiussa¦q	N	–p, –t
kalu¦siussaq	N	{–siussap, –tiliussap}, {–siussat, –tiliussat}
kalusiussivoq	V	(no generation)
kalussarfigaa	V	(no generation)
kalussarpoq	V	(no generation)
kalut	N	–ip, –it
kalut	N, pl.	-
kalutaarpaa	V	(no generation)
kalutaavoq	V	(no generation)
kaluttugaa	V	(no generation)
kaluuvoq	V	(no generation)
kamaakkunnaarpaa	V	(no generation)
kamaammerne¦q	N	–rup, –rit
kamaammerpoq	V	(no generation)
kamaanne¦q	N	–rup, –rit
kamaappaa	V	(no generation)
kamaassaavoq	V	(no generation)
kamaassivoq	V	(no generation)
kamaat	N	–ip, –it
kamaatigaa	V	(no generation)
kamaatigigaluarnikuuaa	V	(no generation)
kamaatiginnippoq	V	(no generation)
kamaatigivallaaqaa	V	(no generation)
kamaa¦tilerneq	N	{–tilernerup, –sernerup}, {–tilernerit, –sernerit}
kamaa¦tilerneq	N	{–tilernerup, –tsilernerup, –sernerup}, {–tilernerit, –tsilernerit, –sernerit}
kamaatingaarpaa	V	(no generation)
kamagaa	V	(no generation)
kamaginninne¦q	N	–rup, –rit
kamaginnippoq	V	(no generation)
kamaginnissu¦seq	N	–tsip, –tsit
kamaginnitt¦oq	N	–up, –ut
kamagittaappoq	V	(no generation)
kamagi¦ttarneq	N	{–ssarnerup, –ttarnerup}, {–ssarnerit, –ttarnerit}
kamagittarpoq	V	(no generation)
kamagittart¦oq	N	–up, –ut
kamagi¦ttartoq	N	{–ssartup, –ttartup}, {–ssartut, –ttartut}
kamajaappoq	V	(no generation)
kamajanerulluinnalerpoq	V	(no generation)
kamajanerulluinnarpoq	V	(no generation)
kamajaneruvoq	V	(no generation)
kamajas¦oq	N	–up, –ut
kamajasorsu¦aq	N	–up, –it
kamajasorsuuvoq	V	(no generation)
kamajassu¦seq	N	–tsip, –tsit
kamajavallaarne¦q	N	–rup, –rit
kamajavallaarpoq	V	(no generation)
kamajavoq	V	(no generation)
kamajuillivoq	V	(no generation)
kamajuinaarpaa	V	(no generation)
kamajuinaarpoq	V	(no generation)
kamajuippoq	V	(no generation)
kamakkajuppoq	V	(no generation)
kamakkajussu¦seq	N	–tsip, –tsit
kamakkajutt¦oq	N	–up, –ut
kamakkaluangaarpoq	V	(no generation)
kamakkaluarnerarpaa	V	(no generation)
kamakkaluttuaqaaq	V	(no generation)
kamakkaluttuinnarpoq	V	(no generation)
kamakkunnaarpoq	V	(no generation)
kamakujuppoq	V	(no generation)
kamakulaarpoq	V	(no generation)
kamalerne¦q	N	–rup, –rit
kamalerpoq	V	(no generation)
kamalias¦oq	N	–up, –ut
kamanaappoq	V	(no generation)
kamanaassu¦seq	N	–tsip, –tsit
kamanaats¦oq	N	–up, –ut
kamanaatsuliorpoq	V	(no generation)
kamanarpoq	V	(no generation)
kamangaarne¦q	N	–rup, –rit
kamangaart¦oq	N	–up, –ut
kamannarisarpaa	V	(no generation)
kamannaveersaarpoq	V	(no generation)
kamannavianngilaq	V	(no generation)
kamanne¦q	N	–rup, –rit
kamannertoqaaq	V	(no generation)
kamannertuvoq	V	(no generation)
kamappasippoq	V	(no generation)
kamappoq	V	(no generation)
kamarujussuarne¦q	N	–rup, –rit
kamassaarine¦q	N	–rup, –rit
kamassaaris¦oq	N	–up, –ut
kamassaarivoq	V	(no generation)
kamassaarpaa	V	(no generation)
kamassimangaarne¦q	N	–rup, –rit
kamassimangaart¦oq	N	–up, –ut
kamassut	N	–ip, –it
kamassutigaa	V	(no generation)
kamasuppoq	V	(no generation)
kamatsippaa	V	(no generation)
kamattoorne¦q	N	–rup, –rit
kamatt¦oq	N	–up, –ut
kamattorsuanngorpoq	V	(no generation)
kamattorsuuvoq	V	(no generation)
kamattorujussuuvoq	V	(no generation)
kamee¦raq	N	–qqap, –qqat
kam¦eeraq	N	{–eeqqap, –iaqqap}, {–eeqqat, –iaqqat}
kameernia¦q	N	–p, –t
kameerniart¦oq	N	–up, –ut
kame¦raq	N	–qqap, –qqat
kamerual¦ik	N	{–iup, –lip, –lup}, –lit
kameru¦aq	N	–ssap, –ssat
kamerusserpoq	V	(no generation)
kamigippoq	V	(no generation)
kamigissaarpoq	V	(no generation)
ka¦mik	N	–miup, {–miit, –nngit}
kamik¦oq	N	–up, –ut
kamiku	N	–p, –t
kamilerpaa	V	(no generation)
kamiliaraa	V	(no generation)
kamiliorpoq	V	(no generation)
kamilisarpoq	V	(no generation)
kamillaangasaannarpoq	V	(no generation)
kamillaangas¦oq	N	–up, –ut
kamillaangavoq	V	(no generation)
kamillaarpoq	V	(no generation)
kamillaat	N	–ip, –it
kamillarpaa	V	(no generation)
kamillarpoq	V	(no generation)
kamillarsimavoq	V	(no generation)
kamillartaat	N	–ip, –it
kamillartart¦oq	N	–up, –ut
kamillarterpaa	V	(no generation)
kamillarterpoq	V	(no generation)
kamillerpoq	V	(no generation)
kamiluppoq	V	(no generation)
kaminngortippaa	V	(no generation)
kaminngu¦aq	N	–up, –it
kamippaa	V	(no generation)
kamippagippoq	V	(no generation)
kamippa¦k	N	–ap, –at
kamippalerpoq	V	(no generation)
kamippal¦ik	N	{–iup, –lip, –lup}, –lit
kamippaliort¦oq	N	–up, –ut
kamippalisaarpoq	V	(no generation)
kamippaqarpoq	V	(no generation)
kamippoq	V	(no generation)
kamisalee¦raq	N	–qqap, –qqat
kamisaliorpoq	V	(no generation)
kami¦saq	N	–tsap, –tsat
kamisartaarpoq	V	(no generation)
kamissaaruppoq	V	(no generation)
kamissaqanngilaq	V	(no generation)
kamissimavoq	V	(no generation)
kamissivoq	V	(no generation)
kamitsiorpoq	V	(no generation)
kamitsisaarpoq	V	(no generation)
kamitsivoq	V	(no generation)
kamittaarpoq	V	(no generation)
kamittaat	N	–ip, –it
kamittaat	N, pl.	-
kami¦ttaat	N	{–ssaatip, –ttaatip}, {–ssaatit, –ttaatit}
kamitta¦q	N	–p, –t
kamittorpoq	V	(no generation)
kammagiit	N, pl.	-
kammagiunnaarpaa	V	(no generation)
kamma¦k	N	–ap, –at
kammalaat	N	–ip, –it
kammalaat	N, pl.	-
kammalaatersorne¦q	N	–rup, –rit
kammart¦ooq	N	–uup, –uut
kammartoorsu¦aq	N	–up, –it
kammartuvoq	V	(no generation)
kammaserpoq	V	(no generation)
kammat	N, pl.	-
kammatigaa	V	(no generation)
kammeraaq	V	(no generation)
kammerisigaa	V	(no generation)
kammerisuuvoq	V	(no generation)
kammerivoq	V	(no generation)
kammillaqqippoq	V	(no generation)
kammiorpaa	V	(no generation)
kammiorpoq	V	(no generation)
kammiortariaqarpoq	V	(no generation)
kammiortippaa	V	(no generation)
kammisarpoq	V	(no generation)
kammisippaa	V	(no generation)
kammiugaavoq	V	(no generation)
kammiu¦gaq	N	–kkap, –kkat
kammiugassa¦q	N	–p, –t
kammiusiorpoq	V	(no generation)
kammiut	N	–ip, –it
kammiutaarserpoq	V	(no generation)
kammiutaaruppoq	V	(no generation)
kammiutisivoq	V	(no generation)
kammivaa	V	(no generation)
kammivoq	V	(no generation)
Kampucheamioq	N	(no generation)
Kampuchea¦miu	N	{–miup, –rmiup}, {–miut, –rmiut}
Kanaan	Prop	–ip
kanaa¦q	N	–p, –t
kanaarmippoq	V	(no generation)
kanaartakippoq	V	(no generation)
kanaartakits¦oq	N	–up, –ut
kanaartal¦ik	N	{–iup, –lip, –lup}, –lit
kanaarta¦q	N	–p, –t
kanajaasiorpoq	V	(no generation)
kanajaat	N	–ip, –it
kanajajoorpoq	V	(no generation)
kanajajugaa	V	(no generation)
kanajajuukkuppaa	V	(no generation)
kana¦joq	N	–ssup, –ssut
kanajorla¦k	N	–ap, –at
kanajorniarpoq	V	(no generation)
kanajorpoq	V	(no generation)
kanajorsiut	N	–ip, –it
kanajorta¦q	N	–p, –t
kananii¦ppoq	V	–nngilaq
kananiitt¦oq	N	–up, –ut
kanannaanngu¦aq	N	–up, –it
kanannaasarpoq	V	(no generation)
kananna¦q	N	–p, –t
kanannarsu¦aq	N	–up, –it
kanannerajuppoq	V	(no generation)
kanannerpoq	V	(no generation)
kanannersorsuuvoq	V	(no generation)
kananngakanne¦q	N	–rup, –rit
kanasserpoq	V	(no generation)
kanassiarpoq	V	(no generation)
kanassiorpoq	V	(no generation)
kandidat	N	–ip, –it
kan¦eeraq	N	{–eeqqap, –iaqqap}, {–eeqqat, –iaqqat}
kaneli	N	–p, –t
kane¦q	N	–rup, –rit
kanernarsiffi¦k	N	–up, –it
kanerne¦q	N	–rup, –rit
kanerpaa	V	(no generation)
kanerpoq	V	(no generation)
kanersorsuuvoq	V	(no generation)
Kangaamiunukarpoq	V	(no generation)
Kangaamiut	Prop, pl.	-
kangaanngu¦aq	N	–up, –it
kangaa¦q	N	–p, –t
kangaarsu¦k	N	–up, –it
kangaasanngu¦aq	N	–up, –it
kangaasa¦q	N	–p, –t
Kangaatsiamukarpoq	V	(no generation)
Kangaatsia¦q	N	–ap, –at
Kangaatsia¦q	Prop	–p
Kange¦q	N	–rup, –rit
kange¦q	N	–rup, –rit
kangeqquppaa	V	(no generation)
kangeqquppoq	V	(no generation)
kangeqqutsivoq	V	(no generation)
kangerlersima¦neq	N	{–nerup, –rnup}, {–nerit, –rnit}
kangerlersimanersu¦aq	N	–up, –it
kangerliuma¦neq	N	{–nerup, –rnup}, {–nerit, –rnit}
kangerliumanersu¦aq	N	–up, –it
kangerliumaninngu¦aq	N	–up, –it
Kangerluarsoru¦seq	Prop	–tsip
Kangerluarsorutsimukarpoq	V	(no generation)
kangerluarsu¦k	N	–up, –it
kangerluarsunngu¦aq	N	–up, –it
kangerluarsussu¦aq	N	–up, –it
kangerluatsia¦q	N	–ap, –at
Kangerlu¦k	N	–up, –it
Kangerlu¦k	Prop	–up, –it
kangerlummiu	N	–p, –t
Kangerlummukarpoq	V	(no generation)
Kangerlussu¦aq	N	–up, –it
Kangerlussu¦aq	Prop	–up
kangerlussu¦aq	N	–up, –it
Kangerlussuarmukarpoq	V	(no generation)
Kangerlussuatsia¦q	N	–ap, –at
kangerluusa¦q	N	–p, –t
Kangermi¦oq	N	–up, –ut
Kangermioqat	N	–ip, –it
kangermiorsu¦aq	N	–up, –it
Kangermiu	N	–p, –t
Kangermiu	Prop	–p
kangerparpoq	V	(no generation)
kangerpasippoq	V	(no generation)
kangers¦ooq	N	–uup, –uut
kangersu¦aq	N	–up, –it
Kangersuatsiamukarpoq	V	(no generation)
Kangersuatsia¦q	N	–ap, –at
Kangersuatsia¦q	N	–p, –t
Kangersuatsia¦q	Prop	–p
kangersune¦q	N	–rup, –rit
kangersunermii¦ppoq	V	–nngilaq
kangi	N	–p, –t
kangiaappaa	V	(no generation)
Kangiamiut	N, pl.	-
kangiarpoq	V	(no generation)
kangiarterpaa	V	(no generation)
kangiartersimas¦oq	N	–up, –ut
kangiatig¦ooq	N	–uup, –uut
kangiatung¦e	N	–ip, –it
kangil¦eq	N	–ip, –it
kangileqarpoq	V	(no generation)
kangileraa	V	(no generation)
kangilermiu	N	–p, –t
kangilernatigoorpoq	V	(no generation)
kangiline¦q	N	–rup, –rit
Kangilinnguanukarpoq	V	(no generation)
Kangilinnguit	N, pl.	-
Kangilinnguit	Prop, pl.	-
kangill¦eq	N	–iup, –iit
kangillermiu	N	–p, –t
kangiller¦saat	N	{–saatip, –taatip}, {–saatit, –taatit}
kangillius¦oq	N	–up, –ut
kangilliuvoq	V	(no generation)
kangimukaappaa	V	(no generation)
kangimukaarpoq	V	(no generation)
kangimukaassivoq	V	(no generation)
kangimukarpoq	V	(no generation)
kangimukart¦oq	N	–up, –ut
kangisinnerus¦oq	N	–up, –ut
kangisi¦ssoq	N	{–ssup, –ttup}, {–ssut, –ttut}
kang¦oq	N	–up, –ut
kangujaappaa	V	(no generation)
kangujarpoq	V	(no generation)
kangujarterpaa	V	(no generation)
kaniajoorpoq	V	(no generation)
kaniajuukkuppaa	V	(no generation)
kaniili	N	–p, –t
kaniina	N	–p, –t
kani¦oq	N	–up, –ut
kaniorla¦k	N	–ap, –at
kaniorniarpoq	V	(no generation)
kaniorpoq	V	(no generation)
kaniorsiut	N	–ip, –it
kanioruppoq	V	(no generation)
kanissiarpoq	V	(no generation)
kanissiorpoq	V	(no generation)
ka¦nna	Pron	–ssuma, {–kku, –kkua}
kannaalia¦q	N	–p, –t
kanna¦k	N	–ap, –at
kannarta¦q	N	–t
kanne¦q	N	–rup, –rit
kanneqanngits¦oq	N	–up, –ut
kanngaarippoq	V	(no generation)
kanngerivoq	V	(no generation)
kanngeruppoq	V	(no generation)
kanngiffigaa	V	(no generation)
kanngippoq	V	(no generation)
kanngisaarut	N	–ip, –it
kanngisippaa	V	(no generation)
kanng¦oq	N	–up, –ut
kanngor¦ooq	N	–uup, –uut
kanngugaa	V	(no generation)
kanngugaaq	V	(no generation)
kannguginnippoq	V	(no generation)
kanngugisa¦q	N	–p, –t
kanngunaat	N	–ip, –it
kannguna¦at	N	{–at, –t, –atip}, –atit
kanngunangajatt¦oq	N	–up, –ut
kannguna¦q	N	{–ap, –p}, {–at, –t}
kanngunarluinnart¦oq	N	–up, –ut
kannguna¦rluinnartoq	N	{–luinnartup, –rluinnartup}, {–luinnartut, –rluinnartut}
kanngunarpoq	V	(no generation)
kanngunarsaane¦q	N	–rup, –rit
kanngunarsaat	N	–ip, –it
kanngunarsaavoq	V	(no generation)
kanngunarsarneqart¦oq	N	–up, –ut
kanngunarsarpaa	V	(no generation)
kanngunartitaane¦q	N	–rup, –rit
kanngunart¦oq	N	–up, –ut
kanngunartulia¦q	N	–p, –t
kanngunartuliorfigaa	V	(no generation)
kanngunartuliorne¦q	N	–rup, –rit
kanngunartuliorpoq	V	(no generation)
kanngunartuliort¦oq	N	–up, –ut
kanngunartuliorumassu¦seq	N	–tsip, –tsit
kanngunartuliungaarne¦q	N	–rup, –rit
kanngunassu¦seq	N	–tsip, –tsit
kannguppaa	V	(no generation)
kanngusaarivoq	V	(no generation)
kanngusaarpaa	V	(no generation)
kanngusaarpoq	V	(no generation)
kanngussaagalu¦aq	N	{–ap, –up}, –it
kanngussaagalu¦aq	N	–up, –it
kanngussaalaqivoq	V	(no generation)
kanngussaaqivoq	V	(no generation)
kanngussaarpoq	V	(no generation)
kanngussaasa¦q	N	–p, –t
kanngussaasimagaluart¦oq	N	–up, –ut
kanngussaat	N	–ip, –it
kanngussa¦k	N	–ap, –at
kanngussaleris¦oq	N	–up, –ut
kanngussaqarfi¦k	N	–up, –it
kanngussariss¦oq	N	–up, –ut
kanngussari¦ssoq	N	{–ssup, –ttup}, {–ssut, –ttut}
kanngussassa¦q	N	–p, –t
kanngussassarsiorfi¦k	N	–up, –it
kanngusuffigaa	V	(no generation)
kanngusujuippoq	V	(no generation)
kanngusulerpoq	V	(no generation)
kanngusunne¦q	N	–rup, –rit
kanngusuppoq	V	(no generation)
kanngusutsippaa	V	(no generation)
kanngusutt¦oq	N	–up, –ut
kanngusuut	N	–ip, –it
kanngusuutaajarpaa	V	(no generation)
kanngusuutigaa	V	(no generation)
kanngutsanne¦q	N	–rup, –rit
kanngutsappoq	V	(no generation)
kanngutsinnart¦oq	N	–up, –ut
kanngutsinne¦q	N	–rup, –rit
kanngut¦sinneq	N	{–innerup, –itinnerup, –sinnerup}, {–innerit, –itinnerit, –sinnerit}
kanngut¦sippoq	V	{–itinngilaq, –sinngilaq}
kanngutsissinnaanngilaq	V	(no generation)
kanngutsissutigaa	V	(no generation)
kannguttaalliorfigisaane¦q	N	–rup, –rit
kannguttaalliorne¦q	N	–rup, –rit
kannguttaalliorpoq	V	(no generation)
kannguttaanne¦q	N	–rup, –rit
kannguttaappoq	V	(no generation)
kannguttaassu¦seq	N	–tsip, –tsit
kannguttaats¦oq	N	–up, –ut
kannguttarpoq	V	(no generation)
kannguttart¦oq	N	–up, –ut
kanniarfi¦k	N	–up, –it
kanniarpoq	V	(no generation)
kannil¦ik	N	{–iup, –lip, –lup}, –lit
kannussa¦k	N	–ap, –at
kantiina	N	–p, –t
kanungaannarpoq	V	(no generation)
kanungakaappaa	V	(no generation)
kanunnaappaa	V	(no generation)
kanunnaassivoq	V	(no generation)
kanunnarpoq	V	(no generation)
kanunne¦q	N	–rup, –rit
kanunnge¦q	N	–rup, –rit
kanuunaqquppaa	V	(no generation)
kanuunaqquppoq	V	(no generation)
kanuunaralaanngu¦aq	N	–up, –it
kanuunart¦oq	N	–up, –ut
kaperiarpaa	V	(no generation)
kaperlaavoq	V	(no generation)
kaperla¦k	N	–ap, –at
kaperlappoq	V	(no generation)
kaperlu¦k	N	–up, –it
kapillattarpoq	V	(no generation)
kapinart¦oq	N	–up, –ut
kapinartoqangaart¦oq	N	–up, –ut
kapinartoqart¦oq	N	–up, –ut
kapinartueruppoq	V	(no generation)
kapinartul¦ik	N	{–iup, –lip, –lup}, –lit
kapine¦q	N	–rup, –rit
kapineqarne¦q	N	–rup, –rit
kapinnguallattarpoq	V	(no generation)
kapinngualuppoq	V	(no generation)
kapinngualutsitsivoq	V	(no generation)
kapinngualuttuarpoq	V	(no generation)
kapippaa	V	(no generation)
kapippoq	V	(no generation)
kapisa¦q	N	–p, –t
kapis¦eq	N	–ip, –it
kapisiarpoq	V	(no generation)
kapisilee¦raq	N	–qqap, –qqat
kapisil¦eeraq	N	{–eeqqap, –iaqqap}, {–eeqqat, –iaqqat}
kapisil¦ik	N	{–iup, –lip, –lup}, –lit
Kapisilimmiu	N	–p, –t
kapisilinniarne¦q	N	–rup, –rit
kapisilinniarpoq	V	(no generation)
Kapisilinnukarpoq	V	(no generation)
kapisilissu¦aq	N	–up, –it
kapisil¦issuaq	N	{–ersuup, –issuup}, {–ersuit, –issuit}
kapisilittassat	N, pl.	-
Kapisilliarpoq	V	(no generation)
Kapisillit	N, pl.	-
Kapisillit	Prop, pl.	-
kapisimas¦oq	N	–up, –ut
kapis¦imasoq	N	{–imasup, –simasup}, {–imasut, –simasut}
kapisine¦q	N	–rup, –rit
kapisiniaraluarniarpoq	V	(no generation)
kapisivoq	V	(no generation)
kapisoorpaa	V	(no generation)
kapisoorpoq	V	(no generation)
kapitaaruppoq	V	(no generation)
kapita¦k	N	–ap, –at
kapitali	N	–p, –t
kapita¦q	N	–p, –t
kapitariit	N, pl.	-
kapiterivoq	V	(no generation)
kapiterpoq	V	(no generation)
kapitinne¦q	N	–rup, –rit
kapit¦inneq	N	{–innerup, –sinnerup}, {–innerit, –sinnerit}
kapi¦tinneq	N	{–tinnerup, –sinnerup}, {–tinnerit, –sinnerit}
kapit¦ippoq	V	–sinngilaq
kapitserpoq	V	(no generation)
kapitsiorpaa	V	(no generation)
kapitsiorpoq	V	(no generation)
kapitsivoq	V	(no generation)
kapittarpoq	V	(no generation)
kapivaa	V	(no generation)
kapivoq	V	(no generation)
kapoorut	N	–ip, –it
kapoorutaavoq	V	(no generation)
kaporne¦q	N	–rup, –rit
kaporpaa	V	(no generation)
kaporpoq	V	(no generation)
kaporti¦ppoq	V	–nngilaq
kaportitsivoq	V	(no generation)
kaport¦oq	N	–up, –ut
kaportuarpaa	V	(no generation)
kaportuarpoq	V	(no generation)
kappiagaa	V	(no generation)
kappialaarajutt¦oq	N	–up, –ut
kappialaarne¦q	N	–rup, –rit
kappialaarpoq	V	(no generation)
kappialaart¦oq	N	–up, –ut
kappialaarumatussu¦seq	N	–tsip, –tsit
kappialaatigaa	V	(no generation)
kappialaffigaa	V	(no generation)
kappialagajutt¦oq	N	–up, –ut
kappialanart¦oq	N	–up, –ut
kappialane¦q	N	–rup, –rit
kappialarpalunne¦q	N	–rup, –rit
kappialarpalutt¦oq	N	–up, –ut
kappialassutigaa	V	(no generation)
kappialavoq	V	(no generation)
kappiasaarpoq	V	(no generation)
kappiasuppoq	V	(no generation)
kappiasuutigaa	V	(no generation)
kappilaatigaa	V	(no generation)
kappivoq	V	(no generation)
kapp¦oq	N	–up, –ut
kappoqquserpaa	V	(no generation)
kappoqqusersorpaa	V	(no generation)
kappoqqut	N	–ip, –it
kappuppaa	V	(no generation)
kappuppoq	V	(no generation)
kappussi¦vik	N	{–ffiup, –viup}, {–ffiit, –viit}
kappussivoq	V	(no generation)
kapput	N	–ip, –it
kapput	N, pl.	-
kapputaavoq	V	(no generation)
kapputarnaqaaq	V	(no generation)
kapugaavoq	V	(no generation)
kapu¦gaq	N	–kkap, –kkat
kapuine¦q	N	–rup, –rit
kapuisarpoq	V	(no generation)
kapuivoq	V	(no generation)
kapukaaluppoq	V	(no generation)
kapukaaluttuinnaavoq	V	(no generation)
kapukaappoq	V	(no generation)
kapukarpoq	V	(no generation)
kapukartaannarpoq	V	(no generation)
kapukartippaa	V	(no generation)
kapumaannart¦oq	N	–up, –ut
kapumavoq	V	(no generation)
kapumisaarpaa	V	(no generation)
kapunisaarut	N	–ip, –it
kapuppaa	V	(no generation)
kapuppoq	V	(no generation)
kapussippaa	V	(no generation)
kapussippoq	V	(no generation)
kapussivaa	V	(no generation)
kapussivi¦k	N	–up, –it
kapussivoq	V	(no generation)
kaputaappoq	V	(no generation)
kaputaavoq	V	(no generation)
kaputarpaa	V	(no generation)
kaputtoorpoq	V	(no generation)
kapuuppoq	V	(no generation)
kapuuserpoq	V	(no generation)
kapuusiuppaa	V	(no generation)
kapuussu¦aq	N	–up, –it
kapuut	N	–ip, –it
kapuutinngu¦aq	N	–up, –it
kapuuttuarpoq	V	(no generation)
karakteri	N	–p, –t
karaterne¦q	N	–rup, –rit
karburator	N	–ip, –it
kardusi	N	–p, –t
karnala¦k	N	–ap, –at
karnalatserut	N	–ip, –it
karnalatsi¦gaq	N	–kkap, –kkat
karnalavoq	V	(no generation)
karpuuli	N	–p, –t
karraqquppaa	V	(no generation)
karraqquppoq	V	(no generation)
karraqqutsivoq	V	(no generation)
karreerniart¦oq	N	–up, –ut
karreqalerpoq	V	(no generation)
karreqangaart¦oq	N	–up, –ut
karrertaajaaffilia¦q	N	–p, –t
karrertaajaane¦q	N	–rup, –rit
karrertaajarpaa	V	(no generation)
karrerta¦q	N	–p, –t
karri	N	–p, –t
karriiaavoq	V	(no generation)
karriiarpaa	V	(no generation)
karsersu¦aq	N	–up, –it
karsi	N	–p, –t
kars¦i	N	–ip, {–er, –it}
kars¦iaraasaq	N	{–eeraasap, –iaraasap}, {–eeraasat, –iaraasat}
karsisivoq	V	(no generation)
Kartago	Prop	–p, –t
kartoffeli	N	–p, –t
Karup	Prop	–ip
kaseerpaa	V	(no generation)
kasiilerpaa	V	(no generation)
kasse¦q	N	–rup, –rit
kassequserpoq	V	(no generation)
kassequt	N	–ip, –it
kasserivoq	V	(no generation)
kassermippaa	V	(no generation)
kassettebåndoptager	N	–ip, –it
kass¦oq	N	–up, –ut
kassunikkaluttuinnarpoq	V	(no generation)
kassunippoq	V	(no generation)
kassuppaa	V	(no generation)
kassuppoq	V	(no generation)
kassutsitsivoq	V	(no generation)
Kastrup	Prop	–ip
kasuppaa	V	(no generation)
kasuppoq	V	(no generation)
kasuta¦q	N	–p, –t
kasutsivoq	V	(no generation)
kasuttaaserpaa	V	(no generation)
kasuttaat	N	–ip, –it
kasutta¦gaq	N	–kkap, –kkat
kasuttorne¦q	N	–rup, –rit
kasuttorpaa	V	(no generation)
kasuttorpoq	V	(no generation)
kasuttuine¦q	N	–rup, –rit
kasuttuivoq	V	(no generation)
kasuttuut	N	–ip, –it
kasuuppaa	V	(no generation)
kasuussaappaa	V	(no generation)
kasuussaappoq	V	(no generation)
kasuussarpaluppoq	V	(no generation)
kasuussarpoq	V	(no generation)
kataakkaluttuinnarpoq	V	(no generation)
kataanniku	N	–p, –t
kataappoq	V	(no generation)
kataasa¦q	N	–p, –t
kataavoq	V	(no generation)
katagaajuarpoq	V	(no generation)
katagaanngivippoq	V	(no generation)
katagaavoq	V	(no generation)
katagalaannarpoq	V	(no generation)
katagalanngilaq	V	(no generation)
katagalavoq	V	(no generation)
katagaqarpoq	V	(no generation)
katagarpaa	V	(no generation)
katagarpoq	V	(no generation)
katajaalluinnarpoq	V	(no generation)
katajaappoq	V	(no generation)
katajavoq	V	(no generation)
kata¦k	N	–ap, –at
katakkiartorpoq	V	(no generation)
katall¦eq	N	–iup, –iit
katalogi	N	–p, –t
katannaveerpoq	V	(no generation)
katanne¦q	N	–rup, –rit
katanniku	N	–p, –t
katappaa	V	(no generation)
katappallappoq	V	(no generation)
katappoq	V	(no generation)
katariaannaavoq	V	(no generation)
katassimavaa	V	(no generation)
katassinnaavoq	V	(no generation)
katataavoq	V	(no generation)
katata¦q	N	–p, –t
katatsilerne¦q	N	–rup, –rit
kata¦tsilerneq	N	{–tsilernerup, –alernerup}, {–tsilernerit, –alernerit}
katatsine¦q	N	–rup, –rit
kata¦tsineq	N	{–anerup, –tsinerup}, {–anerit, –tsinerit}
katatsippaa	V	(no generation)
katatsivoq	V	(no generation)
katatt¦oq	N	–up, –ut
katattussaajunnaar¦sitsineq	N	{–sitsinerup, –titsinerup}, {–sitsinerit, –titsinerit}
katederi	N	–p, –t
katerilluarneqanngits¦oq	N	–up, –ut
katerinne¦q	N	–rup, –rit
kateri¦ppoq	V	–nngilaq
katerisaavoq	V	(no generation)
katerlaa¦q	N	–p, –t
katernaaffi¦k	N	–up, –it
katernaajuffi¦k	N	–up, –it
katernaajuvoq	V	(no generation)
katernaa¦q	N	–p, –t
katernaat	N, pl.	-
katernaavoq	V	(no generation)
katerngaaffi¦k	N	–up, –it
katerngaajuffi¦k	N	–up, –it
katerngaajuvoq	V	(no generation)
katerngaa¦q	N	–p, –t
katerngaavoq	V	(no generation)
katersaateqarfi¦k	N	–up, –it
katersannguutt¦oq	N	–up, –ut
Katersat	N, pl.	-
Katersat	Prop, pl.	-
katersat	N, pl.	-
katersigallarniarpoq	V	(no generation)
katersiinnarniarne¦q	N	–rup, –rit
katersine¦q	N	–rup, –rit
katersiniarne¦q	N	–rup, –rit
katersivoq	V	(no generation)
katersorfi¦k	N	–up, –it
katersorsimane¦q	N	–rup, –rit
katersortarfiit	N, pl.	-
katersortarfi¦k	N	–up, –it
katersueqatigiinne¦q	N	–rup, –rit
katersueqqinne¦q	N	–rup, –rit
katersugaasiveqarfi¦k	N	–up, –it
katersugaasiveqarne¦q	N	–rup, –rit
katersugaasiviit	N, pl.	-
katersugaasivi¦k	N	–up, –it
katersugaasivissu¦aq	N	–up, –it
katersugaat	N	–ip, –it
katersugaateqarfi¦k	N	–up, –it
katersu¦gaq	N	–kkap, –kkat
katersuiffigineqareersimas¦oq	N	–up, –ut
katersuiffi¦k	N	–up, –it
katersuine¦q	N	–rup, –rit
katersuiniarne¦q	N	–rup, –rit
katersuis¦oq	N	–up, –ut
katersuivoq	V	(no generation)
katersuuffi¦k	N	–up, –it
katersuuffissa¦q	N	–p, –t
katersuunne¦q	N	–rup, –rit
katersuussinnaatitaane¦q	N	–rup, –rit
katersuuttarfi¦k	N	–up, –it
katersuuttarfissu¦aq	N	–up, –it
kateruserne¦q	N	–rup, –rit
katerusertitaane¦q	N	–rup, –rit
katerusertitsine¦q	N	–rup, –rit
katiffi¦k	N	–up, –it
katiffissiorfi¦k	N	–up, –it
katiffiss¦iorfik	N	{–iorfiup, –aliorfiup}, {–iorfiit, –aliorfiit}
katiffissiorpoq	V	(no generation)
katiguffi¦k	N	–up, –it
katigunneqarsinnaas¦oq	N	–up, –ut
katiguppoq	V	(no generation)
katikkusutt¦oq	N	–up, –ut
katinne¦q	N	–rup, –rit
katinneqart¦oq	N	–up, –ut
katinngassutaas¦oq	N	–up, –ut
katinngat	N	–ip, –it
katinngataavoq	V	(no generation)
katinngavoq	V	(no generation)
katippaa	V	(no generation)
kati¦ppoq	V	–nngilaq
katisimaffi¦k	N	–up, –it
katisimajartorpoq	V	(no generation)
katisimasarfi¦k	N	–up, –it
katisimmavi¦k	N	–up, –it
katissamaarne¦q	N	–rup, –rit
katissamaarpoq	V	(no generation)
katissimane¦q	N	–rup, –rit
katissimanngits¦oq	N	–up, –ut
katissinnaanngort¦oq	N	–up, –ut
katissut	N	–ip, –it
katitaane¦q	N	–rup, –rit
katitaavoq	V	(no generation)
katita¦q	N	–p, –t
katitassa¦q	N	–p, –t
katiterine¦q	N	–rup, –rit
katiterisarne¦q	N	–rup, –rit
katiterisart¦oq	N	–up, –ut
katiterivoq	V	(no generation)
katiterneqarne¦q	N	–rup, –rit
katit¦erneqarneq	N	{–erneqarnerup, –serneqarnerup}, {–erneqarnerit, –serneqarnerit}
katiterneqarsinnaas¦oq	N	–up, –ut
katit¦erneqarsinnaasoq	N	{–erneqarsinnaasup, –serneqarsinnaasup}, {–erneqarsinnaasut, –serneqarsinnaasut}
katiterpaa	V	(no generation)
katitigaalluarne¦q	N	–rup, –rit
katit¦igaalluarneq	N	{–igaalluarnerup, –sigaalluarnerup}, {–igaalluarnerit, –sigaalluarnerit}
katitigaallu¦innartoq	N	{–aannartup, –innartup}, {–aannartut, –innartut}
katit¦igaalluinnartoq	N	{–igaalluaannartup, –igaalluinnartup, –sigaalluaannartup, –sigaalluinnartup}, {–igaalluaannartut, –igaalluinnartut, –sigaalluaannartut, –sigaalluinnartut}
katitigaane¦q	N	–rup, –rit
katit¦igaaneq	N	{–igaanerup, –sigaanerup}, {–igaanerit, –sigaanerit}
katitigaanerpaa¦q	N	–p, –t
katit¦igaanerpaaq	N	{–igaanerpaap, –sigaanerpaap}, {–igaanerpaat, –sigaanerpaat}
katitigaanngits¦oq	N	–up, –ut
katit¦igaanngitsoq	N	{–igaanngitsup, –sigaanngitsup}, {–igaanngitsut, –sigaanngitsut}
katitinneqarsinnaas¦oq	N	–up, –ut
kati¦tinneqarsinnaasoq	N	{–sinneqarsinnaasup, –tinneqarsinnaasup, –tsinneqarsinnaasup}, {–sinneqarsinnaasut, –tinneqarsinnaasut, –tsinneqarsinnaasut}
katitippaa	V	(no generation)
katititaane¦q	N	–rup, –rit
kati¦titaaneq	N	{–sitaanerup, –titaanerup, –tsitaanerup}, {–sitaanerit, –titaanerit, –tsitaanerit}
katititaaqqinne¦q	N	–rup, –rit
kati¦titaaqqinneq	N	{–sitaaqqinnerup, –titaaqqinnerup, –tsitaaqqinnerup}, {–sitaaqqinnerit, –titaaqqinnerit, –tsitaaqqinnerit}
katititsine¦q	N	–rup, –rit
kati¦titsineq	N	{–sitsinerup, –titsinerup, –tsitsinerup}, {–sitsinerit, –titsinerit, –tsitsinerit}
katititsis¦oq	N	–up, –ut
kati¦titsisoq	N	{–sitsisup, –titsisup, –tsitsisup}, {–sitsisut, –titsisut, –tsitsisut}
katititsivoq	V	(no generation)
katitsillaqqippoq	V	(no generation)
katitsilluarpoq	V	(no generation)
katitsine¦q	N	–rup, –rit
katitsivoq	V	(no generation)
katittorsiorfi¦k	N	–up, –it
katittorsiorne¦q	N	–rup, –rit
katittorsiut	N	–ip, –it
katittunii¦ppoq	V	–nngilaq
katittussa¦q	N	–p, –t
katittussat	N, pl.	-
katsori¦k	N	–up, –it
katsorilluinnarpoq	V	(no generation)
katsorippoq	V	(no generation)
katsorissu¦aq	N	–up, –it
katsorissuuvoq	V	(no generation)
katsorluinnanngilaq	V	(no generation)
katsorna	Interj	(no generation)
katsornanngu¦aq	N	–up, –it
katsorpoq	V	(no generation)
katsorsaane¦q	N	–rup, –rit
katsorsaaserpaa	V	(no generation)
katsorsaasiort¦oq	N	–up, –ut
katsorsaa¦siortoq	N	{–siortup, –tiliortup}, {–siortut, –tiliortut}
katsorsaas¦oq	N	–up, –ut
katsorsaat	N	–ip, –it
katsorsaa¦vik	N	{–ffiup, –viup}, {–ffiit, –viit}
katsorsaavoq	V	(no generation)
katsorsagaane¦q	N	–rup, –rit
katsorsarneqarsinnaanngits¦oq	N	–up, –ut
katsorsarneqarsinnaas¦oq	N	–up, –ut
katsorsartinnart¦oq	N	–up, –ut
katsorsarti¦ttut	N, pl.	{–ttut, –ssut}
katsorsaruminaats¦oq	N	–up, –ut
katsuakippoq	V	(no generation)
katsu¦aq	N	–up, –it
katsuart¦ooq	N	–uup, –uut
katsungaanne¦q	N	–rup, –rit
katsungaappoq	V	(no generation)
katsungaariarpoq	V	(no generation)
katsungaarsorpoq	V	(no generation)
katsungaaserpoq	V	(no generation)
katsungaats¦oq	N	–up, –ut
katsunngilaq	V	(no generation)
kattaku	N	–p, –t
kattariunngilaq	V	(no generation)
Kattegat	Prop	–ip
kattuffi¦k	N	–up, –it
kattunne¦q	N	–rup, –rit
kattunneqarsinnaas¦oq	N	–up, –ut
kattuppaa	V	(no generation)
kattuppoq	V	(no generation)
kattusimas¦oq	N	–up, –ut
kattusimassut	N	–ip, –it
kattussaavoq	V	(no generation)
kattussa¦q	N	–p, –t
kattusseqatigiinne¦q	N	–rup, –rit
kattusseqatigiit	N, pl.	-
kattussine¦q	N	–rup, –rit
kattut	N	–ip, –it
kattutassaanngits¦oq	N	–up, –ut
kattutissa¦q	N	–p, –t
kattuttut	N, pl.	-
katu	N	–p, –t
katuaat	N	–ip, –it
katua¦q	N	–p, –t
katuarne¦q	N	–rup, –rit
katuarpaa	V	(no generation)
katuarpoq	V	(no generation)
katugulluarpaa	V	(no generation)
katugulluarpoq	V	(no generation)
katuguppaa	V	(no generation)
katuguppoq	V	(no generation)
katugut¦sitsineq	N	{–itsinerup, –sitsinerup}, {–itsinerit, –sitsinerit}
katuppaa	V	(no generation)
katussine¦q	N	–rup, –rit
katuul¦eq	N	–lip, –lit
katuulinngortitsiniart¦oq	N	–up, –ut
katuulius¦oq	N	–up, –ut
katuuliussu¦seq	N	–tsip, –tsit
katuut	N	–ip, –it
Kaukasus	Prop	–ip
kavaajak¦oq	N	–up, –ut
kavaajaliuuppaa	V	(no generation)
kavaaja¦q	N	–p, –t
kavaajarissaarpoq	V	(no generation)
kavaajarsu¦aq	N	–up, –it
kavaajartaarpoq	V	(no generation)
kavasappaa	V	(no generation)
kavasserpoq	V	(no generation)
kavassisaarpoq	V	(no generation)
kavassisaarumatoqaaq	V	(no generation)
keeq	Interj	(no generation)
keeqqane¦q	N	–rup, –rit
keeriaavoq	V	(no generation)
keeriarpaa	V	(no generation)
keeriarsaraa	V	(no generation)
keeriartuusaarpaa	V	(no generation)
keerpoq	V	(no generation)
keersagaavoq	V	(no generation)
keeruillivoq	V	(no generation)
keeruippoq	V	(no generation)
keerujussuarne¦q	N	–rup, –rit
keeruppoq	V	(no generation)
kemi	N	{–ip, –p}, {–it, –t}
kemikalia	N	–p, –t
kemiker	N	–ip, –it
Kenya	Prop	–p
keqqasoorpoq	V	(no generation)
keqqavoq	V	(no generation)
Kertemindemioq	N	(no generation)
Kerteminde¦miu	N	{–miup, –rmiup}, {–miut, –rmiut}
kerubi	N	–p, –t
kg	N	(no generation)
kiaallagaa	V	(no generation)
kiaallappoq	V	(no generation)
kiaallatsippaa	V	(no generation)
kiaarukkiartorpoq	V	(no generation)
kiaarunnavianngilaq	V	(no generation)
kiaaruppoq	V	(no generation)
kiaasappoq	V	(no generation)
kiagukkaluttuinnarpoq	V	(no generation)
kiagukkunnaarpoq	V	(no generation)
kiagulerpoq	V	(no generation)
kiagunnart¦oq	N	–up, –ut
kiagunne¦q	N	–rup, –rit
kiaguppoq	V	(no generation)
kiagussaat	N	–ip, –it
kiagussaataas¦oq	N	–up, –ut
kiagussarippoq	V	(no generation)
kiagutt¦oq	N	–up, –ut
kiaguusappoq	V	(no generation)
kia¦k	N	–ap, –at
kiakkernart¦oq	N	–up, –ut
kiakkernert¦ooq	N	–uup, –uut
kiakkerpoq	V	(no generation)
kiakkertarne¦q	N	–rup, –rit
kiakkiuppaa	V	(no generation)
kiakkortuvoq	V	(no generation)
kialaarpoq	V	(no generation)
kialaart¦oq	N	–up, –ut
kialaartuannguarpoq	V	(no generation)
kialaassu¦seq	N	–tsip, –tsit
kiallarpoq	V	(no generation)
kiallerpoq	V	(no generation)
kiallersimavoq	V	(no generation)
kiammiuvoq	V	(no generation)
kianissaatsia¦q	N	–ap, –at
kianneeruppoq	V	(no generation)
kianne¦q	N	–rup, –rit
kiannerpaa¦ffik	N	{–ffiup, –juffiup}, {–ffiit, –juffiit}
kiannersaavoq	V	(no generation)
kiannersu¦aq	N	–up, –it
kiannert¦ooq	N	–uup, –uut
kiannerulerpoq	V	(no generation)
kianngaalu¦k	N	–up, –it
kiannga¦q	N	–p, –t
kianngarpasippoq	V	(no generation)
kianngarpoq	V	(no generation)
kianngarsu¦aq	N	–up, –it
kiapequserpoq	V	(no generation)
kiapequt	N	–ip, –it
kiapequt	N, pl.	-
kiapequtaaruppoq	V	(no generation)
kiapequtaavoq	V	(no generation)
kiapersorfigaa	V	(no generation)
kiapersorpoq	V	(no generation)
kiappallaaqaaq	V	(no generation)
kiappallaart¦oq	N	–up, –ut
kiappersorpoq	V	(no generation)
kiappoq	V	(no generation)
kiaqarne¦q	N	–rup, –rit
kiaqarpoq	V	(no generation)
kiaqarunnaar¦saat	N	{–saatip, –taatip}, {–saatit, –taatit}
kiaqassu¦seq	N	–tsip, –tsit
kiaqutaavoq	V	(no generation)
kia¦sik	N	–tsip, –tsit
kiasissorpoq	V	(no generation)
kiasiusa¦q	N	–p, –t
kiassaane¦q	N	–rup, –rit
kiassaaserpaa	V	(no generation)
kiassaas¦oq	N	–up, –ut
kiassaat	N	–ip, –it
kiassaataalaarpoq	V	(no generation)
kiassaateqarfi¦k	N	–up, –it
kiassaa¦tilerisoq	N	{–serisup, –tilerisup}, {–serisut, –tilerisut}
kiassarippoq	V	(no generation)
kiassarissivoq	V	(no generation)
kiassariss¦oq	N	–up, –ut
kiassari¦ssoq	N	{–ssup, –ttup}, {–ssut, –ttut}
kiassarivippoq	V	(no generation)
kiassiut	N	–ip, –it
kiassu¦aq	N	–up, –it
kiassu¦seq	N	–tsip, –tsit
kiassuseqartitsissut	N	–ip, –it
kiat	N	–ip, –it
kiataanna¦q	N	–ap, –at
kiat¦aannaq	N	{–aannaap, –iinnaap}, {–aannaat, –iinnaat}
kiataarsinaqaaq	V	(no generation)
kiataarsivoq	V	(no generation)
kiataavoq	V	(no generation)
kiata¦q	N	–p, –t
Kiatassu¦aq	N	–up, –it
kiatikippoq	V	(no generation)
kiatikits¦oq	N	–up, –ut
kiatituvoq	V	(no generation)
kiatseruttorpoq	V	(no generation)
kiatsikkaluttuinnarpoq	V	(no generation)
kiatsippaa	V	(no generation)
kiatsi¦ppoq	V	–nngilaq
kiatta¦gaq	N	–kkap, –kkat
kiattarpaa	V	(no generation)
kiatt¦oq	N	–up, –ut
kiattormiu	N	–p, –t
kiattorsu¦aq	N	–up, –it
kiattorujussu¦usoq	N	{–aasup, –usup}, {–aasut, –usut}
kiattulersorpoq	V	(no generation)
kiattuliorpoq	V	(no generation)
kiavippoq	V	(no generation)
kiffaajunnaarpoq	V	(no generation)
kiffaajunnaarsippaa	V	(no generation)
kiffaajunnaarsitaane¦q	N	–rup, –rit
kiffaajunnaar¦sitaaneq	N	{–sitaanerup, –titaanerup}, {–sitaanerit, –titaanerit}
kiffaajunnaarsitaasimas¦oq	N	–up, –ut
kiffaajunnaar¦sitaasimasoq	N	{–sitaasimasup, –titaasimasup}, {–sitaasimasut, –titaasimasut}
kiffaajunnaarsitaas¦oq	N	–up, –ut
kiffaajunnaar¦sitaasoq	N	{–sitaasup, –titaasup}, {–sitaasut, –titaasut}
kiffaanngilaq	V	(no generation)
kiffaanngissu¦seq	N	–tsip, –tsit
kiffaanngissusiiagaane¦q	N	–rup, –rit
kiffaanngits¦oq	N	–up, –ut
kiffaassu¦seq	N	–tsip, –tsit
kiffaavoq	V	(no generation)
kiffakatta¦q	N	–p, –t
kiffalu¦gaq	N	–kkap, –kkat
kiffaluka¦q	N	–p, –t
kiffanngortitaane¦q	N	–rup, –rit
kiffa¦q	N	–p, –t
kiffaqat	N	–ip, –it
kiffaraa	V	(no generation)
kiffariti¦ppoq	V	–nngilaq
kiffartorfigaa	V	(no generation)
kiffartorfi¦k	N	–up, –it
kiffar¦torfik	N	{–sorfiup, –torfiup}, {–sorfiit, –torfiit}
kiffartorne¦q	N	–rup, –rit
kiffar¦torneq	N	{–sornerup, –tornerup}, {–sornerit, –tornerit}
kiffartorpoq	V	(no generation)
kiffartortigaa	V	(no generation)
kiffartort¦oq	N	–up, –ut
kiffar¦tortoq	N	{–sortup, –tortup}, {–sortut, –tortut}
kiffartorumat¦ooq	N	–uup, –uut
kiffar¦torumatooq	N	{–sorumatuup, –torumatuup}, {–sorumatuut, –torumatuut}
kiffartuunneqarne¦q	N	–rup, –rit
kiffartuuppaa	V	(no generation)
kiffartuussilluarpoq	V	(no generation)
kiffartuussine¦q	N	–rup, –rit
kiffartuussisinnaassu¦seq	N	–tsip, –tsit
kiffartuussis¦oq	N	–up, –ut
kiffartuussissut	N	–ip, –it
kiffartuussi¦ssut	N, pl.	{–ssut, –ttut}
kiffartuussiumatuallaart¦oq	N	–up, –ut
kiffartuussiumatussu¦seq	N	–tsip, –tsit
kiffartuussi¦vik	N	{–ffiup, –viup}, {–ffiit, –viit}
kiffartuussivoq	V	(no generation)
kiffartuut	N	–ip, –it
kiffartuut	N, pl.	-
kiffartuutigaa	V	(no generation)
kiffassarsiaraa	V	(no generation)
kiffassarsine¦q	N	–rup, –rit
kiffattaat	N	–ip, –it
kiffattaavoq	V	(no generation)
kiffatta¦q	N	–p, –t
kiffattarpaa	V	(no generation)
kiffiaalluarne¦q	N	–rup, –rit
kiffiaalluarpoq	V	(no generation)
kiffiaane¦q	N	–rup, –rit
kiffiaavoq	V	(no generation)
kiffiagaavoq	V	(no generation)
kiffia¦gaq	N	–kkap, –kkat
kiffiaqqippaa	V	(no generation)
kiffiaqqissaarpaa	V	(no generation)
kiffiarpaa	V	(no generation)
kiffiarsimas¦oq	N	–up, –ut
kiffigaa	V	(no generation)
kiffi¦k	N	–up, –it
kiffissia¦q	N	–p, –t
kiffiuppaa	V	(no generation)
kiffiussivoq	V	(no generation)
kiffiut	N	–ip, –it
kiffiutigaa	V	(no generation)
kiffiutippaa	V	(no generation)
kiffiutissa¦q	N	–p, –t
kigaalaarpoq	V	(no generation)
kigaalaartippaa	V	(no generation)
kigaalaartitsine¦q	N	–rup, –rit
kigaalaniarpoq	V	(no generation)
kigaalaqutaavoq	V	(no generation)
kigaalavallaaqaaq	V	(no generation)
kigaallakkaluttuinnarpoq	V	(no generation)
kigaallakkiartorpoq	V	(no generation)
kigaallappoq	V	(no generation)
kigaallassaaserpaa	V	(no generation)
kigaallassaat	N	–ip, –it
kigaallassaataas¦oq	N	–up, –ut
kigaallatsippaa	V	(no generation)
kigaallatsitsine¦q	N	–rup, –rit
kigaalliallappoq	V	(no generation)
kigaallisaarpoq	V	(no generation)
kigaallisaarutigaa	V	(no generation)
kigaallivoq	V	(no generation)
kigaappallaanngilaq	V	(no generation)
kigaappoq	V	(no generation)
kigaaquserpaa	V	(no generation)
kigaaqut	N	–ip, –it
kigaaqutaavoq	V	(no generation)
kigaarnart¦oq	N	–up, –ut
kigaarne¦q	N	–rup, –rit
kigaarpoq	V	(no generation)
kigaartippaa	V	(no generation)
kigaassu¦seq	N	–tsip, –tsit
kigaats¦oq	N	–up, –ut
kigaja¦q	N	–p, –t
kigalavoq	V	(no generation)
kigannga¦q	N	–p, –t
kiganngarpoq	V	(no generation)
kiganngarsu¦aq	N	–up, –it
kigarne¦q	N	–rup, –rit
kigarpaa	V	(no generation)
kigarpoq	V	(no generation)
kigarsimas¦oq	N	–up, –ut
kigartornil¦ik	N	{–iup, –lip, –lup}, –lit
kigartorpaa	V	(no generation)
kigartu¦gaq	N	–kkap, –kkat
kigartuisart¦oq	N	–up, –ut
kigartuis¦oq	N	–up, –ut
kigartui¦ssut	N	{–ssutip, –ssut, –ttut}, –ssutit
kigartuivoq	V	(no generation)
kigartuusiorpoq	V	(no generation)
kigartuut	N	–ip, –it
kigarukkiartorpoq	V	(no generation)
kigaru¦ppoq	V	–nngilaq
kigerpaa	V	(no generation)
kigganngu¦aq	N	–up, –it
kigga¦q	N	–p, –t
kiggaqart¦oq	N	–up, –ut
kigg¦eq	N	–ip, –it
kiggeqqut	N	–ip, –it
kiggeqqutisivoq	V	(no generation)
kiggeqqutitaarpoq	V	(no generation)
kiggequt	N, pl.	-
kiggersu¦aq	N	–up, –it
kiggert¦ooq	N	–uup, –uut
kiggi¦aq	N	–ssap, –ssat
kiggiguppaa	V	(no generation)
kiggigussa¦q	N	–p, –t
kiggippaa	V	(no generation)
kiggippoq	V	(no generation)
kiggisippaa	V	(no generation)
kiggisitsivoq	V	(no generation)
kiggissa¦q	N	–p, –t
kiggis¦simasoq	N	{–imasup, –simasup}, {–imasut, –simasut}
kiggitsivoq	V	(no generation)
kiggi¦ttaat	N	{–ssaatip, –ttaatip}, {–ssaatit, –ttaatit}
kiggumi¦aq	N	–ssap, –ssat
kiggumiarpaa	V	(no generation)
kiggumisserpaa	V	(no generation)
kiggumissiuppaa	V	(no generation)
kiggumissiussivoq	V	(no generation)
kigguppaa	V	(no generation)
kiggussaavoq	V	(no generation)
kiggussa¦q	N	–p, –t
kiginnart¦oq	N	–up, –ut
kigippoq	V	(no generation)
kigorpoq	V	(no generation)
kigungakaappaa	V	(no generation)
kigungakaassivoq	V	(no generation)
kigungakarpoq	V	(no generation)
kigunnaappaa	V	(no generation)
kigunnarpoq	V	(no generation)
kigu¦serfik	N	{–serfiup, –tilerfiup}, {–serfiit, –tilerfiit}
kigu¦serfilunneq	N	{–serfilunnerup, –tilerfilunnerup}, {–serfilunnerit, –tilerfilunnerit}
kiguserfiluppoq	V	(no generation)
kiguserfinnguvoq	V	(no generation)
kiguserigajuppoq	V	(no generation)
kiguserine¦q	N	–rup, –rit
kigu¦serineq	N	{–serinerup, –tilerinerup}, {–serinerit, –tilerinerit}
kiguserisaannarpoq	V	(no generation)
kiguserivoq	V	(no generation)
kiguserpaa	V	(no generation)
kigusine¦q	N	–rup, –rit
kigusiort¦oq	N	–up, –ut
kigu¦siortoq	N	{–siortup, –tiliortup}, {–siortut, –tiliortut}
kigusivoq	V	(no generation)
kigussu¦aq	N	–up, –it
kigut	N	–ip, –it
kigutaarnanippoq	V	(no generation)
kigutaarna¦q	N	–p, –t
kigutaarnartorpoq	V	(no generation)
kigutaarpaa	V	(no generation)
kigutaarpoq	V	(no generation)
kigutaarsine¦q	N	–rup, –rit
kigutaarsinne¦q	N	–rup, –rit
kigutaarsippoq	V	(no generation)
kigutaarsissut	N	–ip, –it
kigutaarsi¦ssut	N, pl.	{–ssut, –ttut}
kigutaartinne¦q	N	–rup, –rit
kigutaasa¦q	N	–p, –t
kigutaasaqart¦oq	N	–up, –ut
kigutaasat	N, pl.	-
kigutaats¦oq	N	–up, –ut
kiguteqanngits¦oq	N	–up, –ut
kiguterpaluk	N	–up, –it
kigutigissaane¦q	N	–rup, –rit
kigutigissaas¦oq	N	–up, –ut
kigutigi¦ssaat	N	{–ssaatip, –ttaatip}, {–ssaatit, –ttaatit}
kigutigi¦ssaatit	N, pl.	{–ssaatit, –ttaatit}
kigutigissarne¦q	N	–rup, –rit
kigutigi¦ssarneq	N	{–ssarnerup, –ttarnerup}, {–ssarnerit, –ttarnerit}
kigutigissarpoq	V	(no generation)
kigutigissartinne¦q	N	–rup, –rit
kigutigi¦ssuuneq	N	{–ssuunerup, –ttuunerup}, {–ssuunerit, –ttuunerit}
kigutikippoq	V	(no generation)
kigutileriffi¦k	N	–up, –it
kigu¦tileriffik	N	{–seriffiup, –tileriffiup}, {–seriffiit, –tileriffiit}
kigutileris¦oq	N	–up, –ut
kigu¦tilerisoq	N	{–serisup, –tilerisup}, {–serisut, –tilerisut}
kigu¦tileritinneq	N	{–seritinnerup, –tileritinnerup}, {–seritinnerit, –tileritinnerit}
kigutil¦ik	N	{–iup, –lip, –lup}, –lit
kigutilissu¦aq	N	–up, –it
kigutil¦issuaq	N	{–ersuup, –issuup}, {–ersuit, –issuit}
kigutiliune¦q	N	–rup, –rit
kigutissaqannginne¦q	N	–rup, –rit
kigutissaqanngits¦oq	N	–up, –ut
kigutissat	N, pl.	-
kigutisserivoq	V	(no generation)
kigutitaalerne¦q	N	–rup, –rit
kigutitaaqqinne¦q	N	–rup, –rit
kigutitaarpoq	V	(no generation)
kiguunaqquppoq	V	(no generation)
kiguunaralaanngu¦aq	N	–up, –it
kii	Interj	(no generation)
kiiarne¦q	N	–rup, –rit
kiikiingavoq	V	(no generation)
ki¦ilu	N	{–ilup, –lup}, {–ilut, –lut}
kiinaalee¦raq	N	–qqap, –qqat
kiinaal¦ik	N	{–iup, –lip, –lup}, –lit
kiinaali¦saq	N	–tsap, –tsat
kiinaanngussutigaa	V	(no generation)
kiinaannguvoq	V	(no generation)
kiinaa¦q	N	–p, –t
kiinaarpaa	V	(no generation)
kiinaarpoq	V	(no generation)
kiinaarsivoq	V	(no generation)
kiinaaruppoq	V	(no generation)
kiinal¦ik	N	{–iup, –lip, –lup}, –lit
kiinanngujuippoq	V	(no generation)
kiinanngunaqaaq	V	(no generation)
kiinannguvoq	V	(no generation)
kiinapaju¦k	N	–up, –it
kiinappa¦k	N	–ap, –at
kiin¦aq	N	–nap, –nat
kiinaqanngilaq	V	(no generation)
kiinarippoq	V	(no generation)
kiinarlerpoq	V	(no generation)
kiinarluppoq	V	(no generation)
kiina¦roq	N	–qqup, –qqut
kiinarorippoq	V	(no generation)
kiinarorsivoq	V	(no generation)
kiinarpaat	N	–ip, –it
kiinarpaat	N, pl.	-
kiinarpa¦k	N	–ap, –at
kiinarpalerpoq	V	(no generation)
kiinarpalersorpoq	V	(no generation)
kiinarpaqanngits¦oq	N	–up, –ut
kiinarpassu¦aq	N	–up, –it
kiinarpoq	V	(no generation)
kiinarsiorpaa	V	(no generation)
kiinarsiorpoq	V	(no generation)
kiinarsisippaa	V	(no generation)
kiinarsivaa	V	(no generation)
kiinarsorne¦q	N	–rup, –rit
kiinar¦sorneq	N	{–sornerup, –tornerup}, {–sornerit, –tornerit}
kiinarsorpoq	V	(no generation)
kiinart¦ooq	N	–uup, –uut
kiine¦q	N	–rup, –rit
kiineqanngilaq	V	(no generation)
kiinersu¦aq	N	–up, –it
kiinnaavi¦k	N	–up, –it
kiinnaavoq	V	(no generation)
kiinnalluarpaa	V	(no generation)
kiinnappaa	V	(no generation)
kiinnarippoq	V	(no generation)
kiinnarissorsu¦aq	N	–up, –it
kiinnari¦ssorsuaq	N	{–ssorsuup, –ttorsuup}, {–ssorsuit, –ttorsuit}
kiinnarivippoq	V	(no generation)
kiinnarluppoq	V	(no generation)
kiinnassarippoq	V	(no generation)
kiinnatsippaa	V	(no generation)
kiinneraanngilaq	V	(no generation)
kiinneraarpoq	V	(no generation)
kiinneraarsinnaane¦q	N	–rup, –rit
kiinneraart¦oq	N	–up, –ut
kiinnerpoq	V	(no generation)
kiinnertarne¦q	N	–rup, –rit
kiioraasitsivoq	V	(no generation)
kiioraavoq	V	(no generation)
kiisa¦q	N	–p, –t
kiisarne¦q	N	–rup, –rit
kiisarpaa	V	(no generation)
kiisart¦oq	N	–up, –ut
kiisatua¦q	N	–p, –t
kiisigajuppoq	V	(no generation)
kiisilaarne¦q	N	–rup, –rit
kii¦silaarneq	N	{–silaarnerup, –tilaarnerup}, {–silaarnerit, –tilaarnerit}
kiisimavaa	V	(no generation)
kiisine¦q	N	–rup, –rit
kiisippaa	V	(no generation)
kiisisarpoq	V	(no generation)
kiisiumanngilaq	V	(no generation)
kiisiumatuvoq	V	(no generation)
kiisivoq	V	(no generation)
kiisoorpaa	V	(no generation)
kiisorne¦q	N	–rup, –rit
kiisorpoq	V	(no generation)
kiisort¦oq	N	–up, –ut
kiisortorsu¦aq	N	–up, –it
kiisortueruppoq	V	(no generation)
kiisortuusa¦q	N	–p, –t
kiisutorpaa	V	(no generation)
kiitiffi¦k	N	–up, –it
kii¦tiffik	N	{–tiffiup, –siffiup}, {–tiffiit, –siffiit}
kiiti¦ppoq	V	–nngilaq
kiitseriippoq	V	(no generation)
kiitserippoq	V	(no generation)
kiitserissivoq	V	(no generation)
kiitserluppoq	V	(no generation)
kiivaa	V	(no generation)
kiivoq	V	(no generation)
kikeerpoq	V	(no generation)
kikiaalatsivoq	V	(no generation)
kikiaa¦raq	N	–qqap, –qqat
kiki¦aat	N	{–aat, –ssat, –aatip}, –aatit
kikiaffi¦k	N	–up, –it
kikiaguppaa	V	(no generation)
kikiaguppoq	V	(no generation)
kikiagussa¦q	N	–p, –t
kikiagussine¦q	N	–rup, –rit
kiki¦ak	N	{–aap, –ssap}, {–aat, –ssat}
kikiannerluppaa	V	(no generation)
kikiappaa	V	(no generation)
kikiassaaleqivoq	V	(no generation)
kikia¦ssuaq	N	{–rsuup, –ssuup}, {–rsuit, –ssuit}
kikiattorpaa	V	(no generation)
kikiattorpoq	V	(no generation)
kikiattugaas¦oq	N	–up, –ut
kikia¦ttugaasoq	N	{–ssugaasup, –ttugaasup, –tugaasup}, {–ssugaasut, –ttugaasut, –tugaasut}
kikiattu¦gaq	N	–kkap, –kkat
kikia¦ttugaq	N	{–ssukkap, –ttukkap, –tukkap}, {–ssukkat, –ttukkat, –tukkat}
kikiattuiffigaa	V	(no generation)
kikiattuivoq	V	(no generation)
kikiattuuffigaa	V	(no generation)
kikiattuuppaa	V	(no generation)
kikiattuussine¦q	N	–rup, –rit
kikiingavoq	V	(no generation)
kikine¦q	N	–rup, –rit
kikisa¦q	N	–p, –t
kikisimas¦oq	N	–up, –ut
kikisserpaa	V	(no generation)
kikissersorpaa	V	(no generation)
kikissiuppaa	V	(no generation)
kikivaa	V	(no generation)
kikivoq	V	(no generation)
kikkaane¦q	N	–rup, –rit
kikkaas¦oq	N	–up, –ut
kikkaavoq	V	(no generation)
kikka¦gaq	N	–kkap, –kkat
kikkaluppoq	V	(no generation)
kikkarpaa	V	(no generation)
kikkarpoq	V	(no generation)
kikkarsimas¦oq	N	–up, –ut
kikkiik	Interj	(no generation)
kikkik	Interj	(no generation)
kikku	Pron, pl.	–a
kikkul¦eq	N	–ip, –it
kikkulersaarpoq	V	(no generation)
kikkuliartaarpoq	V	(no generation)
kikkulluunniit	Pron, pl.	-
kikkuts¦eq	N	–ip, –it
kilaarsaaserpaa	V	(no generation)
kilaarsaat	N	–ip, –it
kilaarserfi¦k	N	–up, –it
kilaat	N	–ip, –it
kila¦k	N	–ap, –at
kilanne¦q	N	–rup, –rit
kilappaa	V	(no generation)
kilappoq	V	(no generation)
kilatt¦oq	N	–up, –ut
kilavippoq	V	(no generation)
kilerne¦q	N	–rup, –rit
kiler¦neq	N	{–nerup, –rnup}, {–nerit, –rnit}
kilerpaa	V	(no generation)
kilerpoq	V	(no generation)
kilersiterpaa	V	(no generation)
kilertiterpoq	V	(no generation)
kiliffa¦k	N	–ap, –at
kiligaasiorpoq	V	(no generation)
kiligaat	N	–ip, –it
kili¦gaq	N	–kkap, –kkat
kiligarpoq	V	(no generation)
kiligartaavoq	V	(no generation)
kiline¦q	N	–rup, –rit
kilinne¦q	N	–rup, –rit
kilinngavoq	V	(no generation)
kiliorpaa	V	(no generation)
kiliorpoq	V	(no generation)
kiliortinne¦q	N	–rup, –rit
kiliortorpaa	V	(no generation)
kiliortugaane¦q	N	–rup, –rit
kiliortuine¦q	N	–rup, –rit
kiliortuivoq	V	(no generation)
kiliortuusiorpoq	V	(no generation)
kiliortuut	N	–ip, –it
kilippaa	V	(no generation)
kilippoq	V	(no generation)
kilisaaserpoq	V	(no generation)
kilisaat	N	–ip, –it
kilisaatit	N, pl.	-
kilisaavoq	V	(no generation)
kilisaffigaa	V	(no generation)
kilisaffiginninne¦q	N	–rup, –rit
kilisappaa	V	(no generation)
kilisappoq	V	(no generation)
kilissut	N	–ip, –it
kilissut	N, pl.	-
kili¦ssut	N, pl.	{–ssut, –ttut}
kilita¦q	N	–p, –t
kilitarsu¦aq	N	–up, –it
kiliterivoq	V	(no generation)
kiliterpaa	V	(no generation)
kiliterut	N	–ip, –it
kilitsi	N	–p, –t
kilitsigaa	V	(no generation)
kilitsippaa	V	(no generation)
kilitsis¦oq	N	–up, –ut
kilitsissa¦q	N	–p, –t
kilitsissiaane¦q	N	–rup, –rit
kilitsissia¦q	N	–p, –t
kilitsissiaraa	V	(no generation)
kilitsivigaa	V	(no generation)
kilitsivoq	V	(no generation)
kilittoortippaa	V	(no generation)
kiliu¦gaq	N	–kkap, –kkat
kiliugassa¦q	N	–p, –t
kiliuivoq	V	(no generation)
kiliut	N	–ip, –it
kiliutaarserpoq	V	(no generation)
kiliutaaruppoq	V	(no generation)
kiliut¦aq	N	{–ap, –tap}, {–at, –tat}
killaagut	N	–ip, –it
killaagutaarserpoq	V	(no generation)
killaagutissia¦q	N	–p, –t
killaarivoq	V	(no generation)
killaarne¦q	N	–rup, –rit
killaarpaa	V	(no generation)
killaarpoq	V	(no generation)
killaarut¦issaasivik	N	{–issaasiviup, –sissaasiviup}, {–issaasiviit, –sissaasiviit}
killalaarpoq	V	(no generation)
killa¦q	N	–p, –t
killaserpoq	V	(no generation)
killavaal¦ik	N	{–iup, –lip, –lup}, –lit
killavaaliorpoq	V	(no generation)
killavaa¦q	N	–p, –t
killavaarpaa	V	(no generation)
killavaarpoq	V	(no generation)
killavaart¦ooq	N	–uup, –uut
killavaart¦oq	N	–up, –ut
killavaat	N, pl.	-
killeeruppoq	V	(no generation)
killeerutiuippoq	V	(no generation)
kill¦eq	N	–iup, –iit
killeqaannarpoq	V	(no generation)
killeqanngilaq	V	(no generation)
killeqanngisaarpoq	V	(no generation)
killeqanngisaarut	N	–ip, –it
killeqanngissu¦seq	N	–tsip, –tsit
killeqanngits¦oq	N	–up, –ut
killeqarfi¦k	N	–up, –it
killeqarne¦q	N	–rup, –rit
killeqarpoq	V	(no generation)
killeqartitsis¦oq	N	–up, –ut
killeqart¦oq	N	–up, –ut
killeqquppaa	V	(no generation)
killeqquppoq	V	(no generation)
killeqqussivoq	V	(no generation)
killeqqutiinnarpaa	V	(no generation)
killeqqutsivoq	V	(no generation)
killeraa	V	(no generation)
killeraane¦q	N	–rup, –rit
killeraavoq	V	(no generation)
killerarpaa	V	(no generation)
killerippoq	V	(no generation)
killermii¦ppoq	V	–nngilaq
killerpaa	V	(no generation)
killersaavoq	V	(no generation)
killersorpaa	V	(no generation)
killia¦q	N	–p, –t
killiaquserpaa	V	(no generation)
killiaqut	N	–ip, –it
killiaterpoq	V	(no generation)
killiavoq	V	(no generation)
killiffigaa	V	(no generation)
killiffi¦k	N	–up, –it
killiffilersuine¦q	N	–rup, –rit
killiffilersuut	N	–ip, –it
killiffiler¦suut	N	{–suutip, –tuutip}, {–suutit, –tuutit}
killiffilersuutit	N, pl.	-
killiffiler¦suutit	N, pl.	{–suutit, –tuutit}
killiffissa¦q	N	–p, –t
killigaa	V	(no generation)
killigassaanngissu¦seq	N	–tsip, –tsit
killigassaanngits¦oq	N	–up, –ut
killigisa¦q	N	–p, –t
killigitita¦q	N	–p, –t
killiisaarpoq	V	(no generation)
Killiit	N, pl.	-
Killiit	Prop, pl.	-
Killi¦it	N, pl.	{–it, –ngit}
killiit	N, pl.	-
killi¦it	N, pl.	{–it, –ngit}
killiivoq	V	(no generation)
killi¦k	N	{–ngup, –up}, {–it, –ngit}
killikkuminaappoq	V	(no generation)
killilerpaa	V	(no generation)
killilersorpaa	V	(no generation)
killilersuiffigisaalerne¦q	N	–rup, –rit
killilersuine¦q	N	–rup, –rit
killiligaane¦q	N	–rup, –rit
killiliiffigineqarne¦q	N	–rup, –rit
killiliine¦q	N	–rup, –rit
killiliisinnaane¦q	N	–rup, –rit
killiliis¦oq	N	–up, –ut
killiliissut	N	–ip, –it
killiliivoq	V	(no generation)
killil¦ik	N	{–iup, –lip, –lup}, –lit
killiliussa¦q	N	–p, –t
Killin¦eq	Prop	–iup, –iit
Kill¦ineq	N	–ernup, –ernit
killingaarpaa	V	(no generation)
killi¦nganiittoq	N	{–aniittup, –nganiittup}, {–aniittut, –nganiittut}
killingerpaa	V	(no generation)
killingerpoq	V	(no generation)
killingiussaarippoq	V	(no generation)
killingiussaarissivoq	V	(no generation)
killingusaa¦q	N	–p, –t
killinnaqaaq	V	(no generation)
killinnarpoq	V	(no generation)
killinnart¦oq	N	–up, –ut
killinnartorsuuvoq	V	(no generation)
killinnartulia¦q	N	–p, –t
killinneqangaarne¦q	N	–rup, –rit
killinneqanngits¦oq	N	–up, –ut
killinneqarne¦q	N	–rup, –rit
killinneqarsinnaanngissu¦seq	N	–tsip, –tsit
killinneqart¦oq	N	–up, –ut
killinneqassu¦seq	N	–tsip, –tsit
killinniarpaa	V	(no generation)
killippaa	V	(no generation)
killippoq	V	(no generation)
killisaaserpaa	V	(no generation)
killisaat	N	–ip, –it
killiserrarippoq	V	(no generation)
killisimaarnaqaaq	V	(no generation)
killisimaarpoq	V	(no generation)
killisimaartitsivoq	V	(no generation)
killisimaart¦oq	N	–up, –ut
killis¦imaartoq	N	{–imaartup, –simaartup}, {–imaartut, –simaartut}
killisimanart¦oq	N	–up, –ut
killisiorfi¦k	N	–up, –it
killisiorneqarne¦q	N	–rup, –rit
killisiorpaa	V	(no generation)
killisiortiffi¦k	N	–up, –it
killisiorti¦ppoq	V	–nngilaq
killisissaanngilaq	V	(no generation)
killisissaanngits¦oq	N	–up, –ut
killisiueqqissaarne¦q	N	–rup, –rit
killisiueqqissaart¦oq	N	–up, –ut
killisiugaane¦q	N	–rup, –rit
killisiuine¦q	N	–rup, –rit
killisiuis¦oq	N	–up, –ut
killisiuivoq	V	(no generation)
killisiutigaa	V	(no generation)
killisivaa	V	(no generation)
killissaanngilaq	V	(no generation)
killissaanngilluinnarpoq	V	(no generation)
killissaannginne¦q	N	–rup, –rit
killissaanngissu¦seq	N	–tsip, –tsit
killissaanngits¦oq	N	–up, –ut
killissaavoq	V	(no generation)
killissalerpaa	V	(no generation)
killissaliine¦q	N	–rup, –rit
killissaliussa¦q	N	–p, –t
killissa¦q	N	–p, –t
killissarippoq	V	(no generation)
killissaritita¦q	N	–p, –t
killisseriippoq	V	(no generation)
killisseriits¦oq	N	–up, –ut
killitsias¦oq	N	–up, –ut
killitsiassu¦seq	N	–tsip, –tsit
killitsiavoq	V	(no generation)
killitsinnart¦oq	N	–up, –ut
killi¦tsinnartoq	N	{–ssinnartup, –tsinnartup}, {–ssinnartut, –tsinnartut}
killitsi¦ppoq	V	–nngilaq
killius¦oq	N	–up, –ut
killiuvoq	V	(no generation)
kill¦oq	N	–orup, {–orit, –ut}
killoqarfi¦k	N	–up, –it
killorm¦ooq	N	{–up, –uup}, {–ut, –uut}
killormoorne¦q	N	–rup, –rit
killormoorpaa	V	(no generation)
killormoorpoq	V	(no generation)
killormoort¦oq	N	–up, –ut
killormooruppaa	V	(no generation)
killornguvoq	V	(no generation)
killornuvoq	V	(no generation)
killorpaa	V	(no generation)
killu	N	–p, –t
killuataarpaa	V	(no generation)
killuatungaanii¦ppoq	V	–nngilaq
killugaavoq	V	(no generation)
killu¦gaq	N	–kkap, –kkat
killuiffigaa	V	(no generation)
killuiffiginninne¦q	N	–rup, –rit
killuigajuppoq	V	(no generation)
killuigajutt¦oq	N	–up, –ut
killuillaqqippoq	V	(no generation)
killuine¦q	N	–rup, –rit
killuisarpoq	V	(no generation)
killuis¦oq	N	–up, –ut
killuisuuvoq	V	(no generation)
killuivoq	V	(no generation)
killukasi¦k	N	–up, –it
killuliorpaa	V	(no generation)
killuliorpoq	V	(no generation)
killuliuuppaa	V	(no generation)
killussaaruppoq	V	(no generation)
killussa¦q	N	–p, –t
killussarsivoq	V	(no generation)
killussia¦q	N	–p, –t
killussiarsivoq	V	(no generation)
killussiorpoq	V	(no generation)
killuulluneerpoq	V	(no generation)
killuunnivaa	V	(no generation)
killuuppaa	V	(no generation)
killuussigajutt¦oq	N	–up, –ut
killuussine¦q	N	–rup, –rit
killuussisarne¦q	N	–rup, –rit
killuussis¦oq	N	–up, –ut
killuussivoq	V	(no generation)
killuussu¦aq	N	–up, –it
killuut	N	–ip, –it
killuutaavoq	V	(no generation)
killuutigaa	V	(no generation)
killuutiginnippoq	V	(no generation)
killuuvoq	V	(no generation)
k¦ilometerilersuut	N	{–ilometerilersuutip, –ilometerilertuutip, –milersuutip, –milertuutip}, {–ilometerilersuutit, –ilometerilertuutit, –milersuutit, –milertuutit}
kiloqaraluanngilaq	V	(no generation)
kilorra¦q	N	–ap, –at
kilorrarterpaa	V	(no generation)
kilu	N	–p, –t
ki¦lu	N	{–ilup, –lup}, {–ilut, –lut}
kiluarne¦q	N	–rup, –rit
kiluarpaa	V	(no generation)
kiluarpoq	V	(no generation)
kiluarsimavoq	V	(no generation)
kiluarterivoq	V	(no generation)
kiluarterpaa	V	(no generation)
kiluartiterpaa	V	(no generation)
kiluartiterpoq	V	(no generation)
kiluartoorpoq	V	(no generation)
kiluerpoq	V	(no generation)
kiluersinnaanngilaq	V	(no generation)
kiluersinne¦q	N	–rup, –rit
kiluersoorpoq	V	(no generation)
kiluertinne¦q	N	–rup, –rit
kilugippoq	V	(no generation)
kilugissuunngilaq	V	(no generation)
kilugivippoq	V	(no generation)
kiluiarterpaa	V	(no generation)
kilu¦k	N	–up, –it
kilukillisaarpaa	V	(no generation)
kilukippoq	V	(no generation)
kilukisaarpaa	V	(no generation)
kilukits¦oq	N	–up, –ut
ki¦lukitsoq	N	{–ilukitsup, –lukitsup}, {–ilukitsut, –lukitsut}
kilukivippoq	V	(no generation)
kilulerpaa	V	(no generation)
kilul¦ik	N	{–iup, –lip, –lup}, –lit
ki¦lulik	N	{–iluliup, –ilullip, –ilullup, –luliup, –lullip, –lullup}, {–ilullit, –lullit}
kilulluppoq	V	(no generation)
kilumiuusarpoq	V	(no generation)
kilumiuuvoq	V	(no generation)
kilummoorpoq	V	(no generation)
kilunngaaserpaa	V	(no generation)
kilunngaasersorpaa	V	(no generation)
kilunngaat	N	–ip, –it
kilunngaatissa¦q	N	–p, –t
kilunngaavoq	V	(no generation)
kilunngarpaa	V	(no generation)
kilupatserpaa	V	(no generation)
kilutt¦ooq	N	–uup, –uut
kimattuuserpaa	V	(no generation)
kimattuut	N	–ip, –it
kimeqanngilaq	V	(no generation)
kimeqaqaaq	V	(no generation)
kimeqarluarpoq	V	(no generation)
kimeqarpoq	V	(no generation)
kimigiiserfigaa	V	(no generation)
kimigiiserfiginninne¦q	N	–rup, –rit
kimigiiserne¦q	N	–rup, –rit
kimigiiserpoq	V	(no generation)
kimiillisippaa	V	(no generation)
kimiillivoq	V	(no generation)
kimiinneruvoq	V	(no generation)
kimii¦ppoq	V	–nngilaq
kimi¦k	N	–up, –it
kimikillisinneqarne¦q	N	–rup, –rit
kimikilli¦sinneqarneq	N	{–sinneqarnerup, –tinneqarnerup}, {–sinneqarnerit, –tinneqarnerit}
kimikillisippaa	V	(no generation)
kimikillivaa	V	(no generation)
kimikillivoq	V	(no generation)
kimikinaarpaa	V	(no generation)
kimikinne¦q	N	–rup, –rit
kimikippoq	V	(no generation)
kimikits¦oq	N	–up, –ut
kimillaarsuppoq	V	(no generation)
kimillanne¦q	N	–rup, –rit
kimillannersu¦aq	N	–up, –it
kimillappaa	V	(no generation)
kimillappoq	V	(no generation)
kimillatsiterpaa	V	(no generation)
kimillatsiterpoq	V	(no generation)
kiminneqarsimas¦oq	N	–up, –ut
kiminniarpaa	V	(no generation)
kimippaa	V	(no generation)
kimitaavoq	V	(no generation)
kimitsappaa	V	(no generation)
kimitsappoq	V	(no generation)
kimitsilluart¦oq	N	–up, –ut
kimitsivoq	V	(no generation)
kimitt¦ooq	N	–uup, –uut
kimittune¦q	N	–rup, –rit
kimittusaarpoq	V	(no generation)
kimittusisitsine¦q	N	–rup, –rit
kimittusivoq	V	(no generation)
kimittussu¦seq	N	–tsip, –tsit
kimittutsi¦ppoq	V	–nngilaq
kimittuuvoq	V	(no generation)
kimittuvoq	V	(no generation)
kimmaagajuppoq	V	(no generation)
kimmaa¦q	N	–p, –t
kimmaaraa	V	(no generation)
kimmaavoq	V	(no generation)
kimmaliivoq	V	(no generation)
kimmalippaa	V	(no generation)
kimmarneqarsimaqis¦oq	N	–up, –ut
kimmarneqarsimas¦oq	N	–up, –ut
kimmarpaa	V	(no generation)
kimmarpaluppaa	V	(no generation)
kimmarpoq	V	(no generation)
kimmarsaraa	V	(no generation)
kimmeqq¦oq	N	–up, –ut
kimmeqquserpaa	V	(no generation)
kimmeqqut	N	–ip, –it
kimmeqqut	N, pl.	-
kimmeqquut	N	–ip, –it
kimmernaasa¦q	N	–p, –t
kimmernaasat	N, pl.	-
kimmernakul¦ooq	N	–uup, –uut
kimmernakuluut	N, pl.	-
kimmerna¦q	N	–p, –t
kimmernat	N, pl.	-
kimmi¦aq	N	–ssap, –ssat
kimmiaqarpoq	V	(no generation)
kimmiaraa	V	(no generation)
kimmiarpaa	V	(no generation)
kimmiarpoq	V	(no generation)
kimmiffigaa	V	(no generation)
kimmi¦k	N	–up, –it
kimmikkaa¦q	N	–p, –t
kimmilluppoq	V	(no generation)
kimmimmiine¦q	N	–rup, –rit
kimmimmippaa	V	(no generation)
kimmisoortippaa	V	(no generation)
kimmissaat	N	–ip, –it
kimmissaavoq	V	(no generation)
kimmissarpaa	V	(no generation)
kimmisserpaa	V	(no generation)
kimmissersorpaa	V	(no generation)
kimmissiuppaa	V	(no generation)
kimmissiussivoq	V	(no generation)
kimmiss¦ooq	N	–uup, –uut
kimmitt¦ooq	N	–uup, –uut
kimmivaa	V	(no generation)
kimmivi¦k	N	–up, –it
kimmivikippoq	V	(no generation)
kimmivoq	V	(no generation)
kimmoorpoq	V	(no generation)
kimmukaappaa	V	(no generation)
kimmukaassivoq	V	(no generation)
kimmukarpoq	V	(no generation)
kimmukart¦oq	N	–up, –ut
ki¦mmukartoq	N	{–mmukartup, –timukartup}, {–mmukartut, –timukartut}
Kina	Prop	–p
Ki¦na	Pron	{–a, –ap}, –kkut
ki¦na	Pron	{–a, –ap}, –kkut
kinaallagaa	V	(no generation)
kinaallappoq	V	(no generation)
kinaaniut	N	–it
kinaassu¦seq	N	–tsip, –tsit
kinaassu¦seq	N	–tsit
kinaassusersine¦q	N	–rit
kinaassusersine¦q	N	–rup, –rit
kinaassusersiorpoq	V	(no generation)
kinaassusersiort¦oq	N	–up, –ut
kinaassusersiort¦oq	N	–ut
kinaassusersiunnginne¦q	N	–rit
kinaassusersiunnginne¦q	N	–rup, –rit
kinaassusersiunngits¦oq	N	–up, –ut
kinaassusersiunngits¦oq	N	–ut
kinaassusersiu¦siisarneq	N	{–siisarnerit, –tiliisarnerit}
kinaassusersiu¦siisarneq	N	{–siisarnerup, –tiliisarnerup}, {–siisarnerit, –tiliisarnerit}
kinaassusersiut	N	–ip, –it
kinaassusersiut	N	–it
kinaassut	N	–it
kinaatsoorpoq	V	(no generation)
kinaavoq	V	(no generation)
ki¦naluunniit	Pron	{–alluunniit, –aluunniit}, –kkulluunniit
Kinam¦eersoq	N	{–eersup, –eertup, –inngaanneersup, –inngaanneertup, –inngaanninngaanneersup, –inngaanninngaanneertup}, {–eersut, –eertut, –inngaanneersut, –inngaanneertut, –inngaanninngaanneersut, –inngaanninngaanneertut}
Kinamioq	N	(no generation)
Kina¦miu	N	{–miup, –rmiup}, {–miut, –rmiut}
kinaquserpaa	V	(no generation)
kinaqusiorpoq	V	(no generation)
kinaqut	N	–ip, –it
kinaqut	N, pl.	-
kinaqutaavoq	V	(no generation)
kinequserpaa	V	(no generation)
kinequt	N	–ip, –it
kinequt	N, pl.	-
kinequtaavoq	V	(no generation)
kinequtigaa	V	(no generation)
kineraa	V	(no generation)
kinerfippoq	V	(no generation)
kinerpoq	V	(no generation)
kinersaaserpaa	V	(no generation)
kinersaat	N	–ip, –it
kiner¦saat	N	{–saatip, –taatip}, {–saatit, –taatit}
kinersarpaa	V	(no generation)
kinersarpoq	V	(no generation)
kinerserpaa	V	(no generation)
kinersigaluttuinnarpoq	V	(no generation)
kinersimavoq	V	(no generation)
kinerti¦ppoq	V	–nngilaq
kinertoorpoq	V	(no generation)
kiner¦toq	N	{–sup, –tup}, {–sut, –tut}
kinertuliorpoq	V	(no generation)
kinertuvoq	V	(no generation)
kingeqaaq	V	(no generation)
kingerpaa	V	(no generation)
kinginne¦q	N	–rup, –rit
kinginnersaavoq	V	(no generation)
kinginnersa¦q	N	–p, –t
kinginneruvoq	V	(no generation)
kingippoq	V	(no generation)
kingissivoq	V	(no generation)
kingitt¦oq	N	–up, –ut
kingi¦ttoq	N	{–ssup, –ttup}, {–ssut, –ttut}
kingittorsu¦aq	N	–up, –it
kingi¦ttorsuaq	N	{–ssorsuup, –ttorsuup}, {–ssorsuit, –ttorsuit}
kingittuarsu¦k	N	–up, –it
kingi¦ttuarsuk	N	{–ssuarsuup, –ttuarsuup}, {–ssuarsuit, –ttuarsuit}
kingittulivoq	V	(no generation)
kingoqqerpaa	V	(no generation)
kingoqqersorpaa	V	(no generation)
kingoqqiffi¦k	N	–up, –it
kingoqqiulluarpoq	V	(no generation)
kingoqqiuppoq	V	(no generation)
kingoqqiussiivaa	V	(no generation)
kingoqqivaa	V	(no generation)
kingoqqivoq	V	(no generation)
kingoqquppaa	V	(no generation)
kingoqqutsivoq	V	(no generation)
kingoraagajuppoq	V	(no generation)
kingoraa¦gaq	N	–kkap, –kkat
kingoraaneerpaa	V	(no generation)
kingoraarpaa	V	(no generation)
kingoraarsimasa¦q	N	–p, –t
kingoraarsine¦q	N	–rup, –rit
kingoraarsisuune¦q	N	–rup, –rit
kingoraarsivoq	V	(no generation)
kingoraartaaffi¦k	N	–up, –it
kingoraartaagallart¦oq	N	–up, –ut
kingoraartaas¦oq	N	–up, –ut
kingoraartaavoq	V	(no generation)
kingoraarti	N	–p, –t
kingoraartigaa	V	(no generation)
kingoraartippaa	V	(no generation)
kingoraartippoq	V	(no generation)
kingoraartissa¦q	N	–p, –t
kingoraavoq	V	(no generation)
kingora¦q	N	–p, –t
kingorarluppoq	V	(no generation)
kingorarpaa	V	(no generation)
kingorasserpaa	V	(no generation)
kingorassersorpaa	V	(no generation)
kingorassigaavoq	V	(no generation)
kingorassiivoq	V	(no generation)
kingorassiuppaa	V	(no generation)
kingornguppaa	V	(no generation)
kingorngussa¦q	N	–p, –t
kingorngu¦ssaq	N	{–ssap, –tap}, {–ssat, –tat}
kingorngussarsivoq	V	(no generation)
kingorngussassaqanngits¦oq	N	–up, –ut
kingorngu¦ssassaqanngitsoq	N	{–ssassaqanngitsup, –tassaqanngitsup}, {–ssassaqanngitsut, –tassaqanngitsut}
kingorngussassiuivoq	V	(no generation)
kingorngussisussa¦q	N	–p, –t
kingorngussivoq	V	(no generation)
kingornguvoq	V	(no generation)
kingorniuvoq	V	(no generation)
kingornunersaavoq	V	(no generation)
kingornunneqarsinnaas¦oq	N	–up, –ut
kingornunneqarsinnaassu¦seq	N	–tsip, –tsit
kingornunneqartart¦oq	N	–up, –ut
kingornuppaa	V	(no generation)
kingornussaas¦oq	N	–up, –ut
kingornu¦ssaasoq	N	{–ssaasup, –taasup}, {–ssaasut, –taasut}
kingornussaavoq	V	(no generation)
kingornu¦ssaq	N	{–ssap, –tap}, {–ssat, –tat}
kingornussaraa	V	(no generation)
kingornu¦ssarsiaq	N	{–ssarsiap, –tarsiap}, {–ssarsiat, –tarsiat}
kingornu¦ssarsiarisimasaq	N	{–ssarsiarisimasap, –tarsiarisimasap}, {–ssarsiarisimasat, –tarsiarisimasat}
kingornussarsivoq	V	(no generation)
kingornu¦ssassaq	N	{–ssassap, –tassap}, {–ssassat, –tassat}
kingornu¦ssassaqanngitsoq	N	{–ssassaqanngitsup, –tassaqanngitsup}, {–ssassaqanngitsut, –tassaqanngitsut}
kingornussassaritippaa	V	(no generation)
kingornu¦ssassiaq	N	{–ssassiap, –tassiap}, {–ssassiat, –tassiat}
kingornussassiaraa	V	(no generation)
kingornu¦ssassiisoq	N	{–ssassiisup, –tassiisup}, {–ssassiisut, –tassiisut}
kingornussassiivoq	V	(no generation)
kingornusseqat	N	–ip, –it
kingornussisariaqart¦oq	N	–up, –ut
kingornussis¦oq	N	–up, –ut
kingornussisussaane¦q	N	–rup, –rit
kingornussisussaassu¦seq	N	–tsip, –tsit
kingornussisussaatitaane¦q	N	–rup, –rit
kingornussisussaatita¦q	N	–p, –t
kingornussisussa¦q	N	–p, –t
kingornussisussatuaas¦oq	N	–up, –ut
kingornussivoq	V	(no generation)
kingornutta¦gaq	N	–kkap, –kkat
kingornuvoq	V	(no generation)
kingu	N	–p, –t
kinguaajuvoq	V	(no generation)
kinguaamivaa	V	(no generation)
kinguaamivoq	V	(no generation)
kinguaappaa	V	(no generation)
kinguaappoq	V	(no generation)
kinguaa¦q	N	–p, –t
kinguaaraa	V	(no generation)
kinguaariissu¦seq	N	–tsip, –tsit
kinguaart¦ooq	N	–uup, –uut
kinguaassia¦q	N	–p, –t
kinguaassiorluarpoq	V	(no generation)
kinguaassiorne¦q	N	–rup, –rit
kinguaass¦iorneq	N	{–aliornerup, –iornerup}, {–aliornerit, –iornerit}
kinguaassiorpoq	V	(no generation)
kinguaass¦iorsinnaajunnaartitsissut	N	{–aliorsinnaajunnaarsitsissutip, –aliorsinnaajunnaartitsissutip, –iorsinnaajunnaarsitsissutip, –iorsinnaajunnaartitsissutip}, {–aliorsinnaajunnaarsitsissutit, –aliorsinnaajunnaartitsissutit, –iorsinnaajunnaarsitsissutit, –iorsinnaajunnaartitsissutit}
kinguaass¦iorsinnaaneq	N	{–aliorsinnaanerup, –iorsinnaanerup}, {–aliorsinnaanerit, –iorsinnaanerit}
kinguaass¦iorsinnaanngissuseq	N	{–aliorsinnaanngissutsip, –iorsinnaanngissutsip}, {–aliorsinnaanngissutsit, –iorsinnaanngissutsit}
kinguaass¦iorsinnaanngitsoq	N	{–aliorsinnaanngitsup, –iorsinnaanngitsup}, {–aliorsinnaanngitsut, –iorsinnaanngitsut}
kinguaass¦iorsinnaanngortoq	N	{–aliorsinnaanngortup, –iorsinnaanngortup}, {–aliorsinnaanngortut, –iorsinnaanngortut}
kinguaass¦iorsinnaasoq	N	{–aliorsinnaasup, –iorsinnaasup}, {–aliorsinnaasut, –iorsinnaasut}
kinguaass¦iorsinnaassuseq	N	{–aliorsinnaassutsip, –iorsinnaassutsip}, {–aliorsinnaassutsit, –iorsinnaassutsit}
kinguaass¦iorsinnaassuseqanngitsoq	N	{–aliorsinnaassuseqanngitsup, –iorsinnaassuseqanngitsup}, {–aliorsinnaassuseqanngitsut, –iorsinnaassuseqanngitsut}
kinguaassiortitsine¦q	N	–rup, –rit
kinguaass¦iortitsineq	N	{–aliortitsinerup, –iortitsinerup}, {–aliortitsinerit, –iortitsinerit}
kinguaass¦iortitsisoq	N	{–aliortitsisup, –iortitsisup}, {–aliortitsisut, –iortitsisut}
kinguaassiortitsivi¦k	N	–up, –it
kinguaass¦iortitsivik	N	{–aliortitsiffiup, –aliortitsiviup, –iortitsiffiup, –iortitsiviup}, {–aliortitsiffiit, –aliortitsiviit, –iortitsiffiit, –iortitsiviit}
kinguaassisaat	N	–ip, –it
kinguaassisinnaane¦q	N	–rup, –rit
kinguaassisinnaanngort¦oq	N	–up, –ut
kinguaassisinnaas¦oq	N	–up, –ut
kinguaassiuut	N	–ip, –it
kinguaassivoq	V	(no generation)
kinguaat	N	–ip, –it
kinguaat	N, pl.	-
kinguaatigaa	V	(no generation)
kinguaattoorne¦q	N	–rup, –rit
kinguaattoorpoq	V	(no generation)
kinguaattoort¦oq	N	–up, –ut
kinguaattoorut	N	–ip, –it
kinguaavaa	V	(no generation)
kinguanii¦ppoq	V	–nngilaq
kinguariarne¦q	N	–rup, –rit
kinguariarpoq	V	(no generation)
kinguariartorpoq	V	(no generation)
kinguarpaa	V	(no generation)
kinguarpoq	V	(no generation)
kinguarsaane¦q	N	–rup, –rit
kinguarsaat	N	–ip, –it
kinguarsaataas¦oq	N	–up, –ut
kinguarsaavoq	V	(no generation)
kinguarsa¦rpaa	V	–nngilaa
kinguarsimas¦oq	N	–up, –ut
kinguartinneqarpoq	V	(no generation)
kinguartippaa	V	(no generation)
kinguartitaane¦q	N	–rup, –rit
kinguartita¦q	N	–p, –t
kinguartitassaanngits¦oq	N	–up, –ut
kinguartitsigallarne¦q	N	–rup, –rit
kinguartitsine¦q	N	–rup, –rit
kinguartitsivoq	V	(no generation)
kinguartoorne¦q	N	–rup, –rit
kinguartoorpoq	V	(no generation)
kinguartoortippaa	V	(no generation)
kinguartoort¦oq	N	–up, –ut
kinguart¦oq	N	–up, –ut
kinguffakkumaarpoq	V	(no generation)
kinguffappoq	V	(no generation)
kinguffatsippaa	V	(no generation)
kingu¦gaq	N	–kkap, –kkat
kingu¦k	N	–up, –it
kingul¦eq	N	–ip, –it
kinguleqarpoq	V	(no generation)
kinguleqqiut	N	–ip, –it
kinguleqqiutitorpoq	V	(no generation)
kinguleraa	V	(no generation)
kingule¦raq	N	–qqap, –qqat
kingulerartorpoq	V	(no generation)
kinguleriiaartunii¦ppoq	V	–nngilaq
kinguleriiaat	N, pl.	-
kingulerukkiartorpoq	V	(no generation)
kingulerunne¦q	N	–rup, –rit
kinguleruppoq	V	(no generation)
kingulerussinnaanngilaq	V	(no generation)
kingulerutikulaarpoq	V	(no generation)
kingulerutikutsoorpoq	V	(no generation)
kingulerutinngilaq	V	(no generation)
kingulerutivippoq	V	(no generation)
kingulia¦q	N	–p, –t
kinguliaquserpaa	V	(no generation)
kinguliaqusiuppaa	V	(no generation)
kinguliaqut	N	–ip, –it
kinguliaqutaavoq	V	(no generation)
kinguliaqutigaa	V	(no generation)
kinguliits¦oq	N	–up, –ut
kinguliitsortaraa	V	(no generation)
kingull¦eeq	N	–iip, –iit
kingulleers¦ooq	N	–uup, –uut
kingull¦eq	N	–iup, –iit
kingulleqqiut	N	–ip, –it
kingulleqqiutil¦ik	N	{–iup, –lip, –lup}, –lit
kingulleqqiutit	N, pl.	-
kingullermeerpaa	V	(no generation)
kingullermeerpoq	V	(no generation)
kingullerpaa	V	(no generation)
kingullerpaa¦q	N	–p, –t
kingullersaas¦oq	N	–up, –ut
kingullersa¦q	N	–p, –t
kingullersiut	N	–ip, –it
kingulliarnertoqaaq	V	(no generation)
kingulliarpoq	V	(no generation)
kingulliarsu¦k	N	–up, –it
kingulliarsuppaluppoq	V	(no generation)
kingulliikippoq	V	(no generation)
kingullinngorpoq	V	(no generation)
kingullinngukulaarpoq	V	(no generation)
kingullioqaaq	V	(no generation)
kingulliujuaannarpoq	V	(no generation)
kingulliunianngeqaaq	V	(no generation)
kingulliuppaa	V	(no generation)
kingulliussaavoq	V	(no generation)
kingulliuvoq	V	(no generation)
kinguluppaa	V	(no generation)
kingumoorpoq	V	(no generation)
kingumoorut	N	–ip, –it
kingumorsorne¦q	N	–rup, –rit
kingumorsorpoq	V	(no generation)
kingumukaappaa	V	(no generation)
kingumukaatsippaa	V	(no generation)
kingumukarpoq	V	(no generation)
kingumukartuarpoq	V	(no generation)
kingune¦q	N	–rup, –rit
king¦uneq	N	–ornup, –ornit
kinguneqanngilaq	V	(no generation)
kinguneqanngits¦oq	N	–up, –ut
kinguneqarluarpoq	V	(no generation)
kinguneqarluarsinnaas¦oq	N	–up, –ut
kinguneqarluart¦oq	N	–up, –ut
kinguneqarpoq	V	(no generation)
kinguneqartippaa	V	(no generation)
kinguneqartitsivoq	V	(no generation)
kinguneraa	V	(no generation)
kingunerileraa	V	(no generation)
kingunerisa¦q	N	–p, –t
kingunerivigisa¦q	N	–p, –t
kingunerivi¦k	N	–up, –it
kingunerivoq	V	(no generation)
kingunerlutsitsine¦q	N	–rup, –rit
kingunerluut	N	–ip, –it
kingunerpaa	V	(no generation)
kingunert¦ooq	N	–uup, –uut
kingunertoqaaq	V	(no generation)
kingunertugaa	V	(no generation)
kingunertussu¦seq	N	–tsip, –tsit
kingunertuvoq	V	(no generation)
kingunerut	N	–ip, –it
kingunik¦oq	N	–up, –ut
kingunikusiorfigaa	V	(no generation)
kingunikusiorpaa	V	(no generation)
kingunikusiorpoq	V	(no generation)
kingunipilu¦k	N	–up, –it
kingunipilul¦ik	N	{–iup, –lip, –lup}, –lit
kingunissa¦q	N	–p, –t
kingunissaqalerpoq	V	(no generation)
kingunissaqart¦oq	N	–up, –ut
kingunissaqassu¦seq	N	–tsip, –tsit
kinguniuvoq	V	(no generation)
kingunneqarpoq	V	(no generation)
kingunniku	N	–p, –t
kingupoorpoq	V	(no generation)
kinguporsorne¦q	N	–rup, –rit
kinguporsorpoq	V	(no generation)
kinguporsuuppaa	V	(no generation)
kinguppa¦k	N	–ap, –at
kinguppanniut	N	–ip, –it
kinguppiarpoq	V	(no generation)
kinguppiartippaa	V	(no generation)
kinguppoq	V	(no generation)
kingusiinna¦q	N	–p, –t
kingusinaarpaa	V	(no generation)
kingusinaarpoq	V	(no generation)
kingusinaart¦oq	N	–up, –ut
kingusinaartuaannarpoq	V	(no generation)
kingusinnerpaa¦q	N	–p, –t
kingusinnerus¦oq	N	–up, –ut
kingusinneruvoq	V	(no generation)
kingusippallaaqaaq	V	(no generation)
kingusippoq	V	(no generation)
kingusissoorpoq	V	(no generation)
kingusiss¦oq	N	–up, –ut
kingusi¦ssoq	N	{–ssup, –ttup}, {–ssut, –ttut}
kingussimas¦oq	N	–up, –ut
kingussu¦aq	N	–up, –it
kinguuppaa	V	(no generation)
kinguusa¦q	N	–p, –t
kinguvoq	V	(no generation)
kini	N	–p, –t
kinikkaluarsinnaavaa	V	(no generation)
kinimavoq	V	(no generation)
kiningaatsiarpoq	V	(no generation)
kininngits¦oq	N	–up, –ut
kiniorsarpaa	V	(no generation)
kinipas¦oq	N	–up, –ut
kinipasussa¦q	N	–p, –t
kinipavoq	V	(no generation)
kinippaa	V	(no generation)
kinippoq	V	(no generation)
kinisaaruppoq	V	(no generation)
kinisaavoq	V	(no generation)
kinisa¦q	N	–p, –t
kinisivoq	V	(no generation)
kinissu¦seq	N	–tsip, –tsit
kinitalaarpoq	V	(no generation)
kinitalappoq	V	(no generation)
kinitalatsi¦ppoq	V	–nngilaq
kinitalatt¦oq	N	–up, –ut
kinita¦q	N	–p, –t
kinitsine¦q	N	–rup, –rit
kinitsivi¦k	N	–up, –it
kinitsi¦vik	N	{–ffiup, –viup}, {–ffiit, –viit}
kinitsivissa¦q	N	–p, –t
kinitsi¦vissaq	N	{–ffissap, –vissap}, {–ffissat, –vissat}
kinitsivoq	V	(no generation)
kinivaa	V	(no generation)
kinnallaavoq	V	(no generation)
kinnalla¦k	N	–ap, –at
kinne¦q	N	–rup, –rit
kinnerpoq	V	(no generation)
kinnersu¦aq	N	–up, –it
kinnerta¦q	N	–p, –t
kinnertat	N, pl.	-
kinnga	N	–p, –t
ki¦nnga	Pron	–ssuma, {–kku, –kkua}
Kinngaat	N	–ip, –it
kinnga¦neq	N	{–nerup, –rnup}, {–nerit, –rnit}
kinnganik¦oq	N	–up, –ut
kinnganippoq	V	(no generation)
kinnga¦q	N	–p, –t
kinng¦eq	N	–ip, –it
kinngers¦ooq	N	–uup, –uut
kinnginippoq	V	(no generation)
kinngort¦ooq	N	–uup, –uut
kinngujaappoq	V	(no generation)
kinngujavoq	V	(no generation)
kinngune¦q	N	–rup, –rit
kinngusaarpoq	V	(no generation)
kinngusaqattaallaqqi¦ssoq	N	{–ssup, –ttup}, {–ssut, –ttut}
kinngusaqattaarne¦q	N	–rup, –rit
kinngusaqattaarpoq	V	(no generation)
kinngusoorpoq	V	(no generation)
kinngusoqarpoq	V	(no generation)
kinngutippaa	V	(no generation)
kinnguvoq	V	(no generation)
kinnik¦oq	N	–up, –ut
kinninngortarne¦q	N	–rup, –rit
kiorpaa	V	(no generation)
kioski	N	–p, –t
kipaallappaa	V	(no generation)
kiperaaq	V	(no generation)
kiperiffigaa	V	(no generation)
kiperippoq	V	(no generation)
kiperivoq	V	(no generation)
kipikkaluttuinnarpoq	V	(no generation)
kipilaarpaa	V	(no generation)
kipilerfigaa	V	(no generation)
kipilerpoq	V	(no generation)
kipilivippoq	V	(no generation)
kipiluttorfiginnitt¦oq	N	–up, –ut
kipiluttorpoq	V	(no generation)
kipiluttunarpoq	V	(no generation)
kipiluttunarsivoq	V	(no generation)
kipiluttussutigaa	V	(no generation)
kipiluttuutigaa	V	(no generation)
kipiluttuvoq	V	(no generation)
kipinaveerpoq	V	(no generation)
kipineqanngits¦oq	N	–up, –ut
kipineqarne¦q	N	–rup, –rit
kipineqarpoq	V	(no generation)
kipinngunaqaaq	V	(no generation)
kipinngusaarpoq	V	(no generation)
kipinngutsappoq	V	(no generation)
kipinnguvoq	V	(no generation)
kipippoq	V	(no generation)
kipisaane¦q	N	–rup, –rit
kipisaavoq	V	(no generation)
kipisagisa¦q	N	–p, –t
kipisane¦q	N	–rup, –rit
kipisa¦q	N	–p, –t
kipisaqaaq	V	(no generation)
kipisavoq	V	(no generation)
kipisimas¦oq	N	–up, –ut
kipis¦imasoq	N	{–imasup, –simasup}, {–imasut, –simasut}
kipisine¦q	N	–rup, –rit
kipisitsine¦q	N	–rup, –rit
kipisitsivoq	V	(no generation)
kipisivoq	V	(no generation)
kipissaanngits¦oq	N	–up, –ut
kipissanngits¦oq	N	–up, –ut
kipisuippoq	V	(no generation)
kipisuits¦oq	N	–up, –ut
kipitippaa	V	(no generation)
kipititaane¦q	N	–rup, –rit
kipititaas¦oq	N	–up, –ut
kipititsine¦q	N	–rup, –rit
kipititsis¦oq	N	–up, –ut
kipititsissut	N	–ip, –it
kipititsivoq	V	(no generation)
kipitsaarpoq	V	(no generation)
kipitsappaa	V	(no generation)
kipitsappoq	V	(no generation)
kipitsat	N	–ip, –it
kipitsataavoq	V	(no generation)
kipitsatigaa	V	(no generation)
kipitsavigaa	V	(no generation)
kipitsaviginnippoq	V	(no generation)
kipitsavi¦k	N	–up, –it
kipiuippoq	V	(no generation)
kipiuits¦oq	N	–up, –ut
kipivaa	V	(no generation)
kipivoq	V	(no generation)
kippaakkiartorpaa	V	(no generation)
kippaappaa	V	(no generation)
kippaarippaa	V	(no generation)
kippaarippoq	V	(no generation)
kippaariss¦oq	N	–up, –ut
kippaari¦ssoq	N	{–ssup, –ttup}, {–ssut, –ttut}
kippaaritsippoq	V	(no generation)
kippaattoorpaa	V	(no generation)
kippak¦oq	N	–up, –ut
kippaku	N	–p, –t
kippakullu¦k	N	–up, –it
kippakullunngortippaa	V	(no generation)
kippakullunngortitsine¦q	N	–rup, –rit
kippakunnappoq	V	(no generation)
kippakuuvoq	V	(no generation)
kippa¦q	N	–p, –t
kippari	N	–p, –t
kipparilluinnarpoq	V	(no generation)
kipparippoq	V	(no generation)
kipparissivoq	V	(no generation)
kippariss¦oq	N	–up, –ut
kippari¦ssoq	N	{–ssup, –ttup}, {–ssut, –ttut}
kipparissort¦ooq	N	–uup, –uut
kippari¦ssortooq	N	{–ssortuup, –ttortuup}, {–ssortuut, –ttortuut}
kipparissortuuvoq	V	(no generation)
kipparluk¦oq	N	–up, –ut
kipparluku	N	–p, –t
kipparpoq	V	(no generation)
kipparsimaffi¦k	N	–up, –it
kipparsimavoq	V	(no generation)
kipparterpoq	V	(no generation)
kipparteruppaa	V	(no generation)
kippasippallaaqaaq	V	(no generation)
kippasippoq	V	(no generation)
kippasissumii¦ppoq	V	–nngilaq
kippasi¦ssumiippoq	V	{–ssumiinngilaq, –ttumiinngilaq}
kippiveerulluinnarpoq	V	(no generation)
kippiveeruppoq	V	(no generation)
kippiveerutivippoq	V	(no generation)
kippiveqanngilaq	V	(no generation)
kippivi¦k	N	–up, –it
ki¦ppoq	V	–nngilaq
kippunnaveersaarpaa	V	(no generation)
kippuppaa	V	(no generation)
kippussivoq	V	(no generation)
kipput	N	–ip, –it
kipputaavoq	V	(no generation)
kipputigaa	V	(no generation)
kipputinngilaa	V	(no generation)
kipputiuippaa	V	(no generation)
kipputtart¦oq	N	–up, –ut
kipukannerpoq	V	(no generation)
kipukkiartorpoq	V	(no generation)
kipungaarpoq	V	(no generation)
kipungaqaaq	V	(no generation)
kipungasoorpoq	V	(no generation)
kipungavoq	V	(no generation)
kipuppaa	V	(no generation)
kipuppoq	V	(no generation)
kipusaqattaarpoq	V	(no generation)
kipusarpoq	V	(no generation)
kipusoorpoq	V	(no generation)
kiputippaa	V	(no generation)
kiputittoorpaa	V	(no generation)
kiputtaart¦oq	N	–up, –ut
kipu¦ttaartoq	N	{–ssaartup, –ttaartup}, {–ssaartut, –ttaartut}
kiputtart¦oq	N	–up, –ut
kipuvoq	V	(no generation)
kirsebær	N	–ip, –it
kirsebæri	N	–p, –t
kisaa¦raq	N	–qqap, –qqat
kisaarartaarpoq	V	(no generation)
kisaaserpaa	V	(no generation)
kisaasersimas¦oq	N	–up, –ut
kisaa¦sersimasoq	N	{–sersimasup, –tilersimasup}, {–sersimasut, –tilersimasut}
kisaasiuppaa	V	(no generation)
kisaassilluart¦oq	N	–up, –ut
kisaat	N	–ip, –it
kisalia¦q	N	–p, –t
ki¦saq	N	–tsap, –tsat
kisaqqas¦oq	N	–up, –ut
kisaqqavi¦k	N	–up, –it
kisaqqavoq	V	(no generation)
kisarfi¦k	N	–up, –it
kisarne¦q	N	–rup, –rit
kisarpaa	V	(no generation)
kisarpallappoq	V	(no generation)
kisarpoq	V	(no generation)
kisarsimaffi¦k	N	–up, –it
kisarsimas¦oq	N	–up, –ut
kisarsimavoq	V	(no generation)
kisarsu¦aq	N	–up, –it
kisartarfi¦k	N	–up, –it
kisartippaa	V	(no generation)
kisartitsine¦q	N	–rup, –rit
kisartorpaa	V	(no generation)
kiseerfigaa	V	(no generation)
kiseerpoq	V	(no generation)
kiseqqiine¦q	N	–rup, –rit
kiserliornart¦oq	N	–up, –ut
kiserliorne¦q	N	–rup, –rit
kiserliornia¦q	N	–p, –t
kiserliorpoq	V	(no generation)
kiserliorsaraaq	V	(no generation)
kiserliortaannarpoq	V	(no generation)
kiserliort¦oq	N	–up, –ut
kisermaajune¦q	N	–rup, –rit
kisermaajuvoq	V	(no generation)
kisermaannialerpaa	V	(no generation)
kisermaappaa	V	(no generation)
kisermaa¦q	N	–p, –t
kisermaassaavoq	V	(no generation)
kisermaassanngortippaa	V	(no generation)
kisermaassa¦q	N	–p, –t
kisermaassine¦q	N	–rup, –rit
kisermaassinerit	N, pl.	-
kisermaassis¦oq	N	–up, –ut
kisermaassisuutitaane¦q	N	–rup, –rit
kisermaassivoq	V	(no generation)
kisermaavoq	V	(no generation)
kisermiuvoq	V	(no generation)
kiserngaappaa	V	(no generation)
kiserngoruppoq	V	(no generation)
kiserngorussaavoq	V	(no generation)
kiserngorutt¦oq	N	–up, –ut
kisianneerutissa¦q	N	–p, –t
kisianneqarpoq	V	(no generation)
kisiffigaa	V	(no generation)
kisigaa	V	(no generation)
kisigiunnaarpaa	V	(no generation)
kisiillisaarpoq	V	(no generation)
kisiillisarpoq	V	(no generation)
kisiillivoq	V	(no generation)
kisiippoq	V	(no generation)
kisiits¦oq	N	–up, –ut
kisiitsorpoq	V	(no generation)
kisikkunnaarpoq	V	(no generation)
kisimiikkunnaarpoq	V	(no generation)
kisimiilerpoq	V	(no generation)
kisimiinngisaannarpoq	V	(no generation)
kisimii¦ppoq	V	–nngilaq
kisimiitt¦oq	N	–up, –ut
kisimiivippoq	V	(no generation)
kisinnarpoq	V	(no generation)
kisinnart¦oq	N	–up, –ut
kisinneqanngits¦oq	N	–up, –ut
kisinneqarne¦q	N	–rup, –rit
kisinnerluine¦q	N	–rup, –rit
kisinngits¦oq	N	–up, –ut
kisinngorpoq	V	(no generation)
kisinngoruppaa	V	(no generation)
kisinngoruppoq	V	(no generation)
kisippoq	V	(no generation)
kisissaanngitsut	N, pl.	-
kisi¦ssut	N, pl.	{–ssut, –ttut}
kisitassa¦q	N	–p, –t
kisi¦tseqqinneq	N	{–sseqqinnerup, –tseqqinnerup}, {–sseqqinnerit, –tseqqinnerit}
kisi¦tseqqissaarneq	N	{–sseqqissaarnerup, –tseqqissaarnerup}, {–sseqqissaarnerit, –tseqqissaarnerit}
kisitseriaa¦seq	N	–tsip, –tsit
kisi¦tseriaaseq	N	{–sseriaatsip, –ssiperiaatsip, –tseriaatsip, –tsiperiaatsip}, {–sseriaatsit, –ssiperiaatsit, –tseriaatsit, –tsiperiaatsit}
kisitsillaqqippoq	V	(no generation)
kisitsillaqqi¦ssoq	N	{–ssup, –ttup}, {–ssut, –ttut}
kisitsillaqqi¦ssorsuaq	N	{–ssorsuup, –ttorsuup}, {–ssorsuit, –ttorsuit}
kisi¦tsillaqqissuseq	N	{–ssillaqqissutsip, –tsillaqqissutsip}, {–ssillaqqissutsit, –tsillaqqissutsit}
kisitsilluarsinnaavoq	V	(no generation)
kisitsine¦q	N	–rup, –rit
kisitsiniut	N	–ip, –it
kisitsisaa¦seq	N	–tsip, –tsit
kisitsisiliorpoq	V	(no generation)
kisitsisinnaane¦q	N	–rup, –rit
kisitsisinnaas¦oq	N	–up, –ut
kisitsisita¦q	N	–p, –t
kisitsissut	N	–ip, –it
kisitsissutee¦raq	N	–qqap, –qqat
kisitsi¦t	N	–sip, –sit
kisitsivoq	V	(no generation)
kisittuarpoq	V	(no generation)
kissaal¦ik	N	{–iup, –lip, –lup}, –lit
kissaallagaa	V	(no generation)
kissaalla¦k	N	–ap, –at
kissaallappoq	V	(no generation)
kissaallatsippaa	V	(no generation)
kissaallattorpoq	V	(no generation)
kissaalluarpaa	V	(no generation)
kissaammerne¦q	N	–rup, –rit
kissaammerpoq	V	(no generation)
kissaammersippaa	V	(no generation)
kissaammersoorpoq	V	(no generation)
kissaammias¦oq	N	–up, –ut
kissaane¦q	N	–rup, –rit
kissaannarpoq	V	(no generation)
kissaannerluppaa	V	(no generation)
kissaappaa	V	(no generation)
kissaaqqi¦k	N	–up, –it
kissaaqqippoq	V	(no generation)
kissaasarpoq	V	(no generation)
kissaassilluarne¦q	N	–rup, –rit
kissaassilluart¦oq	N	–up, –ut
kissaassivoq	V	(no generation)
kissaat	N	–ip, –it
kissaataavoq	V	(no generation)
kissaateqarne¦q	N	–rup, –rit
kissaateqarpoq	V	(no generation)
kissaatigaa	V	(no generation)
kissaatigilluinnarpaa	V	(no generation)
kissaatiginart¦oq	N	–up, –ut
kissaatigineqanngits¦oq	N	–up, –ut
kissa¦atigineqanngitsoq	N	{–atigineqanngitsup, –jutigineqanngitsup, –asigineqanngitsup}, {–atigineqanngitsut, –jutigineqanngitsut, –asigineqanngitsut}
kissa¦atigineqanngitsoq	N	{–atigineqanngitsup, –jutigineqanngitsup}, {–atigineqanngitsut, –jutigineqanngitsut}
kissaatiginngilaa	V	(no generation)
kissaatigisa¦q	N	–p, –t
kissaa¦tigisaq	N	{–sigisap, –tigisap}, {–sigisat, –tigisat}
kissaatigisaqarne¦q	N	–rup, –rit
kissaa¦tigisaqarneq	N	{–sigisaqarnerup, –tigisaqarnerup}, {–sigisaqarnerit, –tigisaqarnerit}
kissaatigivippaa	V	(no generation)
kissaatit	N, pl.	-
kissaatita¦q	N	–p, –t
kissaavoq	V	(no generation)
kissagaane¦q	N	–rup, –rit
kissagajuppoq	V	(no generation)
kissajavoq	V	(no generation)
kissakkiartorne¦q	N	–rup, –rit
kissakujulaarpoq	V	(no generation)
kissalaalerpoq	V	(no generation)
kissalaarpoq	V	(no generation)
kissalaart¦oq	N	–up, –ut
kissalaassu¦seq	N	–tsip, –tsit
kissal¦ik	N	{–iup, –lip, –lup}, –lit
kissalivoq	V	(no generation)
kissalluarpoq	V	(no generation)
kissannert¦ooq	N	–uup, –uut
kissannertoorsu¦aq	N	–up, –it
kissanniaasaarpoq	V	(no generation)
kissappoq	V	(no generation)
kissa¦q	N	–p, –t
kissariaanna¦q	N	–ap, –at
kissarluarpoq	V	(no generation)
kissarneerunne¦q	N	–rup, –rit
kissarne¦q	N	–rup, –rit
kissarneqanngits¦oq	N	–up, –ut
kissarneqarne¦q	N	–rup, –rit
kissarneqarpoq	V	(no generation)
kissarnerluppoq	V	(no generation)
kissarnersiorpaa	V	(no generation)
kissarnersiorpoq	V	(no generation)
kissarnersiuine¦q	N	–rup, –rit
kissarnersiuivoq	V	(no generation)
kissarnersiut	N	–ip, –it
kissarnertoqaaq	V	(no generation)
kissarnerulerne¦q	N	–rup, –rit
kissarnikillisaat	N	–ip, –it
kissarniut	N	–ip, –it
kissarpaa	V	(no generation)
kissarpallaart¦oq	N	–up, –ut
kissarpoq	V	(no generation)
kissarsorpaa	V	(no generation)
kissarsorpoq	V	(no generation)
kissarsuuserivoq	V	(no generation)
kissarsuussu¦aq	N	–up, –it
kissarsuut	N	–ip, –it
kissarsuuteqarfi¦k	N	–up, –it
kissarsuutipalaa¦q	N	–p, –t
kissarti¦ppoq	V	–nngilaq
kissart¦oq	N	–up, –ut
kissartortorpoq	V	(no generation)
kissartorujussu¦aq	N	–up, –it
kissartuliorpoq	V	(no generation)
kissartulivoq	V	(no generation)
kissarullerpoq	V	(no generation)
kissarullersippaa	V	(no generation)
kissarulliuppaa	V	(no generation)
kissarulungaart¦oq	N	–up, –ut
kissaruluppoq	V	(no generation)
kissarulutsi¦ppoq	V	–nngilaq
kissaruluttuinnaavoq	V	(no generation)
kissassaaserpaa	V	(no generation)
kissassaat	N	–ip, –it
kissassaavoq	V	(no generation)
kissassarippoq	V	(no generation)
kissassarpaa	V	(no generation)
kissasseriarpoq	V	(no generation)
kissasseriippoq	V	(no generation)
kissasserpaa	V	(no generation)
kissasserpoq	V	(no generation)
kissassu¦seq	N	–tsip, –tsit
kissatseriaat	N	–ip, –it
kissatsikkaluttuinnarpoq	V	(no generation)
kissatsikkiartorne¦q	N	–rup, –rit
kissatsippaa	V	(no generation)
kissatsi¦ppoq	V	–nngilaq
kissatsitsine¦q	N	–rup, –rit
kissattaane¦q	N	–rup, –rit
kissattaaserpaa	V	(no generation)
kissattaasiivoq	V	(no generation)
kissattaat	N	–ip, –it
kissattaavoq	V	(no generation)
kissattarpaa	V	(no generation)
kissattartinne¦q	N	–rup, –rit
kissattoorne¦q	N	–rup, –rit
kissattoorpoq	V	(no generation)
kissavaasaa¦raq	N	–qqap, –qqat
kissavaasa¦q	N	–p, –t
kissaviarsu¦gaq	N	–kkap, –kkat
kissaviarsu¦k	N	–up, –it
kissavi¦k	N	–up, –it
kissavinngu¦aq	N	–up, –it
kissavoq	V	(no generation)
kisserpaa	V	(no generation)
kissertaarpoq	V	(no generation)
kissi	N	–p, –t
kissiaavoq	V	(no generation)
kissia¦q	N	–p, –t
kissimavoq	V	(no generation)
kissuaasa¦q	N	–p, –t
kissugaasa¦q	N	–p, –t
kissu¦gaq	N	–kkap, –kkat
kissumiaavoq	V	(no generation)
kissumi¦aq	N	–ssap, –ssat
kissumiarpaa	V	(no generation)
kissumiarpoq	V	(no generation)
kissumiartaannarpaa	V	(no generation)
kissumiartuarpaa	V	(no generation)
kissumisserpaa	V	(no generation)
kissumissiuppaa	V	(no generation)
kissumissiussivoq	V	(no generation)
kisuarianngilaq	V	(no generation)
kisuariarpoq	V	(no generation)
kisuarpoq	V	(no generation)
kisuivoq	V	(no generation)
kisuppaa	V	(no generation)
kitaajuvoq	V	(no generation)
kitaamiu	N	–p, –t
kitaanii¦ppoq	V	–nngilaq
kitaaniitt¦oq	N	–up, –ut
kitaanukarpoq	V	(no generation)
kitaappaa	V	(no generation)
kitaasiorpoq	V	(no generation)
kitaassivoq	V	(no generation)
kitaatsivoq	V	(no generation)
kitangerpaa	V	(no generation)
kitangersimavaa	V	(no generation)
kitangersorpaa	V	(no generation)
kitangiivoq	V	(no generation)
kitangiuppoq	V	(no generation)
kit¦e	N	–ip, –it
kitigaappaa	V	(no generation)
kitigaaserpaa	V	(no generation)
kitigaassaarpaa	V	(no generation)
kitigaassaarpoq	V	(no generation)
kitigaassimas¦oq	N	–up, –ut
kitigaat	N	–ip, –it
kitigaataavoq	V	(no generation)
kitigarpaa	V	(no generation)
kitigarpoq	V	(no generation)
kiti¦k	N	–up, –it
kitikann¦eq	N	–ip, –it
kitsarliorpoq	V	(no generation)
kitseqarpoq	V	(no generation)
kitseriffi¦k	N	–up, –it
kitserii¦gaq	N	–kkap, –kkat
kitserivi¦k	N	–up, –it
kitserivoq	V	(no generation)
kitserluine¦q	N	–rup, –rit
kitserluivoq	V	(no generation)
kitserpaa	V	(no generation)
kitserut	N	–ip, –it
kitsi	N	–p, –t
kitsigaane¦q	N	–rup, –rit
kitsi¦gaq	N	–kkap, –kkat
kitsiliorpoq	V	(no generation)
kitsimaqu¦sersorpoq	V	–tilersunngilaq
kitsimaqut	N	–ip, –it
kitsimassu¦seq	N	–tsip, –tsit
kitsimavoq	V	(no generation)
kitsinaaqquppaa	V	(no generation)
kitsinaarpaa	V	(no generation)
kitsinaarpoq	V	(no generation)
kitsinippoq	V	(no generation)
kitsinne¦q	N	–rup, –rit
kit¦sinneq	N	{–innerup, –sinnerup}, {–innerit, –sinnerit}
kitsinnerpaa¦q	N	–p, –t
kit¦sinnerpaaq	N	{–innerpaap, –sinnerpaap}, {–innerpaat, –sinnerpaat}
kitsinnersaat	N	–ip, –it
kit¦sinnersaat	N	{–innersaatip, –sinnersaatip}, {–innersaatit, –sinnersaatit}
kitsinnersaavoq	V	(no generation)
kitsinngit	N, pl.	-
kitsippallaaqaaq	V	(no generation)
kitsippoq	V	(no generation)
kitsiss¦oq	N	–up, –ut
kitsi¦ssoq	N	{–ssup, –ttup}, {–ssut, –ttut}
Kitsissuarsuit	N, pl.	-
Kitsi¦ssuarsuit	N, pl.	{–ssuarsuit, –ttuarsuit}
Kitsissuarsunnukarpoq	V	(no generation)
kitsiterivoq	V	(no generation)
kitsiterpaa	V	(no generation)
kits¦oq	N	–up, –ut
kitsumavoq	V	(no generation)
kitsuppoq	V	(no generation)
kitsutt¦oq	N	–up, –ut
kittaarivoq	V	(no generation)
kittaarluarpaa	V	(no generation)
kittaarpaa	V	(no generation)
kitta¦q	N	–p, –t
kitteli	N	–p, –t
kitt¦oq	N	–up, –ut
kittoqqa¦q	N	–p, –t
kittoraappoq	V	(no generation)
kittoraat	N	–ip, –it
kittoraatee¦raq	N	–qqap, –qqat
kittoraavaa	V	(no generation)
kittoraavoq	V	(no generation)
kittorarpaa	V	(no generation)
kittorarpoq	V	(no generation)
kittorarsimavoq	V	(no generation)
kittorartaarpoq	V	(no generation)
kittorartoorpoq	V	(no generation)
kiuners¦oq	N	–up, –ut
kiuners¦oq	N	–ut
kiuner¦soq	N	{–sup, –tup}, {–sut, –tut}
kiveqqajuarpoq	V	(no generation)
kiveqqavoq	V	(no generation)
kiverpaa	V	(no generation)
kiversaavoq	V	(no generation)
kiversa¦q	N	–p, –t
kiversarpaa	V	(no generation)
kiversartippaa	V	(no generation)
kiversimas¦oq	N	–up, –ut
kiviartorpoq	V	(no generation)
kivigaluttuaqaaq	V	(no generation)
kiviisart¦oq	N	–up, –ut
kiviisartuuvoq	V	(no generation)
kiviivoq	V	(no generation)
kivikkarpoq	V	(no generation)
kivikkavippoq	V	(no generation)
kivikkiartorpaa	V	(no generation)
kivilerpoq	V	(no generation)
kivilers¦oq	N	–up, –ut
kiviler¦soq	N	{–sup, –tup}, {–sut, –tut}
kivine¦q	N	–rup, –rit
kivingavallaarpoq	V	(no generation)
kivingavoq	V	(no generation)
kivinik¦oq	N	–up, –ut
kivioraasitsivoq	V	(no generation)
kivippaa	V	(no generation)
kivippallassavaa	V	(no generation)
kivippoq	V	(no generation)
kivisimas¦oq	N	–up, –ut
kivis¦imasoq	N	{–imasup, –simasup}, {–imasut, –simasut}
kivisimavoq	V	(no generation)
kivisinnaanngits¦oq	N	–up, –ut
kivisippaa	V	(no generation)
kivisita¦q	N	–p, –t
kivi¦sitaq	N	{–sitap, –titap}, {–sitat, –titat}
kivisivaa	V	(no generation)
kivisoorpoq	V	(no generation)
kivis¦oq	N	–up, –ut
kivissimavaa	V	(no generation)
kivisussanngort¦oq	N	–up, –ut
kivitserpaa	V	(no generation)
kivitsine¦q	N	–rup, –rit
kivitsiniut	N	–ip, –it
kivitsi¦ppoq	V	–nngilaq
kivitsisigaa	V	(no generation)
kivitsi¦t	N	–sip, –sit
kivitsivoq	V	(no generation)
kivittaarine¦q	N	–rup, –rit
kivittaarisart¦oq	N	–up, –ut
kivivaa	V	(no generation)
kivivoq	V	(no generation)
kjol¦e	N	–ip, {–er, –it}
kladd¦e	N	–ip, {–er, –it}
klass¦e	N	–ip, {–er, –it}
knægt	N	–ip, –it
knægti	N	–p, –t
koblingi	N	–p, –t
koksit	N, pl.	-
Koldingimioq	N	(no generation)
Kolding¦imiu	N	{–ermiup, –imiup}, {–ermiut, –imiut}
kommunalbestyrels¦e	N	–ip, {–er, –it}
kommunalbestyrelsit	N, pl.	-
kommun¦e	N	–ip, {–er, –it}
kommunefogedi	N	–p, –t
kommuneqarfi¦k	N	–up, –it
kommune¦qarfik	N	{–-qarfiup, –qarfiup}, {–-qarfiit, –qarfiit}
kommune¦rujussuaq	N	{–-rujussuup, –rujussuup}, {–-rujussuit, –rujussuit}
kommunistiussu¦seq	N	–tsip, –tsit
kommunistiusuusaaginnart¦oq	N	–up, –ut
konsulenti	N	–p, –t
konsuleqarfi¦k	N	–up, –it
kont¦o	N	–up, –ut
kontonormu	N	–p, –t
kontoqarfius¦oq	N	–up, –ut
kontorfuldmægtigi	N	–p, –t
kooqqerpaa	V	(no generation)
kooqqersorpaa	V	(no generation)
kooqqersuut	N	–ip, –it
koo¦qqersuut	N	{–qqersuutip, –qqertuutip, –rulersuutip, –rulertuutip}, {–qqersuutit, –qqertuutit, –rulersuutit, –rulertuutit}
kooqqiumane¦q	N	–rup, –rit
kooqqiunne¦q	N	–rup, –rit
koo¦qqiunneq	N	{–qqiunnerup, –ruliunnerup}, {–qqiunnerit, –ruliunnerit}
kooqqiuppoq	V	(no generation)
koori	N	–p, –t
kooriliorpoq	V	(no generation)
kooriliort¦oq	N	–up, –ut
koor¦oq	N	–up, –ut
koorormiu	N	–p, –t
koororsarne¦q	N	–rup, –rit
koororsu¦aq	N	–up, –it
koorort¦ooq	N	–uup, –uut
koorpu	N	–p, –t
koorpulersaarutit	N, pl.	-
koorseriippoq	V	(no generation)
koorseriivippoq	V	(no generation)
koorusaarpoq	V	(no generation)
koorusaartuarpoq	V	(no generation)
kopeerisarfi¦k	N	–up, –it
korali	N	–p, –t
Korea	Prop	–p
Koream¦eersoq	N	{–eersup, –eertup, –inngaanneersup, –inngaanneertup, –inngaanninngaanneersup, –inngaanninngaanneertup}, {–eersut, –eertut, –inngaanneersut, –inngaanneertut, –inngaanninngaanneersut, –inngaanninngaanneertut}
Koreamioq	N	(no generation)
Korea¦miu	N	{–miup, –rmiup}, {–miut, –rmiut}
Korsika	Prop	–p
kr.	N	–-ip, –-it
kranersu¦aq	N	–up, –it
krani	N	–p, –t
Kreta	Prop	–p
kridti	N	–p, –t
Kristiansand	Prop	–ip
Kristiansminde	Prop	–p, –t
kristumioqat	N	–ip, –it
kristumiorpalaanngits¦oq	N	–up, –ut
kristumiorpalukkunnaarsitsine¦q	N	–rup, –rit
kristumiorpalukkunnaarsitsivoq	V	(no generation)
kristumiorpalunnikillisitsine¦q	N	–rup, –rit
kristumiorpalunnikillisitsivoq	V	(no generation)
kristumiorpalutt¦oq	N	–up, –ut
kristumiu	N	–p, –t
kristumiunngortippaa	V	(no generation)
kristumiussu¦seq	N	–tsip, –tsit
kristumiuulluarpoq	V	(no generation)
kristumiuune¦q	N	–rup, –rit
kristumiuussu¦seq	N	–tsip, –tsit
kristumiuuvoq	V	(no generation)
Kristusi	Prop	–p
Kroatiam¦eersoq	N	{–eersup, –eertup, –inngaanneersup, –inngaanneertup}, {–eersut, –eertut, –inngaanneersut, –inngaanneertut}
Kroatiamioq	N	(no generation)
Kroatiamiu	N	–p, –t
Kroatien	Prop	(no generation)
kroneqarpoq	V	(no generation)
kryds&tværs	N	–ip, –it
krydsi	N	–p, –t
krydsilerpaa	V	(no generation)
krydsilersuiffi¦k	N	–up, –it
krydsiliiffissa¦q	N	–p, –t
krydsiliine¦q	N	–rup, –rit
krydsiliivoq	V	(no generation)
kræfteqaleqqajaavoq	V	(no generation)
kræfteqalissutaasinnaas¦oq	N	–up, –ut
kræfteqarne¦q	N	–rup, –rit
kræfteqarpoq	V	(no generation)
kræfteqart¦oq	N	–up, –ut
kræftert¦oq	N	–up, –ut
kræfti	N	–p, –t
kuann¦eq	N	–ip, –it
kuannersarpoq	V	(no generation)
kuanners¦ooq	N	–uup, –uut
kuannersorpoq	V	(no generation)
Kuannersuit	N, pl.	-
Kuannersuit	Prop, pl.	-
kuanniliarpoq	V	(no generation)
kuannil¦ik	N	{–iup, –lip, –lup}, –lit
kuanniusaa¦raq	N	–qqap, –qqat
kuanniusa¦q	N	–p, –t
k¦uarti	N	{–uartip, –vart-ip}, {–uartit, –vart-it}
kueqqippaa	V	(no generation)
kueraaffi¦k	N	–up, –it
kueraane¦q	N	–rup, –rit
kueraas¦oq	N	–up, –ut
kueraavi¦k	N	–up, –it
kueraa¦vik	N	{–ffiup, –viup}, {–ffiit, –viit}
kueraavoq	V	(no generation)
kuerarpaa	V	(no generation)
kufferti	N	–p, –t
kuffippaa	V	(no generation)
kuffissaavoq	V	(no generation)
kuffissa¦q	N	–p, –t
kuffissivoq	V	(no generation)
kuggippaa	V	(no generation)
kuimaannart¦oq	N	–up, –ut
kuimaarpoq	V	(no generation)
kuimavoq	V	(no generation)
kuine¦q	N	–rup, –rit
kuineqarpoq	V	(no generation)
kuinnginng¦eeq	N	–iip, –iit
kuioraaffi¦k	N	–up, –it
kuioraas¦oq	N	–up, –ut
kuioraavoq	V	(no generation)
kuipeerpoq	V	(no generation)
kuipeertitsivoq	V	(no generation)
kuisa¦q	N	–p, –t
kuisart¦oq	N	–up, –ut
kuiseqqaa¦q	N	–p, –t
kui¦seqqaaq	N	{–seqqaap, –teqqaap}, {–seqqaat, –teqqaat}
kuiseqqeqqusis¦oq	N	–up, –ut
kuisiffi¦k	N	–up, –it
kui¦siffik	N	{–siffiup, –tiffiup}, {–siffiit, –tiffiit}
kuisiffissa¦q	N	–p, –t
kui¦siffissaq	N	{–siffissap, –tiffissap}, {–siffissat, –tiffissat}
kuisiinnarpoq	V	(no generation)
kuisimanngits¦oq	N	–up, –ut
kuisimas¦oq	N	–up, –ut
kuisimasuuvoq	V	(no generation)
kuisimavoq	V	(no generation)
kuisine¦q	N	–rup, –rit
kuisinne¦q	N	–rup, –rit
kui¦sinneq	N	{–sinnerup, –tinnerup}, {–sinnerit, –tinnerit}
kuisinneqanngits¦oq	N	–up, –ut
kui¦sinneqanngitsoq	N	{–sinneqanngitsup, –tinneqanngitsup}, {–sinneqanngitsut, –tinneqanngitsut}
kuisippaa	V	(no generation)
kuisippoq	V	(no generation)
kuisis¦oq	N	–up, –ut
kuisissimavoq	V	(no generation)
kuisissut	N	–ip, –it
kuisi¦ssut	N, pl.	{–ssut, –ttut}
kuisitippaa	V	(no generation)
kuisitsine¦q	N	–rup, –rit
kui¦sitsineq	N	{–sitsinerup, –titsinerup}, {–sitsinerit, –titsinerit}
kuisitsivoq	V	(no generation)
kuisittussa¦q	N	–p, –t
kuisi¦ttussaq	N	{–ssussap, –ttussap}, {–ssussat, –ttussat}
kui¦sittussaq	N	{–sittussap, –tittussap}, {–sittussat, –tittussat}
kuisivi¦k	N	–up, –it
kuisivoq	V	(no generation)
kuissut	N	–ip, –it
kuissutaavoq	V	(no generation)
kuitsivi¦k	N	–up, –it
kuitsiviliorpoq	V	(no generation)
kuitsivissa¦q	N	–p, –t
kuivaa	V	(no generation)
kuiveerpoq	V	(no generation)
kuiveertorpalu¦k	N	–up, –it
kuiveer¦torpaluk	N	{–sorpalukup, –torpalukup}, {–sorpalukit, –torpalukit}
kuiveertorpoq	V	(no generation)
kuivoq	V	(no generation)
kujaaginnal¦ik	N	{–iup, –lip, –lup}, –lit
kujaalerpaa	V	(no generation)
kujaal¦ik	N	{–iup, –lip, –lup}, –lit
kujaa¦q	N	–p, –t
kujaarmi¦ppaa	V	–nngilaa
kujaart¦ooq	N	–uup, –uut
kuja¦k	N	–ap, –at
kujal¦eq	N	–ip, –it
kujaleraa	V	(no generation)
kujall¦eq	N	–iup, –iit
kujallermii¦ppoq	V	–nngilaq
kujallernukarpoq	V	(no generation)
kujallersaat	N	–ip, –it
kujallersaavoq	V	(no generation)
kujalliuvoq	V	(no generation)
kujammippaa	V	(no generation)
kujammukaappaa	V	(no generation)
kujammukaa¦q	N	–p, –t
kujammukaassivoq	V	(no generation)
kujammukarpoq	V	(no generation)
kujammukart¦oq	N	–up, –ut
kuja¦mmukartoq	N	{–mmukartup, –timukartup}, {–mmukartut, –timukartut}
kujanne¦q	N	–rup, –rit
kujanninne¦q	N	–rup, –rit
kujanni¦ppoq	V	–nngilaq
kujapigaasarpaa	V	(no generation)
kujapigaaserpaa	V	(no generation)
kujapigannappoq	V	(no generation)
kujapi¦gaq	N	–kkap, –kkat
kuja¦ppaa	V	–nngilaa
kujaqqukkiartorpaa	V	(no generation)
kujaqqullerpaa	V	(no generation)
kujaqquppaa	V	(no generation)
kujaqqutsivoq	V	(no generation)
kujarpasippoq	V	(no generation)
kujasiarpoq	V	(no generation)
kujasi¦k	N	–up, –it
kujasinneruvoq	V	(no generation)
kujasippoq	V	(no generation)
kujasissoorpoq	V	(no generation)
kujasiss¦oq	N	–up, –ut
kujasi¦ssoq	N	{–ssup, –ttup}, {–ssut, –ttut}
kujasissu¦aq	N	–up, –it
kujasissumii¦ppoq	V	–nngilaq
kujasi¦ssumiippoq	V	{–ssumiinngilaq, –ttumiinngilaq}
kujassu¦aq	N	–up, –it
kujataamioqat	N	–it
kujataamiorsu¦aq	N	–it
kujataamiu	N	–t
kujataanii¦ppoq	V	–nngilaq
kujataanukarpoq	V	(no generation)
kujattarne¦q	N	–rup, –rit
kujavaappaa	V	(no generation)
kujavarpoq	V	(no generation)
kujavarterpoq	V	(no generation)
kukialuppoq	V	(no generation)
kukiffaaj¦ooq	N	–uup, –uut
kukiffa¦k	N	–ap, –at
kukiffal¦ik	N	{–iup, –lip, –lup}, –lit
kukiffappalunne¦q	N	–rup, –rit
kukigissaat	N	–ip, –it
kukigi¦ssaat	N	{–ssaatip, –ttaatip}, {–ssaatit, –ttaatit}
kukiiaat	N	–ip, –it
kukiiarpoq	V	(no generation)
kuki¦k	N	–up, –it
kukil¦ik	N	{–iup, –lip, –lup}, –lit
kukiss¦ooq	N	–uup, –uut
kukitsial¦ik	N	{–iup, –lip, –lup}, –lit
kukittorne¦q	N	–rup, –rit
kukiusa¦q	N	–p, –t
kukkaajaat	N	–ip, –it
kukkaajaataavoq	V	(no generation)
kukkaajarpaa	V	(no generation)
kukkaajarpoq	V	(no generation)
kukkaajartaannarpoq	V	(no generation)
kukkaartorpaa	V	(no generation)
kukkaartuivoq	V	(no generation)
kukkaartuusiorpoq	V	(no generation)
kukkaartuut	N	–ip, –it
kukka¦q	N	–p, –t
kukkarnaa¦q	N	–p, –t
kukkarnaartorpoq	V	(no generation)
kukkarna¦q	N	–p, –t
kukkarpoq	V	(no generation)
kukkartaannarpoq	V	(no generation)
kukkilaarpaa	V	(no generation)
kukkilaartuivoq	V	(no generation)
kukkilaat	N	–ip, –it
kukkilaavoq	V	(no generation)
kukkilaguserpaa	V	(no generation)
kukkilagutaavoq	V	(no generation)
kukkilagutil¦ik	N	{–iup, –lip, –lup}, –lit
kukkila¦k	N	–ap, –at
kukkilappaa	V	(no generation)
kukkilattari¦aq	N	{–ssap, –ap}, {–ssat, –at}
kukkilattari¦aq	N	–ssap, –ssat
kukkilattorpaa	V	(no generation)
kukkilattuivoq	V	(no generation)
kukkilisaasa¦q	N	–p, –t
kukkilisiliorpoq	V	(no generation)
kukkilisiliort¦oq	N	–up, –ut
kukkilisi¦liortoq	N	{–liortup, –ortup}, {–liortut, –ortut}
kukkili¦t	N	–sip, –sit
kukkilitserpaa	V	(no generation)
kukkilivoq	V	(no generation)
kukkippoq	V	(no generation)
kukk¦ooq	N	–uup, –uut
kukkoqqajaavoq	V	(no generation)
kukkoqqajarpoq	V	(no generation)
kukkuaa	V	(no generation)
kukkugajuppoq	V	(no generation)
kukkujuippoq	V	(no generation)
kukkujuissu¦seq	N	–tsip, –tsit
kukkujuits¦oq	N	–up, –ut
kukkuk¦ooq	N	–uup, –uut
kukkukoorpaluk	N	–up, –it
kukkukoorpalu¦k	N	–p, –t
kukkukoorpalu¦k	N	–up, –it
kukkukoorpoq	V	(no generation)
kukkukulavoq	V	(no generation)
kukkukuua¦raq	N	–qqap, –qqat
kukkukuut	N, pl.	-
kukkullu¦innarsimasoq	N	{–innarsimasup, –aannarsimasup}, {–innarsimasut, –aannarsimasut}
kukkullu¦innartoq	N	{–aannartup, –innartup}, {–aannartut, –innartut}
kukkuluttorne¦q	N	–rup, –rit
kukkuluttornersu¦aq	N	–up, –it
kukkuluttorpaa	V	(no generation)
kukkuluttorpoq	V	(no generation)
kukkuluttugaas¦oq	N	–up, –ut
kukkuluttu¦gaq	N	–kkap, –kkat
kukkuluttuine¦q	N	–rup, –rit
kukkunaveersaa¦gaq	N	–kkap, –kkat
kukkunaveersaarne¦q	N	–rup, –rit
kukkunaveersaarpoq	V	(no generation)
kukkune¦q	N	–rup, –rit
kukkuneqangaart¦oq	N	–up, –ut
kukkuneqanngilluinnart¦oq	N	–up, –ut
kukkuneqanngissu¦seq	N	–tsip, –tsit
kukkuneqanngits¦oq	N	–up, –ut
kukkuneqanngi¦vissoq	N	{–ivissup, –ivittup, –vissup, –vittup}, {–ivissut, –ivittut, –vissut, –vittut}
kukkuneqaqis¦oq	N	–up, –ut
kukkunersiorne¦q	N	–rup, –rit
kukkunersiorpaa	V	(no generation)
kukkunersiorpoq	V	(no generation)
kukkunersiueqqissaarne¦q	N	–rup, –rit
kukkunersiueqqissaarpoq	V	(no generation)
kukkunersiu¦gaq	N	–kkap, –kkat
kukkunersiuine¦q	N	–rup, –rit
kukkunersiuisarfi¦k	N	–up, –it
kukkunersiuisart¦oq	N	–up, –ut
kukkunersiuis¦oq	N	–up, –ut
kukkunersiuisoqarfi¦k	N	–up, –it
kukkunersiuivoq	V	(no generation)
kukkunersiut	N	–ip, –it
kukkunersiuut	N	–ip, –it
kukkunertal¦ik	N	{–iup, –lip, –lup}, –lit
kukkunianngissu¦seq	N	–tsip, –tsit
kukkunil¦ik	N	{–iup, –lip, –lup}, –lit
kukkunimininngu¦aq	N	–up, –it
kukkupateerpoq	V	(no generation)
kukkusaannarpoq	V	(no generation)
kukkusaas¦oq	N	–up, –ut
kukkusaavoq	V	(no generation)
kukkusa¦q	N	–p, –t
kukkusart¦oq	N	–up, –ut
kukkusimas¦oq	N	–up, –ut
kukkusinnaanngits¦oq	N	–up, –ut
kukkusinnaas¦oq	N	–up, –ut
kukkusoorpoq	V	(no generation)
kukkus¦oq	N	–up, –ut
kukkussut	N	–ip, –it
kukkussuteqarne¦q	N	–rup, –rit
kukkutaarpaa	V	(no generation)
kukkutaarpoq	V	(no generation)
kukkutippaa	V	(no generation)
kukkut¦ooq	N	–uup, –uut
kukkuuppaa	V	(no generation)
kukkuussivoq	V	(no generation)
kukkuvoq	V	(no generation)
kuk¦ooq	N	–uup, –uut
kukoqqaat	N	–ip, –it
kukoqqaatissaaruppoq	V	(no generation)
kukoqqaatissaasivi¦k	N	–up, –it
kukoqqaatissa¦q	N	–p, –t
kukoqqaatissat	N, pl.	-
kukulluarpaa	V	(no generation)
kukuppaa	V	(no generation)
kukuppoq	V	(no generation)
kukutsine¦q	N	–rup, –rit
kukutsivoq	V	(no generation)
kukuttaaserpaa	V	(no generation)
kukuttaat	N	–ip, –it
kukuut	N	–ip, –it
kukuut	N, pl.	-
kukuutissa¦q	N	–p, –t
kukuutissarsiorpoq	V	(no generation)
kukuutissartarpoq	V	(no generation)
kulavaa¦raq	N	–qqap, –qqat
kulava¦k	N	–ap, –at
kulavappoq	V	(no generation)
kulla¦k	N	–ap, –at
kulleri	N	–p, –t
kull¦oq	N	–up, –ut
kullorfi¦k	N	–up, –it
kullorsorpoq	V	(no generation)
Kullorsu¦aq	N	–up, –it
Kullorsu¦aq	Prop	–up, –it
kullorsu¦aq	N	–up, –it
kullorsuarmukarpoq	V	(no generation)
kullukippoq	V	(no generation)
kullup¦ooq	N	–uup, –uut
kullutorne¦q	N	–rup, –rit
kullutorpoq	V	(no generation)
kul¦ooq	N	–uup, –uut
kultureqanngissu¦seq	N	–tsip, –tsit
kulturi	N	–p, –t
kulturisioqatigiinne¦q	N	–rup, –rit
kuluippoq	V	(no generation)
kuluisaanngeqaaq	V	(no generation)
kuluisaarluinnarne¦q	N	–rup, –rit
kuluisaarpoq	V	(no generation)
kuluissu¦seq	N	–tsip, –tsit
kuluits¦oq	N	–up, –ut
kulumpisorpoq	V	(no generation)
Kulusu¦k	Prop	–up, –it
kumaajaane¦q	N	–rup, –rit
kumaajaavoq	V	(no generation)
kumaajarpaa	V	(no generation)
kumaajarti¦ppoq	V	–nngilaq
kumaarpaa	V	(no generation)
kumaarpoq	V	(no generation)
kumaarsaat	N	–ip, –it
kumaarsarpaa	V	(no generation)
kumaarsarpoq	V	(no generation)
kumaarsine¦q	N	–rup, –rit
kumaarsivoq	V	(no generation)
kumaaruppoq	V	(no generation)
kumaarusaane¦q	N	–rup, –rit
kumaarusaavoq	V	(no generation)
kumaasa¦q	N	–p, –t
kumaasarsivoq	V	(no generation)
kumaat	N	–ip, –it
kumagaavippoq	V	(no generation)
kumagaavoq	V	(no generation)
kuma¦k	N	–ap, –at
kumallu¦k	N	–up, –it
kumangerpaa	V	(no generation)
kumangerpoq	V	(no generation)
kumangiine¦q	N	–rup, –rit
kumangiutisivoq	V	(no generation)
kumanippoq	V	(no generation)
kumappoq	V	(no generation)
kumaqalerpoq	V	(no generation)
kumaqarpoq	V	(no generation)
kumassimavoq	V	(no generation)
kumassiorpoq	V	(no generation)
kumattal¦ik	N	{–iup, –lip, –lup}, –lit
kumatt¦ooq	N	–uup, –uut
kumatt¦oq	N	–up, –ut
kumigaane¦q	N	–rup, –rit
kumigaat	N	–ip, –it
kumigaatisivoq	V	(no generation)
kumigaavoq	V	(no generation)
kumigarpaa	V	(no generation)
kumigartorpaa	V	(no generation)
kumigut	N	–ip, –it
kumilannarpoq	V	(no generation)
kumilannavippoq	V	(no generation)
kumilappoq	V	(no generation)
kumillat	N	–ip, –it
kumippaa	V	(no generation)
kumippoq	V	(no generation)
kumitsi¦t	N	–sip, –sit
kumiut	N	–ip, –it
kummappoq	V	(no generation)
kummassarpaa	V	(no generation)
kummassimavoq	V	(no generation)
kummerinertoqaaq	V	(no generation)
kummerivoq	V	(no generation)
kummi	N	–p, –t
kummine¦q	N	–rup, –rit
kumminert¦ooq	N	–uup, –uut
kummisa¦q	N	–p, –t
kummis¦oq	N	–up, –ut
kummissa¦q	N	–p, –t
kummiusa¦q	N	–p, –t
kummivoq	V	(no generation)
kummut	N	–ip, –it
kumoorn	Interj	(no generation)
kumoorpoq	V	(no generation)
kuni¦k	N	–up, –it
kunilla¦k	N	–ap, –at
kuniorarpaa	V	(no generation)
kuniorpaa	V	(no generation)
kuniortuarpaa	V	(no generation)
kunippaa	V	(no generation)
kunissigajuppoq	V	(no generation)
kunissivoq	V	(no generation)
kunissorpaa	V	(no generation)
kunissuigajuppallaarnersu¦aq	N	–up, –it
kunissuigajuppallaarpoq	V	(no generation)
kunissuine¦q	N	–rup, –rit
kunissuivoq	V	(no generation)
kunissuunne¦q	N	–rup, –rit
kunitsivoq	V	(no generation)
kuniuivoq	V	(no generation)
kunngeeruppoq	V	(no generation)
kunngeqarfi¦k	N	–up, –it
kunngi	N	–p, –t
kunngiitsuuffeqarfi¦k	N	–up, –it
kunngiitsuuffi¦k	N	–up, –it
kunngiitsuuffimmiitt¦oq	N	–up, –ut
kunngikkormiu	N	–p, –t
Kunngikkormiut	N, pl.	-
kunngikkormiut	N, pl.	-
kunngikkormiuus¦oq	N	–up, –ut
kunnginngorne¦q	N	–rup, –rit
kunnginngorniart¦oq	N	–up, –ut
kunnginngorpoq	V	(no generation)
kunnginngortinneqarpoq	V	(no generation)
kunnginngortippaa	V	(no generation)
kunngissakkut	N, pl.	-
kunngissa¦q	N	–p, –t
kunngit	N, pl.	-
kunngiuffi¦k	N	–up, –it
kunngiuniart¦oq	N	–up, –ut
kunngiussu¦seq	N	–tsip, –tsit
kunngiusussaanerart¦oq	N	–up, –ut
kunngorna¦q	N	–p, –t
kunngorpaa	V	(no generation)
kunnguserpoq	V	(no generation)
kunngut	N	–ip, –it
kunngut	N, pl.	-
kunnippaa	V	(no generation)
kunnissaangavoq	V	(no generation)
kunnitsaavoq	V	(no generation)
kunnitsarpaa	V	(no generation)
kunnitsivoq	V	(no generation)
kuntor¦ooq	N	–uup, –uut
kupp¦eq	N	–ip, –it
kupperne¦q	N	–rup, –rit
kupperpoq	V	(no generation)
kuppersoqanngilaq	V	(no generation)
kupp¦iaraq	N	{–eeqqap, –iaqqap}, {–eeqqat, –iaqqat}
kuppileqqippaa	V	(no generation)
kuppilerpaa	V	(no generation)
kuppilerseqqinne¦q	N	–rup, –rit
kuppiler¦seqqinneq	N	{–seqqinnerup, –teqqinnerup}, {–seqqinnerit, –teqqinnerit}
kuppilersinne¦q	N	–rup, –rit
kuppiler¦sinneq	N	{–sinnerup, –tinnerup}, {–sinnerit, –tinnerit}
kuppilersippoq	V	(no generation)
kuppiliissut	N	–ip, –it
kuppiliissut	N, pl.	-
kuppiliivoq	V	(no generation)
Kurdistan	Prop	–ip
Kurdistanim¦eersoq	N	{–eersup, –eertup, –inngaanneersup, –inngaanneertup}, {–eersut, –eertut, –inngaanneersut, –inngaanneertut}
Kurdistanimioq	N	(no generation)
Kurdistan¦imiu	N	{–ermiup, –imiup}, {–ermiut, –imiut}
kursuserne¦q	N	–rup, –rit
kursuserpoq	V	(no generation)
kursusertarfi¦k	N	–up, –it
kusagaa	V	(no generation)
kusaginngilaa	V	(no generation)
kusaginninngilaq	V	(no generation)
kusaginnippoq	V	(no generation)
kusajjaari¦k	N	–up, –it
kusakkeerpaa	V	(no generation)
kusakkeersimavaa	V	(no generation)
kusakkiivippaa	V	(no generation)
kusakkisaanngilaq	V	(no generation)
kusanaalligaluttuinnarpoq	V	(no generation)
kusanaallisippaa	V	(no generation)
kusanaallisitsine¦q	N	–rup, –rit
kusanaappoq	V	(no generation)
kusanaats¦oq	N	–up, –ut
kusanaatsuliorne¦q	N	–rup, –rit
kusanaatsuliorpoq	V	(no generation)
kusanaffaari¦k	N	–up, –it
kusananaarpaa	V	(no generation)
kusanangaarpoq	V	(no generation)
kusanangaart¦oq	N	–up, –ut
kusananngeqis¦oq	N	–up, –ut
kusananngits¦oq	N	–up, –ut
kusananngitsuliort¦oq	N	–up, –ut
kusanaqaaq	V	(no generation)
kusanaqateqanngits¦oq	N	–up, –ut
kusanarluart¦oq	N	–up, –ut
kusanarluartorsiorsinnaane¦q	N	–rup, –rit
kusanarluinnart¦oq	N	–up, –ut
kusanarluinnartorsiorne¦q	N	–rup, –rit
kusanarluinnartorsiort¦oq	N	–up, –ut
kusanarluinnartuus¦oq	N	–up, –ut
kusanarpallaanngilaq	V	(no generation)
kusanarpoq	V	(no generation)
kusanarsaagaannginnerulerne¦q	N	–rup, –rit
kusanarsaagaannginneruler¦sitsineq	N	{–sitsinerup, –titsinerup}, {–sitsinerit, –titsinerit}
kusanarsaagaanngits¦oq	N	–up, –ut
kusanarsaane¦q	N	–rup, –rit
kusanarsaas¦oq	N	–up, –ut
kusanarsarne¦q	N	–rup, –rit
kusanarsarpaa	V	(no generation)
kusanarsu¦seq	N	–tsip, –tsit
kusanart¦oq	N	–up, –ut
kusanartulerine¦q	N	–rup, –rit
kusanartuleris¦oq	N	–up, –ut
kusanartulia¦q	N	–p, –t
kusanartuliat	N, pl.	-
kusanartuliorpoq	V	(no generation)
kusanassu¦seq	N	–tsip, –tsit
kusanaviss¦oq	N	–up, –ut
kusanavi¦ssoq	N	{–ssup, –ttup}, {–ssut, –ttut}
kusannat	N	–ip, –it
kusannataavoq	V	(no generation)
kusannatigaa	V	(no generation)
kusassarpaa	V	(no generation)
kusassarpoq	V	(no generation)
kusassarujoorpoq	V	(no generation)
kusassarumat¦ooq	N	–uup, –uut
kusassarumatussu¦seq	N	–tsip, –tsit
kusatsi¦ppoq	V	–nngilaq
ku¦seq	N	–tsip, –tsit
kuserfigaa	V	(no generation)
kuserfi¦k	N	–up, –it
kuseriarne¦q	N	–rup, –rit
kuseriarninngorne¦q	N	–rup, –rit
kuseriarninngortitsine¦q	N	–rup, –rit
kuseriarpaa	V	(no generation)
kuseriarpoq	V	(no generation)
kuseriarsimas¦oq	N	–up, –ut
kuseriartaane¦q	N	–rup, –rit
kuseriartaat	N	–ip, –it
kuseriartaavoq	V	(no generation)
kuseriartarpaa	V	(no generation)
kusermiuvoq	V	(no generation)
kusernaveeqqut	N	–ip, –it
kuserne¦q	N	–rup, –rit
kuserpoq	V	(no generation)
kusersippaa	V	(no generation)
kusersita¦q	N	–p, –t
kusersitassa¦q	N	–p, –t
kusertitassa¦q	N	–p, –t
kusertuaannarpoq	V	(no generation)
kuserunarpoq	V	(no generation)
kusinnguatsiarpoq	V	(no generation)
kuso¦raq	N	–qqap, –qqat
kussaa¦raq	N	–qqap, –qqat
kussagaa	V	(no generation)
kussagunnart¦oq	N	–up, –ut
kussaguppoq	V	(no generation)
kussagusuppoq	V	(no generation)
kussa¦k	N	–ap, –at
kussakannerpoq	V	(no generation)
kussanarsivoq	V	(no generation)
kussangaarpoq	V	(no generation)
kussangajaajuvoq	V	(no generation)
kussangajaanngu¦aq	N	–up, –it
kussangajaa¦q	N	–p, –t
kussangajaarsu¦aq	N	–up, –it
kussangalaarpoq	V	(no generation)
kussangaqaaq	V	(no generation)
kussangassu¦seq	N	–tsip, –tsit
kussangavallaaqaaq	V	(no generation)
kussangavoq	V	(no generation)
kussanna¦q	N	–p, –t
kussanngaarpoq	V	(no generation)
kussanngaartippaa	V	(no generation)
kussanngarippoq	V	(no generation)
kussanngarissorsuuvoq	V	(no generation)
kussappoq	V	(no generation)
kussa¦q	N	–p, –t
kussariilippoq	V	(no generation)
kussarpoq	V	(no generation)
kussarterpoq	V	(no generation)
kussartippaa	V	(no generation)
kussartita¦q	N	–p, –t
kussartitsivoq	V	(no generation)
kussassigajuppoq	V	(no generation)
kussassivoq	V	(no generation)
kussasuppoq	V	(no generation)
kussatta¦q	N	–p, –t
kussattarna¦q	N	–p, –t
kussattarsu¦aq	N	–up, –it
kusserpoq	V	(no generation)
kussersimavoq	V	(no generation)
kussersorpaa	V	(no generation)
kussertiterpoq	V	(no generation)
kussiaavoq	V	(no generation)
kussiakippoq	V	(no generation)
kussia¦q	N	–p, –t
kussiaqarpoq	V	(no generation)
kussiffeqanngits¦oq	N	–up, –ut
kuss¦ineq	N	–ernup, –ernit
kussinersu¦aq	N	–up, –it
kussinert¦ooq	N	–uup, –uut
kussinertoorsu¦aq	N	–up, –it
kussiorpaa	V	(no generation)
kussiorpoq	V	(no generation)
kussiort¦oq	N	–up, –ut
ku¦ssiortoq	N	{–ssiortup, –uliortup}, {–ssiortut, –uliortut}
kussippallaaqaaq	V	(no generation)
kussippoq	V	(no generation)
kussittaannarpoq	V	(no generation)
kussiugaavoq	V	(no generation)
kussiu¦gaq	N	–kkap, –kkat
kussiuine¦q	N	–rup, –rit
kussugaasa¦q	N	–p, –t
kussu¦gaq	N	–kkap, –kkat
kussugut	N	–ip, –it
kussugutserpaa	V	(no generation)
kussu¦k	N	–up, –it
kussukasi¦k	N	–up, –it
kussukulluuserpoq	V	(no generation)
kussukulluut	N	–ip, –it
kussunne¦q	N	–rup, –rit
kussuppaa	V	(no generation)
kussuppoq	V	(no generation)
kussuttarpaa	V	(no generation)
kussuuvoq	V	(no generation)
kusugaasaa¦raq	N	–qqap, –qqat
kusugaasanngorpoq	V	(no generation)
kusugaasa¦q	N	–p, –t
kusu¦gaq	N	–kkap, –kkat
kusukkerpoq	V	(no generation)
kusupaavoq	V	(no generation)
kusupa¦k	N	–ap, –at
kusupiuppoq	V	(no generation)
kusuppiuppoq	V	(no generation)
kusuppiutivippoq	V	(no generation)
kusuppoq	V	(no generation)
kutaa	Interj	(no generation)
kutaappallaarpoq	V	(no generation)
kutaappoq	V	(no generation)
kutaarfigaa	V	(no generation)
kutaarpaa	V	(no generation)
kutaarpoq	V	(no generation)
kutakkunnaarpoq	V	(no generation)
kutappoq	V	(no generation)
kutattunnguuvoq	V	(no generation)
kuterpoq	V	(no generation)
kuti	N	–p, –t
kutsappaa	V	(no generation)
kutsappoq	V	(no generation)
kutserivoq	V	(no generation)
kutsiffigaa	V	(no generation)
kutsimaffigaa	V	(no generation)
kutsimanngeqaaq	V	(no generation)
kutsimavoq	V	(no generation)
kutsine¦q	N	–rup, –rit
kuts¦ineq	N	{–ernup, –inerup}, {–ernit, –inerit}
kutsinert¦ooq	N	–uup, –uut
kutsinertorpoq	V	(no generation)
kutsingas¦oq	N	–up, –ut
kutsiorfigaa	V	(no generation)
kutsiorpoq	V	(no generation)
kutsisimavoq	V	(no generation)
kutsisippaa	V	(no generation)
kutsisita¦q	N	–p, –t
kutsis¦oq	N	–up, –ut
kutsissutigaa	V	(no generation)
kutsiuut	N	–ip, –it
kutsiuutigaa	V	(no generation)
kutsivoq	V	(no generation)
kutsu¦k	N	–up, –it
kutsukujoorfi¦k	N	–up, –it
kutsukujoorpoq	V	(no generation)
kutsukujoorut	N	–ip, –it
kutsuusa¦q	N	–p, –t
kutsuusia¦q	N	–p, –t
kuttaappoq	V	(no generation)
kutteri	N	–p, –t
kutuulaaginnavippoq	V	(no generation)
kutuulaarpoq	V	(no generation)
kutuulavoq	V	(no generation)
kuueerpoq	V	(no generation)
kuueersuuvoq	V	(no generation)
kuueerutigaa	V	(no generation)
kuuerpaa	V	(no generation)
kuuersari¦aq	N	–ssap, –ssat
kuuerussarta¦q	N	–p, –t
kuuffi¦k	N	–up, –it
kuuffilersorpaa	V	(no generation)
kuuffilia¦q	N	–p, –t
kuugaanngu¦aq	N	–up, –it
kuugaa¦q	N	–p, –t
kuugaarpoq	V	(no generation)
kuugaart¦oq	N	–up, –ut
kuugaatsia¦q	N	–ap, –at
kuugasaarpoq	V	(no generation)
kuugasaartuinnaavoq	V	(no generation)
kuugiaannaavoq	V	(no generation)
kuugia¦q	N	–p, –t
kuuguaa¦q	N	–p, –t
kuuguppaa	V	(no generation)
kuugussaavoq	V	(no generation)
kuugussimavaa	V	(no generation)
kuugutt¦oq	N	–up, –ut
kuu¦k	N	–p, –it
kuukillivoq	V	(no generation)
kuukkooriarsu¦aq	N	–up, –it
kuukkooriarsuaqarpoq	V	(no generation)
kuukkoorpoq	V	(no generation)
kuukoorpoq	V	(no generation)
kuukoortitsinaqaaq	V	(no generation)
kuukoortitsivoq	V	(no generation)
kuukuju¦k	N	–up, –it
kuulteqarfi¦k	N	–up, –it
kuulti	N	–p, –t
kuultilersu¦gaq	N	–kkap, –kkat
kuultil¦ik	N	{–iup, –lip, –lup}, –lit
kuultiliorniaraluart¦oq	N	–up, –ut
kuultiliorniartarne¦q	N	–rup, –rit
kuultimin¦eerannguaq	N	{–eerannguup, –iarannguup}, {–eerannguit, –iarannguit}
kuultim¦ineq	N	–ernup, –ernit
kuultisiorfi¦k	N	–up, –it
kuultisiorfiusimas¦oq	N	–up, –ut
kuultisiorne¦q	N	–rup, –rit
kuultisiort¦oq	N	–up, –ut
kuultitalersorpaa	V	(no generation)
kuultitalersu¦gaq	N	–kkap, –kkat
kuultiteqqippaa	V	(no generation)
kuultiterne¦q	N	–rup, –rit
kuultiterpaa	V	(no generation)
kuultiti¦gaq	N	–kkap, –kkat
kuultiusa¦q	N	–p, –t
kuultiusartaliussa¦q	N	–p, –t
kuultiusarterpaa	V	(no generation)
kuultiusarti¦gaq	N	–kkap, –kkat
kuultius¦oq	N	–up, –ut
kuultiuvoq	V	(no generation)
kuultivi¦k	N	–up, –it
kuulukujoorpoq	V	(no generation)
Kuummiut	N, pl.	-
Kuummiut	Prop, pl.	-
kuungalaarpoq	V	(no generation)
kuungasivoq	V	(no generation)
kuungasoorpoq	V	(no generation)
kuungas¦oq	N	–up, –ut
kuungavippoq	V	(no generation)
kuungavoq	V	(no generation)
Kuunnaat	N, pl.	-
Kuunnaat	Prop, pl.	-
kuunne¦q	N	–rup, –rit
kuunnerasaarpoq	V	(no generation)
kuunnersa¦q	N	–p, –t
kuunngu¦aq	N	–up, –it
kuunnguaqarpoq	V	(no generation)
kuup¦eeq	N	–iip, –iit
kuupeerpaa	V	(no generation)
kuupeersu¦aq	N	–up, –it
kuupiia¦raq	N	–qqap, –qqat
kuupii¦araq	N	{–aqqap, –veqqap}, {–aqqat, –veqqat}
kuuppalaarpoq	V	(no generation)
kuuppassual¦ik	N	{–iup, –lip, –lup}, –lit
kuuppoq	V	(no generation)
kuussaanngilaq	V	(no generation)
kuussaanngivippoq	V	(no generation)
kuussarnerpoq	V	(no generation)
kuussimavoq	V	(no generation)
Kuussu¦aq	N	–up, –it
Kuussu¦aq	Prop	–up, –it
kuussu¦aq	N	–up, –it
kuusugaa	V	(no generation)
kuusuppoq	V	(no generation)
kuusussaavoq	V	(no generation)
kuusussarpaa	V	(no generation)
kuutseerpoq	V	(no generation)
kuuts¦eq	N	–ip, –it
kuutsers¦ooq	N	–uup, –uut
kuutsersorpoq	V	(no generation)
kuutsiiaarpoq	V	(no generation)
kuutsiiaat	N	–ip, –it
kuutsiiarpoq	V	(no generation)
kuutsippaa	V	(no generation)
kuutsitsine¦q	N	–rup, –rit
kuuttarfi¦k	N	–up, –it
kuuttoorne¦q	N	–rup, –rit
kuutt¦oq	N	–up, –ut
kuuttorsuuvoq	V	(no generation)
kuuttuarpoq	V	(no generation)
kuuttuinnanngorpoq	V	(no generation)
Kuwait	Prop	–ip
kvadratkilometer	N	–ip, {–er, –it}
kviksølv	N	–ip, –it
kvækeri	N	–p, –t
kystskipperi	N	–p, –t
kæmnereqarfi¦k	N	–up, –it
kæmneri	N	–p, –t
kærnemælk	N	–ip, –it
